подача: подаче
пастьба: пастьбу
тренер: тренеры
психически: психически
процесс: процессе процесс
овощ: овощи овощами
отличать: отличают отличает
оказываться: оказываются
тело: тела телом теле
приобретать: приобретают
держаться: держатся
широко: широко
средний: средняя среднее средних средней средние
филировать: филируют
здоровый: здоровых здоровое
худой: худые
таковой: таковые
загородный: загородные
следить: следить
отбор: отбор
сколько: сколько
соплеменник: соплеменниками соплеменника соплеменников
неиссякаемый: неиссякаемым
провоцировать: провоцируя провоцирующую провоцировать
предсказать: предсказать
черно-подпалый: черно-подпалыми
бояться: боитесь
название: название
показать: показавшая
собака: собаку собаками собакой собак собака собакам собаке собаки
чемпионский: чемпионский
свойственный: свойственную
настоящий: настоящих настоящей настоящий
помещение: помещения
заранее: заранее
ноздря: ноздри
бессмысленный: бессмысленная
обсуждение: обсуждения
пристёгивать: пристегивать
состав: составами
оптимально: оптимально
пышный: пышные пышный
цена: цена
мальчик: мальчик
любой: любая любую любой любому любыми
процедура: процедуре процедуру процедуры
смысл: смыслах
материал: материалов
хромота: хромоту
чистота: чистоту
отрасти: отросшей отросшим
бесконечный: бесконечное
предприимчивый: предприимчивые
расчёска: расческой
прокачка: прокачки
шампунь: шампунями шампуня
вымыть: вымыть
морской: морская
юморист: юморист
сторона: стороны
лист: листья листом
долгий: дольше
дисквалифицировать: дисквалифицирующие
хороший: хорошую хорошего хорошим
превосходство: превосходства
игра: игру играм
низкий: низшую
увести: увести
семейство: семейства
режим: режиму
зато: зато
бежать: бегущего
россия: россия россии
морда: морде морда
обратный: обратная
итог: итоге
занятие: занятиям занятие
корпус: корпусе корпуса корпус
наскок: наскоков
начинать: начинают
основание: основаниями
размер: размеров размерах
радужка: радужки радужкой
ради: ради
прошмыгнуть: прошмыгнувшей
фен: фен
представитель: представителей представителям представителя представители
желать: желали
команда: команду команде командам команд команды команда
шея: шея шею шеи
отмечать: отмечают
стричь: стричь стригут
шерсть: шерсть шерсти
компаньон: компаньоны
рука: руками рукой
рыба: рыба
качество: качеств качества
ирландец: ирландцы ирландцем ирландец ирландцев
неприятный: неприятная
оптимальный: оптимальная оптимальные
помешать: помешают помешает
челюсть: челюсти
демонстрировать: демонстрирующие
должный: должны должен должно должна
небольшой: небольшого небольшое
заменять: заменять
тримминг: тримминг
говядина: говядина
пойти: пойдут
содержать: содержать
взгляд: взгляд
чёрный: черные черным черными
ирландский: ирландских ирландского
человек: людям человеку человека
рождаться: рождаются
анальный: анального
мозоль: мозоли
тонкий: тонкий тонкие
большой: большой
некоторый: некоторых некоторые
спустя: спустя
нога: ног ноги ногами ногах
уточнение: уточнение
отличаться: отличается
бедлингтон: бедлингтоны
участие: участием
важно: важно
травма: травмы
история: история историей
гипотиреоз: гипотиреоз
заводиться: заводящиеся
кто-то: кого-то ком-то
щенок: щенка щенков щенки щенок щенкам
откликаться: откликаться
проявляться: проявляется
нормально: нормально
обездвиженный: обездвиженными
раздражитель: раздражители
нарезка: нарезку
высохший: высохшую
обязательный: обязательный обязательным
питомец: питомцев питомцу питомец питомцах питомцам питомца питомцем
ринг: ринг рингах
каждый: каждого каждым каждый
туалетный: туалетные
планка: планку
особый: особое особого
трёхмесячный: трехмесячного
голова: голове головы голову голова
запас: запасом
трансформироваться: трансформируются трансформирующийся
масло: масле
семья: семьи семью
негромко: негромко
гонять: гоняют
приятный: приятные
добавление: добавлением
полуоборот: полуоборота
подобрать: подобранная
воронка: воронки
балл: балл
характеристика: характеристика
быть: е будьте будут
практика: практике
вредить: вредят
выставка: выставках выставок выставки выставке
приподнимать: приподнимать приподнимая
шлёпать: шлепать
переход: переходы переход
заводчик: заводчик заводчики
купание: купания
год: годы годах года годам лет году
блокировать: блокирует
густой: густую густая
повод: поводу
испытание: испытаний
неплохой: неплохих
мурлыка: мурлыка
еда: еды
порода: породе породы пород породами породу порода породой
списать: списать
спина: спине спину спины спина
осуществлять: осуществлять
псовина: псовины псовину
требовательный: требовательны
палец: пальцы пальцами пальцев
систематически: систематически
быстро: быстро
чужак: чужакам чужака
боязнь: боязнь
основное: основном
незнакомец: незнакомца незнакомцами
недоисследовать: недоисследованные
противник: противник
ухоженность: ухоженность
водоём: водоемах
раз: раза
видео: видео
зелёный: зеленого
физический: физическую
мячик: мячики
киса: кис
полноценный: полноценного
любящий: любящей
керри-блю-терьер: керри-блю-терьером керри-блю-терьеры керри-блю-терьер керри-блю-терьера керри-блю-терьерам керри-блю-терьеров
полностью: полностью
очередь: очередь
никакой: никаких
месячный: месячном месячного месячных
единый: единому
условие: условии
компания: компании
пёс: псы пса
кеннел-клуб: кеннел-клуб
домашний: домашних домашние домашней домашним
трудоголизм: трудоголизмом
утверждать: утверждавшего
скучный: скучными
предплечье: предплечьям
отрастание: отрастания
такой: таких такие такая такого
упрямый: упрямые
скука: скуки
проникнуть: проникла
полевой: полевых
речь: речь
образ: образ
содержание: содержание содержания
предмет: предметами предметы предметов
сера: серы
схватка: схватка
что-либо: чего-либо
попытка: попытки попытка
мощный: мощный мощную
бок: боках бокам
витаминный: витаминные
рекомендовать: рекомендуют
охрана: охрану
реагировать: реагировать
подзывать: подзывать
путь: путь
принимать: принимало
окрас: окраса окрас окрасом
руководитель: руководителя
приучить: приучено приучить
давать: дает дают
полуторагодовалый: полуторагодовалых
цитировать: цитировать
догонялки: догонялки
кстати: кстати
территория: территорию
поколение: поколений
связь: связь
продемонстрировать: продемонстрировать
другой: другую другие других другими
точно: точно
приближение: приближения
теменной: теменной
выгуливать: выгуливает выгуливать
кондиция: кондиции
орган: органам
крыса: крыс
вода: воде
объединяться: объединяться
единственный: единственный
изумрудный: изумрудного
правильный: правильную правильного правильное
выпустить: выпустить
владелец: владельцев владельцу владельцы
сообщать: сообщает
блоха: блох
бедро: бедра
бытовать: бытует
пока: пока
стать: стали стать
уточнить: уточните
протестировать: протестированы
репрессия: репрессий
рубить: рубят
осанка: осанкой
внешний: внешние внешней внешняя
вязка: вязки
предупреждать: предупреждающий
достижение: достижении
лёгкий: легким
дважды: дважды
возраст: возрасту возраста возрасте
способ: способами способ
стаж: стажем
типичный: типичными типичное типичные
протирать: протирать
незнакомый: незнакомых
расчесать: расчесать
спортивный: спортивные
складка: складку складки
покрасоваться: покрасоваться
болезненный: болезненные
прочный: прочным
жизненный: жизненный
сменить: сменили
восточноевропейский: восточноевропейская
причина: причина
проверить: проверить
приём: приемов
принцип: принципу
лечиться: лечится
крупный: крупный крупных крупные
смотреть: см
плюс: плюс
фотография: фотографии
развлечение: развлечений развлечения развлечениях
помогать: помогает помогать
солнце: солнце
томатный: томатного
невзирая: невзирая
агрессивный: агрессивная
семь: семь
уход: уходе ухода уход
современный: современные
исполнение: исполнение
чёткий: четкими
обожать: обожающие
помнить: помните помнить
результат: результатов
страдать: страдают страдает
высокий: высокая высокий
питомник: питомники питомников питомник
потешный: потешной
проникать: проникает
анатомический: анатомические
пространство: пространству
сухофрукты: сухофрукты
сложение: сложения
выбирать: выбирайте
глаз: глаза глаз глазами
навещать: навещаете
водяной: водяных водяная
самый: самый
решать: решать
морально: морально
прийтись: придется
мягкий: мягкий мягких
штраф: штрафы
птичий: птичьими
кинолог: кинолог
корм: корм кормами
педикюр: педикюр
выщипывать: выщипывать
масть: масть
снисхождение: снисхождение
часть: части часть
вниз: вниз
быт: быту
ус: усы
мясной: мясную мясного
век: века веке век
отставание: отставание
форма: форме форму
собачий: собачьей собачью собачьих
трубчатый: трубчатыми
поэтапный: поэтапным
увидеть: увидев
рычание: рычание
реакция: реакция
поскольку: поскольку
осваивать: осваивать
обучение: обучения
ребро: ребрах
ходульный: ходульную
плавать: плавать
простой: простой
покупать: покупать покупают
краткий: краткая
уроженец: уроженцы
истинный: истинные истинного
весьма: весьма
общий: общую
забавный: забавным забавную
отношение: отношение
называть: называть
заболевание: заболеваниям заболевание
место: место мест
поясница: поясницей
пилочка: пилочкой
клумба: клумбах
неординарно: неординарно
край: края
тёмный: темной
периодичность: периодичность
первый: первом первые первый первую первых
веньечко: веньечко
эксперт: экспертов
керриблютерьер: керриблютерьер
наследник: наследниками
драка: драки
взмах: взмах
факт: факт
пищалка: пищалки
вконтакте: вконтакте
создать: создать создан
мышь: мыши
далее: далее
прогрессировать: прогрессирующая
ярко: ярко
овечий: овечьих
молодой: молодая молодым
шубка: шубки
кожа: коже
животное: животных животным животного животными животные животное
один: одного одна одном
верить: верить
светлеть: светлея
одинаково: одинаково
апортировка: апортировка
параметр: параметрам
волос: волос волоса
высококачественный: высококачественными
ножницеобразный: ножницеобразного
длина: длины длиной длина
тон: тон
выбрать: выбрать
битьё: битья
оценить: оцените
основать: основана
шёрстный: шерстного шерстный
классический: классические
хотя: хотя
нижний: нижняя нижней
продукт: продуктов продукты
товарищ: товарищи товарищ
волнистый: волнистый волнистая
х: х
запереть: заперты
эффектный: эффектных
хвост: хвостом хвоста хвост
установить: установить
который: которую которыми которой которого которых которым которые который
пасть: пасть
позволяться: позволяется
костяк: костяка костяком
пластина: пластину
довольствоваться: довольствуются
собственно: собственно
глубокий: глубокие
посильный: посильную
доминанта: доминанты
квартира: квартире
мера: меру мере меры
поймать: пойман
присутствовать: присутствуют
известный: известны
информация: информация
проходить: проходят проходит
максимально: максимально
варёный: вареный
создание: создание
айриша: айриш
двухразовый: двухразовое
жилплощадь: жилплощадь
буйный: буйным
сустав: суставы суставов
преодолевать: преодолевать
мускулатура: мускулатуры мускулатурой мускулатуру
гребень: гребнем
трижды: трижды
сначала: сначала
острый: острый
изысканный: изысканным
мытьё: мытья
ниже: ниже
забыть: забыв
хвостатый: хвостатого
аз: азы
крепкий: крепкие крепкой
положиться: положиться
сухой: сухой сухих сухими
юный: юными
идеальный: идеальными идеальная
баловство: баловство
проделка: проделкам
выстригаться: выстригаются
среди: среди
затылок: затылка
дом: дом доме
лапа: лапах лапы лап
подушечка: подушечками подушечках
линия: линию линий
рельефный: рельефной
распорядок: распорядку
обильно: обильно
подружиться: подружиться
выставочный: выставочного выставочный выставочную выставочных
кошконенавистник: кошконенавистники
пшеничный: пшеничные
развитой: развитыми развит
стянуть: стянуть
вручную: вручную
просто: просто
клеить: клеить
проходиться: проходиться
избыточный: избыточным избыточного
частый: частые чаще почаще
этикет: этикета
волна: волну
ковёр: ковре
сушка: сушка сушки
принять: принято принять
сторожевой: сторожевых
отчаянный: отчаянные
заканчивать: заканчивали заканчивают
стричься: стрижется стригутся
фрукт: фрукты
дисквалифицироваться: дисквалифицируются
крестьянский: крестьянская
чёлка: челка челкой
противопоказанный: противопоказан
подышать: подышать
глазной: глазные глазных
добавить: добавьте
рюттер: рюттера
прогулка: прогулки прогулке
проворачивать: проворачивают
предрасположенность: предрасположенность
искристый: искристый
скрадывать: скрадывать
происхождение: происхождения
киста: кист
абиотрофия: абиотрофия
необходимо: необходимо
готовый: готовы готовые
исторически: исторически
покров: покровов покров покрова
разгораться: разгорается
стандартизировать: стандартизировали
дойти: дошло
аккуратный: аккуратные аккуратную аккуратен
задний: задние задних задними задним
заведомо: заведомо
редкий: реже
вид: вида виде
тщательно: тщательно
авторитет: авторитета
непонимание: непонимание
предосторожность: предосторожности
дрессировка: дрессировка дрессировкой
подросток: подростках
время: время
сука: суки сук
агрессивность: агрессивность
остров: острова
ушной: ушной ушное
выносливый: выносливые
наказание: наказания
лоб: лбу
начать: начали начав
противный: противном
кость: костей костями
американский: американский
яркий: яркая
ладить: ладить
грумерский: грумерские
слух: слуха
подкормка: подкормки
хронический: хронической
характерный: характерна характерны
взаимопонимание: взаимопонимание
треск: треска
замаячить: замаячившего
например: например
несколько: несколько
рост: рост роста росте
потомство: потомство
шотландия: шотландия
ограничивать: ограничивающей
удобный: удобнее
девочка: девочек
надеяться: надейтесь
нетуго: нетуго
умеренный: умеренное
к: ко
реклама: реклама
исполниться: исполнится
налагаться: налагаются
жизнедеятельность: жизнедеятельности
сыр: сыр
понять: поймет
использование: использованием
базовый: базовые
воспринять: воспримет
где-нибудь: где-нибудь
пантомима: пантомиме
лакомство: лакомствами лакомства
посадка: посадки
неглубокий: неглубокой
полагаться: полагается
угольно-чёрный: угольно-черный
рекомендоваться: рекомендуется
спокойно: спокойно
выходец: выходцев выходец
слезотечение: слезотечения
воспитание: воспитание
обладание: обладание
авторитаризм: авторитаризма
кудрявый: кудрявая
понравиться: понравится
кажущийся: кажущихся
шлейка: шлейка
мирно: мирно
выдёргивать: выдергивать
выстригание: выстригание
правильно: правильно
строгий: строгие
металлический: металлическим
поддержание: поддержания
человекоориентировать: человекоориентированное
сайт: сайту
несовершенство: несовершенства
родословная: родословной
белокочанный: белокочанная
сопровождаться: сопровождающаяся
сосуществовать: сосуществовать
добыча: добыче
полезно: полезно
конечность: конечностями конечностей конечности
паста: пастой
член: членом членов
лишь: лишь
относиться: относиться относятся
долго: долго
стрижка: стрижка стрижки стрижку
окружающий: окружающей окружающими
горло: горла
форум: форум форуме
португальский: португальская
стоп: стопом
конец: конце конец
резинка: резинкой
усилить: усилена
спастись: спасшаяся
нагловатый: нагловатых
хрящевой: хрящевой
усов: усов
требовать: требуют
образовать: образуя
капля: капли
положение: положение
тип: типу типа
внешне: внешне
поддразнивать: поддразнивает
сдержанно-холодноватый: сдержанно-холодноваты
подклеивать: подклеивать подклеивают
разудалый: разудалое
крестьянин: крестьян
описание: описание
горизонт: горизонте
голубой: голубым голубую голубые голубого
начало: начало начале
внушительный: внушительной
грубый: грубые грубейшая
навага: навага
отодвинуть: отодвинуть
стандарт: стандартом стандарт
состояние: состояния
присущий: присущи
оттенок: оттенки
ускорить: ускорить
экономный: экономного
подчиняться: подчиняться
серьёзный: серьезный
лопатка: лопатки
переключаться: переключается
прилегание: прилеганием
юниорский: юниорского
припустить: припущенная
найти: найти
гречневый: гречневая
однако: однако
германия: германии
играть: играть
поличное: поличным
острота: остроте остроту
поводок: поводком поводок
устраивать: устраивать
свободный: свободный
поэтому: поэтому
практичный: практичные
четыре: четырех четыре
копирование: копирование
дружелюбный: дружелюбная
методика: методики
активность: активность
подверженный: подвержены
хозяин: хозяевами хозяевам хозяина хозяева
упертость: упертость
дружелюбность: дружелюбность
сквозняк: сквозняк
подвижный: подвижные
отзыв: отзывах отзывы
выпуклый: выпуклую
кошка: кошки
простак: простак
следовать: следует
животный: животному
шум: шум
курить: курят
достаться: достались
преклонный: преклонного
особь: особи особям особей
возрастной: возрастную
метка: метки
впустить: впустить
чистый: чистая чистые
прямой: прямая прямое прямой
гламурный: гламурного
отличие: отличие
нервный: нервная
допустимый: допустимо
кусок: куски
учиться: учится
воображение: воображением
породный: породные
ваш: вашими вашего
разрушительный: разрушительных
ведущий: ведущие
ужин: ужин
интерес: интерес
мочь: могут можете могла
умение: умению умения
локоть: локти
минимум: минимум
клубный: клубный
округлый: округлый
смена: смены
конина: конина
зубной: зубных зубной
творог: творог
ухо: ушей уха уши
ножницы: ножницами
профессиональный: профессионального
объявление: объявления
сделать: сделать сделано
основной: основные
убедительно: убедительно
полова: половой
бородач: бородач
привлекаться: привлекались
интеллект: интеллект
охранный: охранные
многие: многие
величина: величины
выйти: вышло
вес: вес
показаться: показаться
степень: степени
сенсация: сенсации
аддисон: аддисона
относить: относить
чемпион: чемпионов
голос: голос
ежедневно: ежедневно
свой: своим свой своей своих свои
утруждать: утруждающих
намеренно: намеренно
именно: именно
держать: держали
приучать: приучают
твёрдый: твердое
чрезмерный: чрезмерная
назначать: назначая
уходить: уходить
продолжительность: продолжительность
плотный: плотными плотной
плавание: плавание
досуг: досуге
нормальный: нормальной
воспитывать: воспитывают
питаться: питающимся
кератоконъюнктивит: кератоконъюнктивит
любопытный: любопытен
навязывать: навязывали
дешёвый: дешевая
маленький: маленькое маленькие
доходить: доходит
затянуться: затянуться
смычка: смычка
лестница: лестнице
цвет: цвета
десна: десны
полотно: полотно
лениться: ленятся
зависимость: зависимости
мания: мания
прохождение: прохождению
научить: научить
очертание: очертаниями
продавец: продавца
швейцарский: швейцарский
вокруг: вокруг
ожидать: ожидать
слегка: слегка
собака-бородач: собаки-бородачи
сокращать: сокращают
подниматься: подниматься
фото: фото
сесть: сесть
экстерьерный: экстерьерных
подвывих: подвывих
питание: питание
бобовый: бобовых
допускаться: допускается
стена: стенах
м: м
коровий: коровью
игрушка: игрушек игрушки
два: две двух
яндекс: яндекс
распространить: распространенная
ротвейлер: ротвейлер
количество: количество
показатель: показателями
уголок: уголок уголках уголке
странноватый: странноватым
грызун: грызунов
дело: делом дело делах деле
покупаться: покупается
гармонично: гармонично
резиновый: резиновые
остальной: остальным
вперёд: вперед
конкретный: конкретный
череп: череп
тренировочный: тренировочную
социализация: социализации
экспонироваться: экспонироваться
поведение: поведением поведение
выраженный: выраженной выраженные
получить: получила получили
делать: делая делать делает делают
боков: боков
породистый: породистых породистый
фрисби: фрисби
холка: холке
облегчить: облегчит
стабильный: стабильных
жёлтый: желтый
полезность: полезностями
журнал: журнал
неделя: недели неделю
высота: высота
игривый: игривые игривы
фарш: фарш
изучать: изучает
использовать: использующих использовать
чей: чьи
зелень: зелень
последствие: последствиями
отлов: отлову отлов
постав: постав
определить: определить
пища: пищу
э: э
двух-треха: двух-трех
больший: большие
выровняться: выровняться
раскопка: раскопок
пристально: пристально
упражнение: упражнение упражнения
порядок: порядка
болезнь: болезни болезнь
ребёнок: дети детях
изредка: изредка
дирхаунд: дирхаунд
малый: меньшей
четвероногий: четвероногим четвероногими четвероногого
терьер: терьеры терьерами
чрезмерно: чрезмерно
либо: либо
зона: зоны зоне
пошлифовать: пошлифовать
этот: этому
сырой: сырыми сырое сырой сырая
тёплый: теплое теплой
сок: сока
европейский: европейских
висок: висков
отрастить: отрасти
жест: жест
подопечный: подопечным подопечных
подтекать: подтекают
обучаться: обучаться
статный: статный
внимательно: внимательно
зверь: зверя
уступить: уступить
рассматривать: рассматривать
фермерский: фермерскими
ведение: ведению
кобель: кобели
гармоничный: гармоничная
одуванчик: одуванчика
скакательный: скакательные
перекус: перекус
прирождённый: прирожденный
прочитать: прочитать
упрямство: упрямства
перетягивание: перетягивание
появиться: появится
седловидный: седловидную
диморфизм: диморфизм
запретить: запретить запрещено
троечка: троечку
день: дня день
осветлить: осветленный
минеральный: минеральные
являться: являются является
перейти: перейти
разрастись: разросшуюся
сутки: сутки
завиток: завиткам
ткань: ткани тканью ткань
регулярно: регулярно
главное: главное
коготь: когтей
менее: менее
курчавый: курчавый
рёбрышко: ребрышек
собрат: собратьями
излучающий: излучающий
хваткий: хваткие
родиться: родились
вытянутый: вытянутые
оставлять: оставляя
солидный: солидном
выпрямить: выпрямленный
культивировать: культивировать
потенциал: потенциал
кондиционировать: кондиционирующими
грудь: груди грудь
воспаление: воспаление воспаления
требование: требования требований
подзыв: подзыв
вправе: вправе
развлекаться: развлекается
обстановка: обстановке
отсутствие: отсутствие
слишком: слишком
невероятно: невероятно
пуделистость: пуделистость
одиночество: одиночеству
ошибка: ошибки ошибка
поточить: поточить
вести: ведут
будущее: будущего
опираться: опираясь
требоваться: требуется требуются
маскировать: маскировать
непобедимость: непобедимость
кой: коем
образование: образованию
альтернативный: альтернативными
снимать: снимают
габарит: габаритов
гигиена: гигиена
накупить: накупите
внутренний: внутренняя внутренней
первопроходец: первопроходцем
второй: втором
дьявол: дьяволы
конфликт: конфликтов
позволить: позволить позволит
работа: работу
собственный: собственную
массировать: массировать
прислушаться: прислушаются
капуста: капуста
оценка: оценке
рубль: рублей
делить: делящий делить
тот: тому ту
коллективный: коллективный
начесать: начесать
постигать: постигать
разведение: разведения
мочка: мочка
предъявляться: предъявляются
отрабатывать: отрабатывать
основательность: основательность
сбалансированный: сбалансированный
глубина: глубиной
подбородок: подбородке
постный: постное
опасность: опасность
жёсткий: жесткую жесткая
внимание: внимание
горизонтальный: горизонтальная
прикус: прикуса прикус
разумеется: разумеется
селянин: селяне
претендовать: претендовать
видеть: видят
использоваться: используется
обновлять: обновляйте
идти: идет
короткий: короткие короткой
удалять: удаляют
капустный: капустным
число: числом числа
терьерский: терьерские
английский: английскими
иметь: имеет иметь имеют
стоимость: стоимость
приобрести: приобрести
петрушка: петрушка
натуральный: натуральных
особенно: особенно
длинный: длинной
охотничий: охотничий
желательно: желательно
стойка: стойке стойку
час: часов
машинка: машинкой
выход: выходы выхода
предельно: предельно
трусливо: трусливо
нравиться: нравится
груминг: груминга
достаточно: достаточно
каста: касту
повышенный: повышенное
откровенный: откровенная
родство: родства
титул: титул
таиться: таится
накануне: накануне
обязать: обязан
привычка: привычки привычку
эталонный: эталонный
успеть: успели успела
способность: способностей
угощать: угощать
мордашка: мордашками
кровь: кровей
голубошерстный: голубошерстных
зоомагазин: зоомагазина
мечтать: мечтающим
хек: хек
расчёсываться: расчесывается
посадить: посаженный
семейный: семейной
лежанка: лежанке лежанкой
проговаривать: проговаривать
охотно: охотно
англия: англии англия
несмотря: несмотря
р-р-р: р-р-р
купить: купить
часто: часто
оговорить: оговоренного
склонность: склонность
эпидермальный: эпидермальных
пункт: пункт
отлавливать: отлавливать
упустить: упустит
променад: променады
элемент: элементам
осуществляться: осуществляется
выносить: вынося выносят
пинок: пинком
неустойчивый: неустойчивой
ветеринарный: ветеринарной
деструктивный: деструктивным
убирать: убирают
зенненхунд: зенненхунд
клуб: клубы
ссср: ссср
яблоко: яблоки
ювенильный: ювенильная
рассчитывать: рассчитывать
крыться: кроется
потребность: потребности потребность
послушание: послушание
пресекаться: пресекаться
отар: отар
козлятина: козлятина
ирландия: ирландии ирландия
проблема: проблему проблем проблемой
гриценко: гриценко
паховый: пахов
увеличиваться: увеличиваться
дисплазия: дисплазию дисплазия
весь: вся всем
монтгомери: монтгомери
домочадец: домочадцев
кусание: кусание
обитатель: обитатели
открытый: открытых
честь: честь
комплекс: комплексы
реальность: реальностью
организовать: организуя
одноклассник: одноклассники
путём: путем
попутно: попутно
традиционный: традиционную
грубоватость: грубоватость
приносить: приносили
узнать: узнать
структура: структуре
лосьон: лосьон
волосок: волоски
стая: стаю
нестись: несутся
укус: укусы
возможность: возможности
мнение: мнение
здоровье: здоровья здоровье
против: против
чистить: чистить
лохматый: лохматым
состригать: состригать
приказ: приказы
сам: самом
случайный: случайные
передний: передние передних
случай: случаи случае
кроме: кроме
мясо: мясо
ограничиваться: ограничиваются
отстоять: отстоящие
подремать: подремать
фермер: фермерами
последовательность: последовательности
живот: животе
советский: советского
копировать: копирует
неподтверждённый: неподтвержденными
три: трех
жевательный: жевательными
подвывание: подвыванием
щенячий: щенячьем
поиск: поиск
становление: становления
направление: направлению
бриллиантовый: бриллиантовые
хозяйственный: хозяйственных
достигать: достигали
коротко: коротко
зуб: зубы зубов
козловский: козловского
вообще: вообще
высохнуть: высохнуть
квашеный: квашеная
куриный: куриное
керри: керри
туда: туда
скромный: скромной
характер: характер
удалить: удалены удалить
помощь: помощь
выглядеть: выглядят
концентрироваться: концентрироваться
прайор: прайор
помета: помета
ремешок: ремешке
явление: явление
болезненно: болезненно
лаять: лают
подозрительность: подозрительность
очко: очков
укорачивать: укорачивают
шерстяной: шерстяными
сторож: сторожа
общение: общении
зрение: зрения
щётка: щеткой
испанский: испанского
нос: нос
колтун: колтуны
периодически: периодически
порок: пороки
хозяйский: хозяйского
вливаться: вливается
принуждение: принуждения
генетический: генетическую
родина: родины
предок: предков
недокус: недокус
вовсе: вовсе
жизнь: жизни жизнь
пустобрехство: пустобрехством
огород: огородах
выпадение: выпадением
забывать: забывайте
овчарка: овчарка
красивый: красивые
веселие: веселье
эрина: эрина
яйцо: яйцо
ознакомиться: ознакомьтесь
мешать: мешает
благодаря: благодаря
провокация: провокаций
смута: смуту
легенда: легенды
затем: затем
столетие: столетие столетия
впервые: впервые
франтоватый-элегантный: франтовато-элегантно
российский: российских
начёсывать: начесывают
шоу-особь: шоу-особям
оставление: оставление
добродушие: добродушие
успех: успехи
бады: бады
относительно: относительно
нужно: нужно
мимимишность: мимимишности
врождённый: врожденную
наказывать: наказывают
также: также
толчок: толчок
экстерьер: экстерьера
умный: умная
идеал: идеале
вещь: вещь вещах
предел: предел
обман: обмана
любимец: любимца
момент: моменты
шёрстка: шерстка
догадка: догадками
тонуть: тонущего
палочка: палочек
нежирный: нежирные
белок: белок
зарегистрировать: зарегистрировали
разбирать: разбирая
крупяной: крупяные
считать: считать
продолжать: продолжает продолжают
специальный: специальных
ранний: ранних
подать: поданным
удерживать: удерживая
сто: сто
баранина: баранина
хипстерский: хипстерской
оставаться: остается
лицо: лицом
высоко: высоко
агрессия: агрессию
прилипать: прилипать
виллебранд: виллебранда
подходить: подходят
обрабатываться: обрабатываются
спадать: спадая
книга: книгах
безжалостный: безжалостными
наследственный: наследственным
сложно: сложно
вносить: вносящий
задаток: задатки
розыгрыш: розыгрышей
знакомство: знакомства
область: области
стоить: стоит
это: это
массивный: массивные
укоротить: укоротить
прибылой: прибылые
зацикленный: зацикленной
когда-то: когда-то
инфицироваться: инфицируются
гиперактивность: гиперактивностью
образоваться: образуются
кормить: кормить
вполне: вполне
сохранять: сохраняет
походка: походку
прыгучий: прыгуч
смочь: сможет
любить: любят
невозможно: невозможно
способный: способен способны
имущество: имущества
прочий: прочими
верхний: верхняя
стандартный: стандартные
аккуратно: аккуратно
обусловить: обусловлен
каша: каши
хаос: хаос
формироваться: формируется
легко: легко
идеально: идеально
узкий: узкую
контур: контур
лента: ленту
лояльный: лояльны
обильный: обильная
падкий: падкие
ряд: рядов
что-нибудь: что-нибудь
добавка: добавки
евро: евро
специалист: специалиста специалисты
отличный: отличные
инициатива: инициативе
желток: желток
месяц: месяцев
морковь: морковью
затрачивать: затрачивая
расчёсывать: расчесывать
пасти: пасти
доверенный: доверенным
снисходительно: снисходительно
продавец-разведенец: продавцами-разведенцами
вакансия: вакансии
всесоюзный: всесоюзных
настойчиво: настойчиво
конфликтный: конфликтные
приходиться: приходится
прародитель: прародителем
обойтись: обойдется обойтись
погрызть: погрызть
начинаться: начинается
темно-ореховый: темно-ореховой
встречаться: встречается встречаются
постоянно: постоянно
вроде: вроде
корректировать: корректировать
дальнейший: дальнейшем
минутный: минутное
генетически: генетически
сверхспособность: сверхспособностей
мелькать: мелькали
выше: выше
смочить: смоченной
отверстие: отверстия
потребоваться: потребуются
формировать: формируя
случаться: случается
плавный: плавный
психика: психикой
чересчур: чересчур
проделать: проделал
бараний: бараньих
экспонирование: экспонирования
патология: патологий
ватный: ватных
принести: принесенный
распахнуть: распахнутые
рисовый: рисовая
большинство: большинство большинства
главный: главная
практически: практически
крапива: крапива
снижать: снижающую
катаракт: катаракта
полгода: полугода
рейтинг: рейтинг
округлить: округленных
гигиенический: гигиенический
дефект: дефекты
прозвище: прозвище
избыток: избытки
производитель: производители
подписываться: подписывайтесь
двигаться: движется
хиппи: хиппи
сильный: сильные сильными
самостоятельно: самостоятельно
передаваться: передается
экскурсия: экскурсий
салат: салат
корабль: корабля
очень: очень
обычно: обычно
площадка: площадку
энтропион: энтропион
менталитет: менталитет
противостоять: противостоять
исправить: исправить
демонстрация: демонстрация
трубка: трубки
инстинкт: инстинкт
постепенно: постепенно
кто-нибудь: кто-нибудь
кличка: клички кличку
клоун: клоуна
описывать: описывая
правило: правила
довольно: довольно
диагностировать: диагностировать
готовиться: готовьтесь
касаться: касается
естественный: естественным
медленный: медленное
племенной: племенного
окрасить: окрашена
граница: границы
обрабатывать: обрабатывают
взрослый: взрослых
бородка: бородки
летний: летнем
индивидуальность: индивидуальность
лидер: лидера
проскальзывать: проскальзывает
трюк: трюкам
проект: проекте
наследство: наследству
дрессура: дрессуре
пора: пор
завтрак: завтрак
незамедлительный: незамедлительная
кг: кг
уступать: уступающими
насколько: насколько
удовлетворить: удовлетворить
кефир: кефир
злобность: злобность
сладко: сладко
сей: сих
среднее: среднего
минимальный: минимальная
линька: линька
нарост: наросты
дымчатый: дымчатых
действительно: действительно
страна: страна
графство: графства
предпочтительный: предпочтительна
темперамент: темперамент
жиреть: жирела
лишний: лишнего
ширина: шириной
облик: облике
внятный: внятной
спускаться: спускаться
кормление: кормления кормление
сориентироваться: сориентировались
формирование: формирования
выявлять: выявляют
развить: развитая
косой: косые
ситуация: ситуации
мирный: мирное
недостаток: недостаток
пронзительно-умный: пронзительно-умный
родитель: родителей
носитель: носителя
баловень: баловня
борода: борода
задувать: задувает
ожидание: ожидании
запретный: запретных
исказить: исказить
волкодав: волкодавов
пытаться: пытаются
неухоженный: неухоженной
житель: жителей
назначаться: назначается
невоспитанный: невоспитанных
г: г
рычать: рычите
недуг: недуг
сюрприз: сюрприза
щетинистый: щетинистую
темпераментный: темпераментный
угрожать: угрожающий
