америка: америке
иметь: имели имеющий иметь
процесс: процессе
овощ: овощи
тело: тела теле тело
стоять: стоять
широко: широко
опыт: опыт
расти: растет расти
профессиональный: профессиональном профессиональную
сколько: сколько
планк: планка
название: название названием названия
интенсивность: интенсивности
собака: собаку собак собака собакам собаке собаки
варёный: вареным
физический: физических
обсуждение: обсуждения
предупредительный: предупредительное
цена: цена
грейхаунд: грейхаунда грейхаундами
обновляться: обновляется
внести: внесла
пропорция: пропорция
регистрировать: регистрируют
материал: материалов
племенной: племенные
спокойный: спокойнее
повадка: повадках повадками
массивный: массивным
манипуляция: манипуляцию
издать: издать
традиция: традиции
стянуть: стянуты
семейство: семейства
субпродукт: субпродукты
поголовье: поголовье
пробежка: пробежки
зато: зато
россия: россия россии
морда: морде морда
обратный: обратная
необходимый: необходимая
мероприятие: мероприятия мероприятиях мероприятий
представитель: представителей представителя представители
искать: искать ищут
команда: команду команде команд команды команда
занятие: занятий занятие занятия
шея: шея шее
волос: волосом волос
флегматичный: флегматичное
стричь: стричь
очертание: очертаниям
специфический: специфическая
шерсть: шерсть шерсти шерстью
мощность: мощность
низкий: низкий низкая низком
неприятный: неприятное
высокий: высоких высокая высоком высокого
крупа: крупа крупы
применять: применять
держать: держат держать
оптимальный: оптимальная оптимальный
челюсть: челюсти
должный: должны должна
самый: самая самое самую самых
тримминг: тримминг
соревнование: соревнования
проделывать: проделывать
питомец: питомцами питомцев питомца питомцем
большой: большой
собственный: собственный
жесткошёрстный: жесткошерстная жесткошерстных
карен: карен
сверху: сверху
назвать: назвать
теория: теория
нога: ног ноги ногах
прекращать: прекращает
выраженный: выражен выраженным выраженной
участие: участием
важно: важно
признак: признаками признак
встретить: встретить
история: история
редкий: редкое редкой
гипотиреоз: гипотиреоз
кинологический: кинологических
щенок: щенка щенков щенки щенком щенке
взрослый: взрослое взрослой взрослые взрослых
хрупкий: хрупкая
ирландский: ирландского ирландскими
успешно: успешно
поощрять: поощрять
настолько: настолько
классический: классическая
картина: картине
каждый: каждого
голова: голове головой голову голова
выступ: выступ
даваться: дается
чувство: чувством
характеристика: характеристика характеристик
род: рода
стоп: стоп
исключить: исключите
выставка: выставках выставок выставки выставке
рабочий: рабочая рабочих рабочие
помощь: помощью помощь
физически: физически
заводчик: заводчик заводчика заводчики
зарождение: зарождения
еда: еды едой
внушительный: внушительный
порода: породе породы пород породу порода
обязательный: обязательными обязательные
маклак: маклаки
дружелюбие: дружелюбии
утвердить: утвердили
маска: маска
палец: пальцы
тримминговочный: тримминговочного тримминговочный
деревушка: деревушки
копытное: копытных
выбрать: выберите выбрать
видео: видео
установить: установлен
роднить: роднит
грубый: грубый
подойти: подойдет
безупречный: безупречное
конкретный: конкретного
внимание: внимания
полностью: полностью
данность: данность
форум: форумы форум форуме
гладкошёрстный: гладкошерстные
стагхаунд: стагхаунд
аристократический: аристократическими
бликсен: бликсен
владелец: владельца владельцев
должность: должности
участвовать: участвовали
полевой: полевых
усваиваться: усваивается
хороший: хорошим лучшего хороший лучшее хорошей хороши хорошее
физиология: физиологии
содержание: содержание содержания
ген: гены
присутствовать: присутствовать
датироваться: датируется
опытный: опытного опытных
копытный: копытное
незаметный: незаметный
мелкий: мелких
работа: работе работа
хвост: хвосте хвосты хвоста хвост
слово: слово
клановый: клановой
снизу: снизу
волкодав: волкодава волкодавами
прилегать: прилегающий
рекомендовать: рекомендуют
защита: защиты
контраст: контрасте
услуга: услуги услуг
скука: скуку
городской: городских
словесно: словесно
специальный: специальная
практиковать: практикуйте практикующих
показать: покажи
связь: связь
расставить: расставленные
старотипный: старотипных старотипные старотипными
ходить: ходят ходили
мягкий: мягкой мягком
найти: нашел
прямолинейно: прямолинейно
профнепригодность: профнепригодность
работать: работающая работает
пока: пока
стать: стали
протестировать: протестированы
ошейник: ошейнику
состояние: состоянии
собачий: собачьего собачьих
аллергия: аллергии
вязка: вязки
возбудить: возбужденного
интерес: интереса интерес
структура: структуру структура
давать: давать дают
содержать: содержит
молниеносный: молниеносной
спортивный: спортивные спортивных
предмет: предметы
выразительный: выразительная
гигант: гиганты
беспорядок: беспорядок
прочный: прочным
проверить: проверить
происходить: происходят
подтон: подтоном
эффектный: эффектной
подобрать: подобрать
смотреть: см смотреть
знающий: знающих
лёгкий: легкий
фотография: фотографии
пуходерк: пуходерка
травля: травля
любимый: любимыми
широкий: широкие широкая
знание: знаниям
понимание: пониманием
агрессивный: агрессивная
современный: современные современных
уход: уходе уход уходу
холод: холоду
исполнение: исполнение
корма: корме
столько: столько
питомник: питомники
пара: пары
выбирать: выбирайте
глаз: глаза
тигровин: тигровинами
задор: задора
прийтись: придется
корм: корм
масть: масть
потреблять: потребляла
список: списки список
дирхаунд: дирхаунда дирхаунду дирхаунды дирхаунд дирхаундом дирхаундов
часть: части часть
легкоатлет: легкоатлетов
шотландский: шотландский шотландская шотландские шотландской шотландских
быт: быту
ус: усы
малыш: малышу малыша
третировать: третируют
поскольку: поскольку
верхний: верхний
существо: существо существа
уплощённый: уплощенный
краткий: краткая
косматый: косматый косматых
весьма: весьма
импортировать: импортированных
дополнительный: дополнительные дополнительных
сильный: сильная
любой: любого любому
сухой: сухом сухой
отношение: отношение отношении
достаточный: достаточные
место: место
исключительно: исключительно
зверь: зверю
приветствоваться: приветствуются
пустой: пустых
эксперт: экспертов
узкий: узкие
купать: купать
урок: урока
факт: факт
отвечать: отвечают
интеллигент: интеллигентов
вконтакте: вконтакте
рядом: рядом
впечатление: впечатление
создать: создать
загон: загонов загона
любимец: любимцев
притравка: притравка
срок: срок
пересечь: пересеченной
среда: среде
русский: русской русскими
повторять: повторяйте
животное: животных животным животного животные животное
вначале: вначале
олень: оленей оленя
сша: сша
параметр: параметрам
усиленный: усиленные
длина: длины
охотничий: охотничьих охотничьими охотничья охотничий
напальчник: напальчники
основать: основана
шёрстный: шерстного шерстный
нижний: нижняя нижней
марка: марку
кэдболл: кэдболл
порядок: порядок
барельеф: барельеф
постоять: постоять
век: веке веку
увлечённо: увлеченно
портосистемный: портосистемный
полный: полные
витамин: витаминов
осмотр: осмотре осмотр
серый: серая
предрасположенность: предрасположенности предрасположенность
измотать: измотать
сотня: сотен
заметный: заметен
сырой: сырым сырое
щипать: щиплете
информация: информация
поимка: поимки
прийти: придет
важный: важное
прививаться: прививалось
максимально: максимально
натуральный: натуральный
создание: создание
делиться: делится делиться
лежебок: лежебоку
авторитет: авторитет
генетический: генетической
ниже: ниже
проявлять: проявляющие проявляющий
характер: характера характер
интеллект: интеллекте интеллект
тёплый: теплый
окрас: окрас
такой: такое такие такого такими
сложный: сложных
воспринимать: воспринимать
подходящий: подходящий
ссылаться: ссылаются
одобрение: одобрения
юный: юными
природный: природной природным
молчаливый: молчаливое
стремительно-неутомимый: стремительно-неутомимые
сравнительно: сравнительно
среди: среди
дом: дом дома доме
лежанка: лежанка
категорически: категорически
статичный: статичном
ограниченный: ограниченного
длинный: длинные длинный длинной
заводить: заводите
загривок: загривком
вручную: вручную
просто: просто
перекрыть: перекрыть
очароваться: очароваться
пиктский: пиктский
олений: оленью оленьих оленьей оленья оленьи
борзая: борзой борзым борзая борзых борзые борзую борзыми
улучшать: улучшающую
подчеркнуть: подчеркнуто
принять: принято
успешный: успешного
смыкаться: смыкаются
дискомфорт: дискомфорта
отдохнуть: отдохнуть
домашний: домашней домашнего
камень: камень
тон: тона
считать: считают считать
соцсеть: соцсетях
плохой: плохое
добавить: добавьте
человек: человеку человека человек
черта: чертах
умеренный: умеренная умеренное умеренной
происхождение: происхождения
заболевание: заболевания
демонстрировать: демонстрируют
необходимо: необходимо
готовый: готовы
исторически: исторически
течь: течет
отправляться: отправляется
аккуратный: аккуратные
задний: задние задних
депрессия: депрессию
недопустимый: недопустима
силиконовый: силиконовые
приобрести: приобретите
лакомство: лакомство
дрессировка: дрессировка
предплечье: предплечья
предлагать: предлагает предлагают предлагать
время: время
сука: суки сук сука
фанат: фанатов
стоящий: стоящее
мочка: мочкой
агрессивность: агрессивность
вес: веса вес весу
наказание: наказания
жёсткий: жесткий жесткой
лоб: лбу
местность: местности
другой: другие других
сила: сила силой
приведение: приведения
использовать: используйте используют использовать
признавать: признают
ступить: ступившему
мера: мере
толстый: толстые
заканчиваться: заканчивающийся
например: например
несколько: несколько
грациозный: грациозные
превосходно: превосходно
рост: рост роста
отходить: отходит
потомство: потомство потомству
густота: густоты
шотландия: шотландия шотландии
далматинец: далматинец
вне: вне
определяться: определяется
удобный: удобнее
резко: резко
к: ко
реклама: реклама
хилтон: хилтон
наклон: наклоном
постепенный: постепенную
завиток: завитка
глазница: глазницами
печёночный: печеночной
первый: первым первый первую первых
кровать: кроватью
линять: линяет
ладонь: ладонью
врождённый: врожденный
продавец: продавец
второй: второй
гончая: гончими
рекомендоваться: рекомендуется
напоминать: напоминает
привлекать: привлекали
воспитание: воспитание воспитанию
тестовый: тестовым
отрыскать: отрыщь
год: лет год году
один: одно одна одном
здоровый: здорового
выдёргивать: выдергивать
чау-чау: чау-чау
который: которыми которой которая которых которым которые которому который
завоевать: завоевать
метис: метисы
чернь: чернью
дирхаунд-подросток: дирхаунды-подростки
сайт: сайту
решение: решения
выращивание: выращивание
особенность: особенностей
горец: горцы
следствие: следствие
позволять: позволяет
добыча: добыче
полезно: полезно
получаться: получаются
схема: схеме
социализация: социализация
недуг: недугов
быть: будут
выводить: выводить
экстерьер: экстерьер
подкрепление: подкрепление
бежать: бегущей
конец: конце конец концов
протяжение: протяжении
тяга: тяги
ступень: ступеням
положение: положение
внешне: внешне
умиротворённый: умиротворенного
приблизить: приближенным
увольнять: увольнять
подготовительный: подготовительный
посредственный: посредственные
выводиться: выводилась выводились
натаска: натаске
земля: земли
описание: описание
объявление: объявлений объявления
начало: начало
стандарт: стандартом стандарт
лопатка: лопатки
одиночный: одиночное
округлый: округлые
угасание: угасанием
мускулатура: мускулатура
иной: иную иное
стоячий: стоячие
гребень: гребень
гибрид: гибрид
однако: однако
начальный: начальная
искренне: искренне
отварный: отварное отварном
отличаться: отличаются
респираторный: респираторной
глубина: глубины
поэтому: поэтому
консультация: консультацию
копирование: копирование
дружелюбный: дружелюбная
макроэлемент: макроэлементов
победа: победу
активность: активность
существовать: существует
помещение: помещении
дружелюбность: дружелюбность
указывать: указывающая
выслеживание: выслеживания
насечка: насечкой
силуэт: силуэт силуэтом
насыщенный: насыщенного
отзыв: отзывах отзывы
сужаться: сужающаяся
кошка: кошки
простоватый: простоватый
ореховый: орехового
выезжать: выезжает
отсутствие: отсутствии
животный: животному
оценка: оценки оценке
шум: шум
собачник: собачников
висячий: висячие
курсинга: курсинг курсинге
особь: особи особей
шотландец: шотландцев шотландцами шотландец
гав: гав
метка: метки
покупатель: покупателю
положительный: положительное
присутствие: присутствию
баланс: баланс
допустимый: допустимо
аллергический: аллергических
клетка: клетку клетка клетке клетках
актуально: актуально
акит: акита
породный: породным
назад: назад
преимущественно: преимущественно
планировать: планируете
кость: кости
отработка: отработка
гористый: гористой
сегодняшний: сегодняшний
локоть: локти
потеря: потерю
н: н
средний: средней
термин: термин
конина: конина
посещение: посещения посещении
приносить: приносят
творог: творог
сделка: сделки
впадать: впадают
консультационный: консультационные
наполовину: наполовину
основной: основные
охранный: охранные
скрещивать: скрещивали
повторение: повторении
проставить: проставили
матрас: матрасом
конечность: конечностей конечности
спуск: спуски
попадаться: попадается
средне: средне
случайный: случайный случайные
степень: степени
поднять: поднят
план: план плане
разведение: разведение разведения
по-настоящему: по-настоящему
постав: постава
экономия: экономии
изогнутый: изогнут изогнутая
разработать: разработали
компанейский: компанейских
продолжительность: продолжительность
аксессуар: аксессуары
аппетит: аппетитом
страховка: страховка
отлично: отлично
пёс: пес пса
усмотрение: усмотрение
испытание: испытание испытаниях
интересный: интересный интересна
попасться: попался
цвет: цвета
привставать: привстают
линия: линий
отдых: отдыха
вещество: веществ
койот: койотов
подход: подход
стандартный: стандартного стандартной стандартная
слегка: слегка
преследование: преследование
идеальный: идеальном идеального идеальная
обследование: обследованиях
доска: досках
ожидание: ожидания
носитель: носителями
фото: фото
элегантный: элегантна
описывать: описывавших
заодно: заодно
резервирование: резервирования
два: две
сам: самого самому
яндекс: яндекс
считаться: считаются
дефект: дефект дефекты
обожать: обожают
уголок: уголок
бега: бегах
режим: режим
ножницы: ножницы
хотеть: хотите
помета: помет помета
вызывающий: вызывающей
череп: череп
возрастной: возрастными
техника: техника
разный: разной разные
рад: рад
лапа: лапы
холка: холке
незнакомец: незнакомцу
взгляд: взгляде
журнал: журнал
скорректировать: скорректировать
высота: высота
пособие: пособия
месяц: месяца
делать: делать делают
художник: художника
экономить: экономит
гулять: гулять
э: э
количество: количества
покров: покров покрова
ортопедический: ортопедическим
болезнь: болезни
кенгуру: кенгуру
борзятник: борзятников борзятники
необоснованный: необоснованные
сторона: сторона
совершенно: совершенно
ребёнок: детей
либо: либо
требование: требование
костистый: костистого
древний: древнего
охота: охоте охота охоты охотой охоту
падение: падением
кардиомиопатия: кардиомиопатию кардиомиопатия
дисквалификация: дисквалификации
посетить: посетить
подвес: подвеса
говорящий: говорящий
силовой: силовые
корпус: корпуса
кобель: кобели кобелей кобель
весь: всему всем
условие: условиях
вольерный: вольерное
пушистость: пушистость
дальнейший: дальнейшей дальнейших
любящий: любящие любящего
являться: являются
перейти: перейти
пудра: пудру
реально: реально
опускание: опускание
из-за: из-за
главное: главное
костяк: костяком
легкоусваивать: легкоусваиваемые
псовый: псовыми псовой
поведение: поведение
оборона: оборону
бородка: бородка
менее: менее
многократный: многократном
свободный: свободных свободным
судьба: судьбе
уровень: уровне
прибытие: прибытия
белый: белая
терять: теряет
покрывать: покрывать
крипторхизм: крипторхизма
некрахмалистый: некрахмалистые
ка-де-бый: ка-де-бо
обстановка: обстановке
намерить: намерено
приобретать: приобретать
слишком: слишком
одиночество: одиночеству
обзавестись: обзавелись
рацион: рационе рацион
разнообразный: разнообразным
запрет: запрет
день: день
рука: рук
изящный: изящным
появляться: появляется
спина: спины спина
гигиена: гигиена
подросток: подростков
статус: статуса
жильё: жилье
относиться: относятся
небольшой: небольшие небольшой невелико
передний: передней передние
голубоватый: голубоватым
спереди: спереди
сочувствие: сочувствие
обводка: обводкой
постный: постное
чередовать: чередуя
прикус: прикуса
каменный: каменной
австралия: австралии
стоимость: стоимость
бывалый: бывалых
телятина: телятина
особенно: особенно
разрушительный: разрушительными
строго: строго
диван: диваном
грюнендалить: грюнендаль
достаточно: достаточно
обязательно: обязательно
свой: свое своего своих свои
хозяин: хозяина
приобретение: приобретением
выступление: выступления
промежуток: промежутках
какой-то: какое-то
накануне: накануне
обязать: обязан
редко: редко
группа: группе группа
показатель: показателей показатели
бесплатный: бесплатных
производить: производит
отнести: отнесенный
поводок: поводке
заниматься: занимаются
любитель: любителей
англия: англии
белок: белков
мечтать: мечтаете
несмотря: несмотря
исследователь: исследователи
вальяжный: вальяжными
купить: купить купленным купите
часто: часто
прямой: прямые
подкормка: подкормок
процедура: процедура
живой: живое
растрепать: растрепанный
допускаться: допускаются
принимать: принимает
простолюдин: простолюдинами
оф: оф
опрокидывать: опрокидывают
грудной: грудной грудная
осуществляться: осуществляется
свежий: свежем
что: чему
период: периоды период
случай: случаях
тысячелетие: тысячелетий
предок: предки
задача: задача
покатость: покатостью
совершенный: совершенную
столетие: столетии
переворачивать: переворачивать
ухо: уши
задаток: задатками
басенджи: басенджи
кто-то: кто-то
сожаление: сожалению
система: системы
привыкание: привыкание
микро: микро
потребность: потребности потребность
писательница: писательницы
достигать: достигающие
тепло: теплом
нежелательно: нежелательно
сердце: сердце
восстановить: восстановленная
поднимать: поднимать
чувствительный: чувствительны
угол: углы
старый: старых
выключать: выключает
одноклассник: одноклассники
кровь: кровь
скорее: скорее
путём: путем
квартира: квартиру квартира
занятость: занятости
историк: историки
аристократ: аристократов
мочь: можете
правда: правда
скорость: скорость
очередь: очереди
грудь: грудь
комфортозависить: комфортозависимые
тот: ту
показ: показ
движение: движении
мясо: мясо
взять: взять
дать: дали
шунт: шунт
выезд: выезды
бридер: бридеры
частый: чаще частой
мыслить: мыслить
поиск: поиск
захват: захват
получить: получить
плоский: плоская плоские
стремительный: стремительный
зуб: зубы зубов
вообще: вообще
расчёска: расческа
волосок: волосков
полезный: полезны полезных
некоторый: некоторые
углевод: углеводов
белые: белые
выглядеть: выглядят
сложение: сложение
шампунь: шампунем
испортить: испортит
обольщаться: обольщайтесь
явление: явление
цистинурия: цистинурия
направление: направлении
пятно: пятно
лежать: лежать
сторож: сторожа
дисплазия: дисплазии
сбоку: сбоку
сделать: сделано
нос: нос
ранний: раньше
чей: чьих
порок: пороки
хозяйский: хозяйского
линька: линьки линька
жизнь: жизни
нежирный: нежирная
они: ними
шанс: шансов
собаколичность: собаколичности
мир: мире
предположение: предположениях
легенда: легенды
затем: затем
вид: виде вид
длительный: длительных
видеть: видит
пространство: пространства
нож: ножа нож
желанный: желанным
ассоциация: ассоциаций
сородич: сородичи
обучение: обучение
нужно: нужно
мимимишность: мимимишности
датский: датской
также: также
съесть: съеден съесть
умный: умная
что-нибудь: чем-нибудь
жилище: жилища
предел: предел
лерчер: лерчерам
момент: моменты момент
возможно: возможно
заяц: зайцев
экскурсия: экскурсиями
прокачивать: прокачивать
груминговый: груминговую
поясница: поясница
прогулка: прогулок прогулке
обычный: обычных
переквалифицироваться: переквалифицировались
короткий: короткой
ранее: ранее
агрессия: агрессию
поваляться: поваляться
чёрный: черной
порог: порог
сложно: сложно
аскетичный: аскетичное
стоить: стоит
это: это
придумать: придумать
жир: жиров
портретист: портретиста
северный: северной
загородный: загородное
зависеть: зависит
отворачивать: отворачивать
ловля: ловле
обучать: обучать
крупный: крупные
тёмно-коричневый: темно-коричневого
молодец: молодец
подобный: подобных
ряженка: ряженка
охотиться: охотились
труд: трудом
качество: качества
отдельный: отдельных
годиться: годились
версия: версия
заинтересованность: заинтересованность
клан: клана
необычный: необычной
легко: легко
неудачный: неудачным
спорт: спортом
выносливость: выносливость
устраивать: устраивают
лента: ленту
вызывать: вызывать
следующий: следующее
производитель: производителей производители
здоровье: здоровье
покатый: покатого
порция: порции
вверх: вверх
изменить: изменить
интенсивно: интенсивно
произвести: произвести
велосипед: велосипедом
покрыть: покрыт
товарищ: товарищами товарищ
подумать: подумает
американский: американская
уверить: уверены
жила: жилах
подозрение: подозрении
говорить: говорит
английский: английского
покупка: покупке
усиливать: усиливают
справиться: справится
стремиться: стремитесь
вакансия: вакансии
фенотипически: фенотипически
этап: этапа
приходиться: приходится
город: города
спортивно-подтянутый: спортивно-подтянутое
встречаться: встречается
уживаться: уживающиеся
сосредоточить: сосредоточено
зимний: зимний
сцепление: сцепления
вор: вора
выше: выше
маленький: меньше
переходящий: переходящие
пищеварение: пищеварением
кошачий: кошачьих
охотник: охотников
изобразить: изображена изображен
комплекс: комплекс
чересчур: чересчур
тёмно-серый: темно-серая
оказывать: оказывать
аристократизм: аристократизм
охватывать: охватывать
прислушаться: прислушаться
воля: воле
гармоничный: гармоничной
большинство: большинство большинства
бигль: бигль
заболеть: заболеть
главный: главная
практически: практически
родство: родство
рейтинг: рейтинг
ученик: ученики
объём: объем
рыжий: рыжая
мнение: мнению
подписываться: подписывайтесь
двигаться: движется
металлический: металлический
свод: сводом свод
самостоятельно: самостоятельно
дикси: дикси
затягиваться: затягивается
запретить: запрещено
очень: очень
обычно: обычно
возрождение: возрождения
вина: виной
умение: умение
произойти: произошло
несложный: несложная
узнать: узнайте
наиболее: наиболее
демонстрация: демонстрация
наоборот: наоборот
постепенно: постепенно
голый: голые
кличка: клички
скармливать: скармливать
правило: правила
отпускать: отпускать
касаться: касается
подъём: подъемы
молодой: молодых моложе
дело: деле
подлежать: подлежат
одновременно: одновременно
отработать: отработайте
горбинка: горбинкой
мутация: мутации
проект: проекте
сразу: сразу
грабли: грабли
перспективный: перспективный
герберт: герберта
разрешить: разрешены
кольцо: кольца
придавать: придающая
кг: кг
необходимость: необходимости
пристальный: пристального
загонный: загонной
сидеть: сидеть
среднее: среднего
риск: риск
развитие: развитием
складка: складкой
ответ: ответ
реакция: реакций
общий: общая
страна: страна
рф: рф
интерьер: интерьер
практический: практическим
отрыв: отрыве
плита: плите
сустав: суставов
меняться: меняется
малый: малейшем
использоваться: использовались
лизнуть: лизнуть
вариант: варианты
ответственный: ответственном
причём: причем
финансовый: финансовая
энергия: энергии
родитель: родителей
кормление: кормление
загнать: загнать
превращаться: превращаются
обновлять: обновлять
губа: губы
трусливость: трусливость
доступный: доступными
сдержать: сдержанных
таз: таза
гораздо: гораздо
данный: данную
г: г
трансформироваться: трансформируется
гэльский: гэльскими
тормашки: тормашками
пет-класс: пет-класса
действовать: действовал
шаг: шаг
какой: каких
