травмированный: травмированную
психически: психически
овощ: овощи
поддержание: поддержание поддержания
кинолог: кинологов кинологи кинолог
короткошёрстный: короткошерстной короткошерстные короткошерстный короткошерстных
колебаться: колеблется
средний: средняя среднее средних средней средний
опыт: опыт
расти: растет
включаться: включаются
использоваться: используются
сколько: сколько
высокий: высока высокие
упадок: упадок
название: название названия
эталон: эталон
собака: собаку собаками собакой собак собака собаки
прижимание: прижимание
позиционироваться: позиционируется
губа: губах губы
физический: физических физической физическая
обсуждение: обсуждения
суровый: суровых суровые
отношение: отношениях отношение
рыбный: рыбное
маломобильный: маломобильного
бить: бить
привлечение: привлечением
цена: цена
копытный: копытным
длинноголовый: длинноголовых
материал: материалов
рыбий: рыбий
ферма: ферм фермах
спокойный: спокойнее спокойными
расчёска: расческой
поведение: поведения поведению
миниатюрный: миниатюрные
нюанс: нюансы нюанс
дисквалифицировать: дисквалифицирующие
больший: большим
скапливаться: скапливаются
режим: режиму режим
субпродукт: субпродукты
поголовье: поголовье
холка: холку холке
россия: россия россии
вычёсывать: вычесывают
рекомендовать: рекомендовано рекомендуют
морда: морде морда
обратный: обратная
представитель: представителей представитель представители
команда: команду команд команда
занятие: занятий
штанишки: штанишками
шея: шея шее
волос: волосом волос волоса
овчарка: овчарки овчарок овчаркам овчарке овчарку овчарками овчарка
развитой: развитым развит развитой
выраженный: выраженных
шерсть: шерсть шерсти шерстью
тупеть: тупеет
челюсть: челюсти
должный: должны должен должна
бровь: бровей
тип: тип типа
породный: породного породных
содержать: содержать
встреча: встречам
взгляд: взгляд
исключение: исключение
езда: езде
сохранение: сохранения
человек: людям людей человека человеком
голосистый: голосистые
пастуший: пастушья пастушьей
реагирование: реагирования
жесткошёрстный: жесткошерстная жесткошерстный жесткошерстных жесткошерстной жесткошерстного жесткошерстные
овечий: овечьими
золотистый: золотистая
равно: равно
экземпляр: экземпляра
отличаться: отличается
сок: сок
быстрый: быстрого
важно: важно
превратиться: превратится
загонять: загоняла
сытость: сытости
душа: душе
школа: школа
история: история историей
навыкате: навыкате
камера: камеры
щенок: щенка щенков щенки щенок
успешно: успешно
пастух: пастухи
питомец: питомцев питомец питомцы
итог: итог
описывать: описывает
голова: голове головы голова
кисломолочный: кисломолочные
характеристика: характеристика характеристики
выставка: выставках выставки
доставщик: доставщиками
полицейский: полицейских
попрощаться: попрощаться
год: годы год
война: войны
хрящ: хрящ
порода: породе породы породу порода породой
весёлый: веселым
маска: маска
наполнитель: наполнителями
копытное: копытных
контролировать: контролирующую
приоритет: приоритете
первый: первой первого первый первую первых
чистый: чистых чистыми чистым
основное: основном
раз: раза
видео: видео
длинношёрстный: длинношерстных длинношерстного длинношерстной длинношерстная
грубый: грубый
демонстрировать: демонстрирующая демонстрирует
характер: характере характеру характер
дог-фрисби: дог-фрисби
пышный: пышными
подопечный: подопечные подопечного
гладкошёрстный: гладкошерстные
нестабильный: нестабильные
комиссия: комиссией
тело: телу теле тело
владелец: владельца владельцев
одобрение: одобрение
такой: таких таким
продажа: продажей
рацион: рациона рацион
хороший: хорошим хорошие лучшего лучший хорош хорошими хорошая хорошее лучших
содержание: содержание содержанию содержания
корректно: корректно
сера: серы
гиперактивность: гиперактивность
работа: работе работами работы работам
очистка: очистки
тигровин: тигровины
хвост: хвосте хвостов хвоста хвост
голод: голода
характеризоваться: характеризуется характеризуются
ринг: ринге
борода: бороду
вейтпуллинг: вейтпуллинге
реагировать: реагировать
численность: численность
родить: рождено
окрас: окраса окрас
подбор: подбором
голландец: голландцы голландцев голландца голландец
орган: органов органах
подвес: подвес подвеса
масло: масло масла
игрок: игрок
связь: связь
точно: точно
служебник: служебников
клуб: клуб
покрыть: покрыты
система: система системе
вода: воде
кура: кур
приход: приходе
расслабляться: расслабляться
работать: работающая работать работающие работали работает
военный: военные
исполнять: исполняют
бедро: бедра бедрах
пока: пока
полный: полная
профессиональный: профессиональных
прямой: прямыми прямая прямой
яйцо: яйца
лёгкий: легким легкий
типичный: типичный
жила: жилы жилах
давать: давать дают
плюсна: плюснами
уровень: уровнем уровню
наполнить: наполнена
спортивный: спортивные спортивных
прочный: прочным
прилегать: прилегающим
плотно: плотно
овчарка-универсал: овчарка-универсал
качество: качестве качества
срываться: срывается
смотреть: см
бельгийский: бельгийские бельгийских бельгийским бельгийскими
фотография: фотографии
четвероногий: четвероногие четвероногого
современный: современные современного
уход: уходе уход
хердёр: хердерами хердер хердеры хердеров хердера хердерам
социализировать: социализировать
чёрный: черная черного черными
овцеводство: овцеводство
питомник: питомники питомникам
классический: классического
взрослый: взрослой
сложение: сложения сложение
отдавать: отдавать
глаз: глаза глаз глазах глазами
проведение: проведении
прийтись: придется пришлось
мягкий: мягкий
незнакомый: незнакомым
количество: количеством
ус: усы
форма: форме
собачий: собачьей
продукция: продукцией
светить: светит
обожать: обожает
консультировать: консультирует
правило: правилам правила
неизбежный: неизбежны
бельгиец: бельгийцев
покупать: покупать
уплощённый: уплощенный
краткий: краткая
общий: общую общих
рассматриваться: рассматривается
выявить: выявленным
компаньон: компаньона
запрягать: запрягали
заболевание: заболеваниям
плотный: плотная плотные
поясница: поясницей
образовать: образующая образуют
пищевой: пищевая
сородич: сородичей
корм: кормами
эксперт: экспертов
факт: факт
доверить: доверить
вконтакте: вконтакте
скрывать: скрывают
создать: создать
тазобедренный: тазобедренных
роль: роль
отличительный: отличительная
кожа: коже кожу
ценник: ценник
животное: животных животным животного животные животное
существование: существования
интеллектуальный: интеллектуальная интеллектуальные
ножницеобразный: ножницеобразного
длина: длины длиной
тон: тон
выбрать: выбрать
экспонирование: экспонирование
углевод: углеводы
двор: двору дворе
российский: российские
поддержка: поддержку
мнение: мнения
оба: обеих оба
рабочий: рабочим рабочих рабочие
основать: основана
шёрстный: шерстного
хотя: хотя
старание: старании
присмотр: присмотра
редкий: редкой редкая
сельский: сельская сельских
сам: сами сама
видный: видны
корова: коров
взъерошить: взъерошенный
шоу-класс: шоу-класс
установить: установить
который: которую которой которая которых которым которые которому
программа: программу
миозит: миозит
атмосфера: атмосферу
звук: звукам
свободно: свободно
собаководство: собаководства
текстура: текстуры
заметный: заметный заметным
собака-психопат: собаку-психопата
квартира: квартире
трудоголик: трудоголиков
поощрительный: поощрительные
аллергия: аллергию
мера: меру
злаковый: злаковыми
информация: информация
обладать: обладает
подходить: подходит
максимально: максимально
создание: создание
жир: жир
палец: пальцами палец
охранник: охранников
гребень: гребнем
баловать: баловали
сначала: сначала
спинка: спинка
выбор: выбор
ниже: ниже
улица: улицы
обитание: обитания
сложный: сложных сложное
крепкий: крепкие крепкое
форбруст: форбрустом
польза: пользу пользы
ощупь: ощупь
уязвимость: уязвимости
восстанавливать: восстанавливать
дом: дом дома доме
племенной: племенной
пушистый: пушистыми
любой: любое
лапа: лапах лапы
природный: природным
крупа: крупы круп
категорически: категорически
продолжительность: продолжительностью
гасить: гасить
одинаковый: одинаковое одинаковым
ость: ости ость
армейский: армейская
пол: полу
загрязнение: загрязнения
развитый: развитый
водить: водить
подчеркнуть: подчеркнуто
повторение: повторений
пёс: псов пес
фрукт: фрукты
скот: скотом скот
возрастной: возрастной
домашний: домашней домашним
мировой: мировой
низкий: низкая
обходиться: обходится
соплеменник: соплеменники соплеменников
заниматься: занимающимся занимается
мотивация: мотивация
добавить: добавьте
объяснимый: объяснима
молодой: молодой
умный: умен умная
дог-шоу: дог-шоу
умеренный: умеренная умеренной
происхождение: происхождения происхождение
необходимо: необходимо
течь: течет
выкладка: выкладка
расписываться: расписывается
промышленный: промышленными
клиновидность: клиновидность
частично: частично
аккуратный: аккуратные аккуратном аккуратным
задний: задние задних
дрессировка: дрессировка дрессировке дрессировки
мясной: мясным
время: время времени
приспосабливаться: приспосабливается
сука: суки сук
плохой: хуже плохой плохую
агрессивность: агрессивность
ушной: ушной
формировать: формирует
практиковать: практикующий практикуют
жёсткий: жесткий жесткую
перемещаться: перемещаться
другой: другие другими
голландский: голландским голландская голландские голландских голландской
хозяин: хозяином хозяина
параллельно: параллельно
характерный: характерна характерной
место: местах
охрана: охраны
участник: участниками
отличный: отличная
рост: рост
потомство: потомство
инициатор: инициаторами
скрытый: скрыты
воротник: воротником воротник
регистрация: регистрацией
твёрдый: твердые
резко: резко
положительно: положительно
реклама: реклама
наклон: наклоном
небольшой: небольшую небольшой
променад: променадами
необходимый: необходима необходимую
второй: второй вторая вторыми
период: периодами периоды период
определённый: определенном
рекомендоваться: рекомендуется
вывезти: вывезли
воспитание: воспитание воспитании воспитанием
подарить: подарившие
куриный: куриные
ласковый: ласков
влиять: влияют
распознавать: распознавать
цветовой: цветовые
сайт: сайту
тяга: тягу
чрезмерный: чрезмерных
бывать: бывает
предмет: предметам
периодический: периодических
стая: стаей
занять: занять
понять: понять
мощный: мощная мощные
полезно: полезно
получаться: получаются
отдача: отдачи
калорийность: калорийность
вариант: вариант
немецкий: немецким немецкими немецкие
тримминговать: триммингуют
адаптировать: адаптировать
форум: форум форуме
спорт: спорта спортом
подкрепление: подкрепление
предпочтение: предпочтение
сторож: сторожем сторожа
незначительный: незначительной
просматриваться: просматриваться
капля: капли
положение: положение
любитель: любитель
позволять: позволяющая позволяла позволяющий
выводиться: выводилась
задействовать: задействуют задействовать
описание: описание
рано: рано
начало: начало
терпимый: терпима
выгул: выгулы
послушание: послушанием
ускорить: ускорить
звезда: звезд
налёт: налета
пробраться: пробраться
найти: найти
гречневый: гречневая
длинный: длинный длинная
однако: однако
поэтому: поэтому
непослушание: непослушание
предлагать: предлагают
копирование: копирование
дружелюбный: дружелюбная дружелюбен
привыкать: привыкать
активность: активность активности
существовать: существует
близкий: близки
дружелюбность: дружелюбность
прибегать: прибегать
грузить: грузили
подвижный: подвижные
отзыв: отзывах отзывы
нога: ноги ногах
крупный: крупных крупные
неугомонный: неугомонных
кошка: кошки кошек кошками
нереально: нереально
пытаться: пытавшихся пытаться пытаясь
шум: шум
масть: мастью
собираться: собирается
особь: особи особям особей
процедура: процедуры
метка: метки
покупатель: покупателю
отличие: отличие
тигровый: тигрового тигровой тигровые
смена: смену
универсальный: универсальная
слой: слоем
ощутимый: ощутимый
наш: наши
требовать: требовали
настоящий: настоящий
впитывать: впитывать
ламинария: ламинария
плавный: плавным
германия: германию
отдать: отданный
голос: голоса
ухо: ушей ушах уши
трение: трения
объявление: объявления
миндалина: миндалин
сделать: сделать сделано
дешёвый: дешевыми
густой: густого
основной: основные
интеллект: интеллект
охранный: охранные
негативный: негативное
вес: вес
сторожевой: сторожевой
план: план
конец: конец
возраст: возраст возраста возрасте
ежедневно: ежедневно
газета: газетой
нос: носа нос
разведение: разведение
кипячёный: кипяченой
планироваться: планируется
доля: долей
приучать: приучают приучали
запретительный: запретительных
поплавать: поплавать
сверхэнергичный: сверхэнергичен
идентифицировать: идентифицировать
курс: курс
прожорливый: прожорливых
преимущество: преимущество преимущества
линия: линия линий
потенциал: потенциалом
кричать: кричать
трудиться: трудилась
интересный: интересный
опустить: опущен
мышца: мышцами
молочный: молочной молочных
развитие: развития развитием
размер: размера
закладываться: закладываются
преданность: преданности
учиться: учиться
слегка: слегка
фото: фото
переходящий: переходящая
нидерланды: нидерландов нидерландах нидерланды
яндекс: яндекс
раскосость: раскосостью
состав: состав
стереотип: стереотипы
вперёд: вперед
череп: череп
вставать: встают
спина: спиной
сбрасывать: сбрасывают
фрисби: фрисби
повышенный: повышенный
журнал: журнал
высота: высота
селянин: селянин
томатный: томатный
рассчитывать: рассчитывают
чей: чьи
страна: стране страна
увеличивать: увеличивают
участие: участии
расположить: расположен
еженедельно: еженедельно
покров: покров покрова
превосходный: превосходные
болезнь: болезни
поисковик-спасатель: поисковиком-спасателем
один: одной одни
огород: огород
совершенно: совершенно
упражнение: упражнения
либо: либо
отработка: отработке
шкала: шкале
начинать: начинать
будущий: будущих
прийти: пришло
топтать: топтать
помучиться: помучиться
отход: отходы
условие: условиям условиях
присматриваться: присматриваться
усиливать: усиливает
остаться: осталось
кобель: кобели кобелей
плохо: плохо
сопровождаться: сопровождаться
вольерный: вольерное
дело: дело
день: дня дни
основательность: основательностью
перейти: перейти
дойка: дойку
гонять: гоняла
статус: статус
ткань: ткани
из-за: из-за
костяк: костяком
сушёный: сушеная
слово: слова
собранный: собранными
внимательный: внимательные
приструнить: приструнить
менее: менее
слуховой: слуховые
складка: складок
разновидность: разновидностях
слишком: слишком
одиночество: одиночеству
никто: никто
хвалить: хвалить
коготь: когтями
подшёрсток: подшерсток подшерстка
опубликовать: опубликован
разнородный: разнородного
габарит: габаритов
отнести: отнести
пигментировать: пигментированные
намотать: намотав
различать: различал
конфликт: конфликтов
собственный: собственную
семья: семью
перепелиный: перепелиные
ощущение: ощущения
передний: передней передние
книзу: книзу
оценка: оценке
нагрузка: нагрузок
бдительность: бдительности
загородный: загородная загородное
тот: тому
требование: требованиям
разрешение: разрешений
холодный: холодной
мочка: мочка
территориальный: территориальным
пастьба: пастьбой
оповещать: оповещала
ряд: ряды
вырабатывать: вырабатывают
испытывать: испытывает
социализация: социализацией
лесной: лесной
неделя: недель неделю
целенаправленно: целенаправленно
каждый: каждый
копировать: копируя
интересоваться: интересуются
короткий: короткие короткая
глубокий: глубокая
ассоциация: ассоциация
часть: часть
иметь: имеет иметь имеют
стоимость: стоимость
подойти: подойдут
поле: поля
пучок: пучки
особенно: особенно
сухой: сухая сухими
новый: новым
австралийский: австралийская
желательно: желательно
забредать: забредать
час: часов
штаны: штанами штаны
поисково-спасательный: поисково-спасательным поисково-спасательными
включать: включать
предельно: предельно
расслабить: расслабленной
достаточно: достаточно
дрессировать: дрессировать
обязательно: обязательно
стимулировать: стимулировать
контакт: контактов
клетка: клетке
серьёзный: серьезной
угощать: угощать
городской: городского
кровь: кровей кровь
специальный: специальные
переживать: переживают
стэнли: стэнли
поводок: поводке
пасти: пасет
охотно: охотно
несмотря: несмотря
ходить: ходить
растительный: растительные
купить: купить
желать: желал
инстинкт: инстинктом инстинкт
леонбергер: леонбергер
тщательный: тщательным
выступать: выступают
сторонний: сторонних
сильный: сильную сильными
тележка: тележку
вертикально: вертикально
грудной: грудной
гость: гостей
механический: механической
охранять: охраняющая
партнёр: партнера
задача: задача
аджилить: аджилити
недостаток: недостатки
хозяйка: хозяйкой
заметить: заметила
предупреждать: предупреждает
контролироваться: контролируется
убирать: убирают
освобождать: освобождать
независимый: независимые
привыкание: привыкание
этот: этих
поощрение: поощрение
усвоить: усвоить
дисплазия: дисплазию
интуиция: интуиция
завершить: завершил
бжу: бжу
эффект: эффект
весь: всем
вероятность: вероятность
овца: овцами
дисциплина: дисциплинах
р: р
отбирать: отбирать
участвовать: участвуют
одноклассник: одноклассники
марка: марки
запрет: запретов
прислать: пришли
мочь: можете
овсяный: овсяная
клад: клад
здоровье: здоровья здоровье
грудь: грудь
случайный: случайные
самодостаточность: самодостаточности
кроме: кроме
мясо: мясо
группа: группа группы
мускулистость: мускулистостью
полиция: полиция
принудительный: принудительные
доминанта: доминанта
приказ: приказ
три: трех
сослужить: сослужить
щенячий: щенячьем щенячьего
частый: чаще
поиск: поиск
доминировать: доминирующее
салфетка: салфетку
зуб: зубы зубов
плоскоскулый: плоскоскулых
свой: своей своих
вязать: вязали
себя: собой
белые: белые
родственник: родственник
генетический: генетическим
вельштерьер: вельштерьер
ершистый: ершистой
бесплатный: бесплатные
сбой: сбоев
предложить: предложат
поощряться: поощряется
служба: службу
нормальный: нормального
зрение: зрения
корить: корена
независимость: независимость
игра: игры
погибнуть: погибла
гигиенический: гигиенические
потребность: потребность
порок: пороки
восторг: восторга
память: память
повод: повод
предок: предков
сократиться: сократилось
генофонд: генофонд
линька: линьки линька
два: двух
остальной: остальном
абсолютно: абсолютно
подсказка: подсказок
рука: руку
девочка: девочки
затем: затем
консультация: консультации
вид: виде
настороже: настороже
изгиб: изгибом
психический: психического
синхронно: синхронно
успех: успехи
посещать: посещать
нужно: нужно
мимимишность: мимимишности
принять: принять
слепота: слепоты
пара: паре
также: также
экстерьер: экстерьера
процесс: процесс
идеал: идеале
достаточный: достаточной
чистка: чистке
переломный: переломный
нерафинированный: нерафинированные
любимец: любимца
момент: моменты момент
проход: проходы
нежирный: нежирные
белок: белок
возможно: возможно
человеческий: человеческого
овал: овала
старший: старшего
корпус: корпус
стандарт: стандарт
живот: живота
шлепок: шлепок
прогулка: прогулок
кр: кр
друг: друга
переквалифицироваться: переквалифицировались
упустить: упустить
подобие: подобие
умеренно: умеренно
норма: норма
отар: отарами
изначально: изначально
выставочный: выставочную выставочных
тёмный: темный
служебный: служебным
лакомство: лакомства
управляться: управлялись
сложно: сложно
крайне: крайне
стоить: стоит
это: это
воспитанный: воспитанная
разный: разных
связка: связок
существо: существа
лакенуа: лакенуа
калораж: калораж
больной: больные
филе: филе
вариация: вариации
недешёвый: недешевая
исходить: исходя
сведение: сведению
обеспечить: обеспечат обеспечит
показатель: показатели
замечательный: замечательная
зубной: зубные
питаться: питается
явление: явлениям
посев: посевы
монопородный: монопородным
вязка: вязок
щётка: щетки
грубоватый: грубоватым
невозможно: невозможно
исполнительный: исполнительная
влажный: влажными
стандартный: стандартные
прыжок: прыжки
выполнять: выполняла
сезон: сезон
формироваться: формируется
использование: использование
разобрать: разобрать
легко: легко
прослойка: прослойка
выносливость: выносливость
идеально: идеально
лента: ленту
производитель: производителей
переход: переходом
лояльный: лояльны
управлять: управляющая
сочетание: сочетании
малыш: малыша
пора: порах
поддаваться: поддающиеся
гуляка: гуляка
специалист: специалист
повезти: повезло
подобрать: подобрана
серебристый: серебристая
дорогой: дороже
местный: местная
королевский: королевская
ркф: ркф
локтевой: локтевых
выход: выход
вакансия: вакансии
прямо: прямо
продукт: продукты
прикус: прикус
незнакомец: незнакомцев
постоянно: постоянно
подавлять: подавляющее
украсить: украшены
шутцхунд: шутцхунде
занятый: занята
сливочный: сливочное
исследование: исследование
чересчур: чересчур
темпераментность: темпераментность
рисовый: рисовая
большинство: большинство
главный: главная
рейтинг: рейтинг
пропорция: пропорции
машина: машине
подписываться: подписывайтесь
самостоятельность: самостоятельности
гониоскопия: гониоскопии
самостоятельно: самостоятельно
птица: птицей
учёба: учебе
запретить: запрещено
привлекать: привлекает
очень: очень
обычно: обычно
равноправный: равноправных
упоение: упоением
мелкий: мелким
умение: умение
несложный: несложная
ответственность: ответственности
страшно: страшно
кличка: клички кличку
черта: черта
держать: держать
касаться: касается
вырастить: вырастить
лидер: лидера
данные: данным
обрастать: обрастает
проект: проекте
паннус: паннус
игровой: игровая
кг: кг
необходимость: необходимости
вывести: выведенный
энергичность: энергичность
ученик: учеников
смочить: смоченным
дефект: дефектами
отзываться: отзываться
рф: рф
направлять: направлять
задействоваться: задействуется
внушение: внушение
важный: важный
кусочек: кусочком
сустав: суставов
жевательный: жевательный
волна: волне
причём: причем
кверху: кверху
кормление: кормление
конечность: конечности
шейка: шейки
гампр: гампр
жизнь: жизнь
малинуа: малинуа
родственный: родственна
пожилое: пожилого
родословный: родословными
приучение: приучением
хердер-клуб: хердер-клубом
предел: предела
угол: углов
паста: пасты
способный: способны
г: г
сообразительность: сообразительности
бег: бег
разводиться: разводятся
