придать: придать
необязательно: необязательно
процесс: процессе процесс
подстригать: подстригать
неоговорённый: неоговоренных
орган: орган
отдавать: отдавайте
тело: тела тело
американский: американских
средний: средняя среднее среднюю средней
принцип: принципе
скот: скота
продавец: продавцов продавца продавцом
параллельный: параллельные
необходимость: необходимость
агрессия: агрессия агрессии
четвероногий: четвероногих четвероногими четвероногом
сколько: сколько
соплеменник: соплеменниками соплеменникам
отвар: отваром
бодигарда: бодигард
чайный: чайным
упадок: упадок
название: название названия
невозмутимый: невозмутимого
разрешать: разрешает
собака: собаку собак собака собаках собаке собаки
примерно: примерно
сузить: суженный
боксёр: боксеров
обсуждение: обсуждения
отношение: отношениях отношение отношении отношения
сушка: сушке
свёкла: свекла
бить: бить
ваш: вашему
оно: оно
ретироваться: ретироваться
цена: цена
реальность: реальности
зачастую: зачастую
блеск: блеска
любой: любая любую
плен: плен
материал: материалов
испания: испания испании
оставить: оставить
идеальный: идеальные идеальный
познакомиться: познакомьтесь
массивный: массивным массивнее массивный массивная массивные
олений: оленьего
излишек: излишки
соприкосновение: соприкосновении
передний: передняя передними передней передние
мускулистый: мускулистыми мускулистые
сторона: стороны стороне
долгий: долгого
испанец: испанцы испанцев
дисквалифицировать: дисквалифицирующие
больший: большим
потенциально: потенциально
власть: власти
остановить: остановить
пробежка: пробежки
выраженный: выраженный
россия: россия россии
обладатель: обладателям
карьера: карьеру карьера
морда: морде морда
обратный: обратная
отчётливо: отчетливо
выворот: выворота
поляк: поляков
скорость: скоростью
радужка: радужки
ради: ради
представитель: представителей представителям
контроль: контролем
тренировочный: тренировочные
водка: водки
попробовать: попробовать попробуйте
нападение: нападение
косметика: косметики
шея: шея шее
сливаться: сливаются
исполнять: исполнять
песочный: песочного
шерсть: шерсть шерсти шерстью
низкий: низкий низкая
канарский: канарский канарские канарскому канарского канарским канарских
вводить: вводить
провести: провести
запрет: запрета запрет
уравнивать: уравниваете
шейный: шейной
запретить: запрещена запрещено
население: население
кинолог: кинологи кинологом
розовый: розовый
тенерифе: тенерифе
челюсть: челюсти челюстей
метод: метод методы методом
нежелательный: нежелательна
небольшой: небольшого небольшие небольшими небольшим
самый: самая самое самые
должный: должны должен должно должна
препятствовать: препятствовать
несложно: несложно
породный: породного породных породные
австралия: австралию
воблер: воблера
содержать: содержать содержат
предупреждение: предупреждения
протестировать: протестируйте
исключение: исключение
нерафинированный: нерафинированным
проглотить: проглотить
отмереть: отмерший отмершие
губа: губами губ губы
уступать: уступают уступать
звук: звуков звукам звуки
питомец: питомцами питомцев питомцы питомца питомцем
большой: большой большому
иметься: имеется имеются
беларусь: беларуси
участок: участки
присвоить: присвоили
чуткий: чутком
масть: масти масть
архипелаг: архипелага
включая: включая
отойти: отойдите
учитывать: учитывайте
сок: сок
формат: формат
участие: участием
важно: важно
главный: главный главная
способствовать: способствует
моментально: моментально
пытаться: пытайтесь пытается пытаются
дог: догом дога догу доги догов дог догам
история: история
месяц: месяцы месяцев
кто-то: кого-то кто-то
щенок: щенка щенков щенки щенком щенку щенкам
растительный: растительным
влиться: влиться
белок: белка
лепесток: лепесток
потрудиться: потрудиться
выгул: выгул выгула
живить: живя
успешно: успешно
уравновесить: уравновешенный
искусать: искусанные
попросить: попросите
мыть: моют
стимулировать: стимулирует
каждый: каждого
голова: голове голова
валяться: валяться
тигровый: тигровая тигрового тигровому тигровые
семья: семьи семье
регламентироваться: регламентируется
тесно: тесно
подобрать: подобранная подберет
воронка: воронки
характеристика: характеристика
быть: е
стоп: стоп
практика: практике
кабинет: кабинет
такой: таком
фигура: фигуры
поздний: позднее поздний
хозяин-новичок: хозяин-новичок
причина: причинам причине
выступать: выступает
распределяться: распределяются
заводчик: заводчик заводчиков заводчика заводчики
нет-нуть: нет-нет
следующий: следующие
пол: пола
прийти: пришел
еда: еды
коготь: когти
внушительный: внушительный
очередь: очередях
порода: породе породы пород породу порода
хрупкость: хрупкости
скотогонный: скотогонные
декоративный: декоративного декоративных
появление: появление
маска: маска маски
пёс: псу пса псом
быстро: быстро
добавлять: добавляют
первый: первой первые первое первую первых
входить: входят входит входить
напоминать: напоминающее напоминающие напоминает напоминать
основное: основном
присутствие: присутствия
удаться: удалось
видео: видео
подойти: подойдет
обязать: обязаны обязан
свисать: свисают свисающей свисающие
разрешаться: разрешается
придумать: придумали
меню: меню
племя: племенами
вода: воды
полностью: полностью
канарец: канарцами канарцам канарец канарца
заглотнуть: заглотнуть
смелость: смелость
владелец: владельца владельцев владельцу владельцы владельцами владельцем
домашний: домашнюю домашними
вечер: вечер
усваиваться: усваивается
содержание: содержание содержанию содержания
ген: гены генами
сера: серы
вписываться: вписываться
когтереза: когтереза
попытка: попытки
представление: представления
ширина: ширину
южнорусский: южнорусская
составлять: составляет
рекомендовать: рекомендуют
ринг: ринге
жить: живет живущие
холка: холки холке холкой
защита: защиты
охрана: охрану охрана
обнаружить: обнаружить
реагировать: реагировать реагируют
ноздря: ноздрями
окрас: окраса окрас окрасов
послушание: послушанию послушания
задача: задачей
глюкозамин: глюкозамином
смешиваться: смешиваясь
округлить: округленными
обеспечить: обеспечили
облик: облика обликом
кстати: кстати
связь: связь связи
появляться: появляться
бояться: боятся
надёжный: надежного
нетребовательный: нетребовательные
сформировать: сформировать
трусливый: трусливые
клуб: клуб
казахстан: казахстана
нарушить: нарушенных
единственный: единственный
формирование: формировании
спокойствие: спокойствия
переводиться: переводится
налёт: налет
бедро: бедра бедрах
сдать: сдавшие
травильщик: травильщики
проходить: проходить
пока: пока
уничтожаться: уничтожались
состояние: состоянии
внешний: внешние внешней внешних
официальный: официальный
яйцо: яйца
крупный: покрупнее крупных крупной крупными крупные
собака-лидер: собак-лидеров
ниша: нишах
лёгкий: легким легкое легкие
дважды: дважды
давать: давать
публичный: публичные
забота: забот
рекомендоваться: рекомендуются рекомендуется
конёк: конек
дальнейший: дальнейшему
канарцев: канарцев
частенько: частенько
жара: жары
завезти: завезли завезенными
ситуация: ситуацию ситуации
предмет: предметы
спортивный: спортивные спортивных спортивная
дрессировать: дрессируют
злобность: злобностью
притираться: притираются
выставка: выставки выставкам
воспитательный: воспитательном
плотно: плотно
качество: качестве качества
бывать: бывают
смотреть: см
племенной: племенную
купировать: купируя купированными купируют
плюс: плюс
фотография: фотографии
осматривать: осматривать
мастиф: мастифами мастифов
общественный: общественного общественных
помогать: помогает помогающим
работать: работать работает
уход: уходе уход
знать: знать
создание: создания
чёрный: черная черного черной черными
помнить: помните
зародиться: зародившаяся
страдать: страдать страдают
результат: результат
ряд: ряде
тестирование: тестирование
присутствовать: присутствует
питомник: питомники питомника питомниках
возникнуть: возникла возникло
богато: богато
глаз: глаза
летний: летний
район: районе
обзаводиться: обзаводиться обзаводясь
прийтись: придется
ранний: ранние ранняя раннее
сбросить: сбросить
корм: корм корма
выщипывать: выщипывать
список: списки список
вниз: вниз
часть: части часть частей
дый: дого
неприхотливый: неприхотливы
методика: методик методикам
количество: количеством
шотландский: шотландский
отменно: отменно
быт: быту
мясной: мясную
век: века веке век
собачий: собачьей собачьи собачий
малыш: малышу малышей малышам малыш
настой: настоем
существовать: существуют существовать существует
остальной: остальными остальной остальном
рядовой: рядовое
поскольку: поскольку
дом: домах дома доме
обучение: обучения
лишний: лишняя лишних
сука: сукам суки сук суку
неизбежный: неизбежны
краткий: краткая
стирание: стиранию
уроженец: уроженцы уроженцев
неправильный: неправильной
источник: источниками источником
овощ: овощей
эквивалентный: эквивалентно
место: место местах места
масса: массы
проморозить: промороженным
отдыхать: отдыхающими
весь: весь вся всем всеми
трение: трениям
эксперт: экспертов
климат: климата
драка: драки драку
создавать: создающего
питательный: питательной
обновить: обновили
следовать: следуя следует
любимец: любимцем любимцу любимца
вконтакте: вконтакте
рядом: рядом
актуальный: актуальна
пахта: пахту
кровожадность: кровожадности
создать: создать
далее: далее
тазобедренный: тазобедренных
ярко: ярко
хозяин: хозяин хозяином хозяина
среда: среде среду
средство: средств средства
отличительный: отличительная
ценник: ценник
транспорт: транспорта
животное: животных животным животного животными животные животное
один: одного одна
размер: размерах размер размера
разводить: разводимые
серьёзный: серьезная
сша: сша
свежий: свежими
выяснять: выяснять
доставщик: доставщика
затылочный: затылочным
увеличить: увеличить
сыр: сыром
волос: волос
миска: мисками
длина: длины длину
аминокислота: аминокислотами
выбрать: выбрать
экспонирование: экспонирование
пластика: пластика
снизить: снижен сниженной
желание: желании желание желания
птица: птица птицы
основать: основана
хотя: хотя
увлажнить: увлажненной
прикрывать: прикрывают
продукт: продуктов
протирать: протирая
допускать: допуская
кожа: кожу кожи кожей
редкий: редкой
который: которую которое которыми которой которая которых которым которые который
форма: форму формы
витамин: витаминов
учитель: учителем
проблема: проблемы проблем
свободно: свободно
намордник: наморднике
темперамент: темпераментом
заметный: заметный заметные
малайзия: малайзию
дать: даст данные
официально: официально
мера: меру меры
мирный: мирные
информация: информация
подходить: подходит
друг: друг друге другом друга другу
оттенок: оттенков
отличаться: отличавшиеся отличающихся
резиновый: резиновой
ретинопатия: ретинопатию
натуральный: натуральный
российский: российский российскими
сустав: суставы суставами суставов
палец: пальцами пальцах
курс: курсов
недоверие: недоверие
очередной: очередной
авторитет: авторитет
негативно: негативно
ниже: ниже
приподниматься: приподнимается
половина: половины
забыть: забыв
характер: характера характер
мириться: мириться
сообразительность: сообразительность
крепкий: крепкие крепким крепкая
неаполитать: неаполитано
агрессор: агрессора агрессорами
дикий: диких дикая
ягода: ягодами
сухой: сухой
переселение: переселение
классический: классический
габарит: габариты
сравнительно: сравнительно
число: число
подушечка: подушечками
кардиотренировка: кардиотренировки
это: этим это
веко: веки
гель: гели
распространить: распространенное
считаться: считается
развитой: развитыми развитой
коммуницировать: коммуницировать
тряпочка: тряпочку тряпочкой
формально: формально
загрязнение: загрязнения
спрей: спреи спреев
вручную: вручную
просто: просто
обусловить: обусловлена
катать: катающего
плодиться: плодились
мало: мало
норматив: нормативы
пара-тройка: парой-тройкой
встать: встало
развитый: развитый
питие: питья
синдром: синдром
подчеркнуть: подчеркнуто подчеркнуть
какой-то: каким-то
прочий: прочих
принять: принято принять
оценочный: оценочной
режим: режима
взяться: возьмись
утяжелитель: утяжелителями
гуанча: гуанчей
упускать: упускать
неприятный: неприятным
территория: территории территориях
заменить: заменить
лес: лесу
повлиять: повлияет
женский: женского
приводить: приводят
засчитываться: засчитываются
выселять: выселять
глазной: глазные
добавить: добавьте добавив
чистка: чистка чистки
диагностика: диагностика
остановиться: остановиться
животный: животном животному
сфера: сферы сферой
отвлекать: отвлекая
черта: чертах черта
пушистик: пушистика
умеренный: умеренная умеренное
происхождение: происхождения
необходимо: необходимо
морковный: морковную
сгладить: сглаженным
понимать: понимают
наследовать: наследуют
стандартизировать: стандартизировали
выходец: выходцы
слюна: слюной
частично: частично
свой: своем своим своего своей своих
соотношение: соотношение
груз: груз
подобный: подобное
дрессировка: дрессировку дрессировка
обыватель: обыватели
скромный: скромнее
стандартный: стандартный стандартные
время: время времени
агрессивность: агрессивность
жёсткий: жесткий жестким
родительница: родительницы
деятельность: деятельности
перечисленный: перечисленных
пясть: пясти
другой: другие других другими
родственник: родственников
кусаться: кусаться
малоопытный: малоопытному малоопытные
отнять: отнять
каштановый: каштанового
зарычать: зарычало
фенотип: фенотип
окружающий: окружающего окружающими окружающих
например: например
подопечный: подопечными
обнаружиться: обнаружились
позвоночник: позвоночник
сведение: сведений
рост: рост
потомство: потомство
крутой: крутой
кондиционер: кондиционеров
закон: законом
удобный: удобнее
хотеться: хочется
оценка: оценку оценке
девочка: девочек
совет: советы
твёрдый: твердые твердыми
к: ко
реклама: реклама
мясо: мясом мяса мясо
наклон: наклоном
исполниться: исполнится
нюанс: нюанс
ротвейлер: ротвейлеров
базовый: базовые
здоровый: здорова здорового здоровые
махореро: махореро
обладать: обладало
ложиться: ложится
флегматичный: флегматичный
посадка: посадки посадку
мускулатура: мускулатурой
незначительный: незначительным
немедленно: немедленно
второй: второй
весовой: весовая
удлинённый: удлиненного удлиненными
окд: окд
огородить: огороженной
мочка: мочки мочка
обильный: обильным
проявляться: проявляются
воспитание: воспитание
генотип: генотипа
контактировать: контактировать
достигать: достигает
смочить: смочить смоченной
год: лет год году
куриный: куриные
дичь: дичи
вид: виду виде
обеспечивать: обеспечивающие
гулять: гуляй гулять
стать: стало стать
процедура: процедур
сайт: сайту
черепной: черепной
задний: задних
прес: преса
выбор: выбора
полезно: полезно
социализация: социализация социализацией
прохождение: прохождения
атлет: атлету
этот: эта этих
саблевидный: саблевидную
лишь: лишь
вариант: вариант
гран-канария: гран-канария
стрижка: стрижка
выводить: выводить
комплексный: комплексную
иметь: имеющий имеет иметь имеющие имеют
форум: форум форуме
печень: печень
заворот: завороту
предпочтение: предпочтение
протяжение: протяжении
хрящевой: хрящевой
запах: запахам
последствие: последствиям
подростковый: подростковый
профессия: профессий
внести: внесена
характерный: характерным характерная
утренний: утренних
раствор: раствор
супермен: суперменом
порой: порой
психотип: психотип
положение: положение
манипуляция: манипуляции
внешне: внешне
переборщить: переборщить
бойцовский: бойцовскими бойцовскую бойцовских
спокойный: спокойны спокойной
дешёвый: дешевые
резкий: резких резкие
конкурировать: конкурирует
столовый: столового
маленький: поменьше меньше
описание: описание
неаполитанский: неаполитанских
начало: начало
многое: многое
инициировать: инициируют
куба: куба
стандарт: стандартом стандарта стандарт
подчиняться: подчиняться
догов-подросток: догов-подростков
овсяный: овсяную
доверительный: доверительные
поиск: поиске поиск
глубоко: глубоко
длинный: длинный длинная
раздражитель: раздражителей
коллектив: коллектив
миссия: миссией
фитолосьон: фитолосьоне
национальный: национальный
выкат: выкате
костюм: костюму
полагаться: полагаться
подъём: подъемом
свободный: свободный свободное
поэтому: поэтому
радикальный: радикальные
предлагать: предлагают
копирование: копирование
короткий: короткий короткая короткой
трудно: трудно
далёкий: подальше
предках-мастиф: предках-мастифах
пройти: прошли
активность: активность
основание: основания основанием
дружелюбность: дружелюбность
незнакомец: незнакомцам
тип: типах типа типы
мясник: мясникам
отзыв: отзывах отзывы
слюнотечение: слюнотечением
бугор: бугром
рассудительный: рассудительны
коренной: коренное коренными
сужаться: сужающаяся
походить: походить
кошка: кошки кошек
комиссия: комиссии
пропорция: пропорций
центр: центр
нереально: нереально
сторожить: сторожить
отсутствие: отсутствии отсутствие
частный: частной
шум: шум
расслоение: расслоению
собачник: собачников
усложнять: усложняет
особь: особи особей
метка: метки
гладиатор: гладиаторы гладиаторов
уровень: уровня уровень
широкий: широким широкая
верхний: верхние
прямой: прямая
испанский: испанских испанские испанского
планировать: планируете
поначалу: поначалу
сеттер: сеттер
мочь: могут можете
локоть: локти
влияние: влияния
автоматизм: автоматизме
кровать: кровати
обезжиренный: обезжиренный
полно: полно
творог: творог
ухо: ушей уши
двор: двор
объявление: объявления
бульдог: бульдогов бульдог бульдогами
основной: основные основной
новый: новую
важный: важна важная важный
интеллект: интеллект
охранный: охранные
вес: вес
стаффорд: стаффордов
сторожевой: сторожевой сторожевым
покупать: покупал
считать: считающий
конец: конец
попытаться: попытается
бордер-терьер: бордер-терьер
ежедневно: ежедневно
противопоказанный: противопоказана
нос: носа носом нос
круповой: круповой
разведение: разведение разведению
планироваться: планируется
сухарик: сухариками
переносить: перенося
именно: именно
полезный: полезные полезных
серьёзно: серьезно
рот: рта
выбрасывать: выбрасывать
визгливый: визгливого
ответственность: ответственность ответственности
продолжительность: продолжительность
поучаствовать: поучаствовали
мастино: мастино
заботливый: заботливом
качка: качки
член: членов
ввоз: ввозу
отлично: отлично
расположить: расположенные расположенными
линия: линия линий
конфликтовать: конфликтуют
молоссоподобный: молоссоподобный молоссоподобным молоссоподобных
зуб: зубами зубы зубов
кричать: кричать
короче: короче
опустить: опущен
прес-канарио: преса-канарио
бросаться: бросаться
смычка: смычка
счёт: счету
отдельный: отдельной
полотно: полотно
основный: основным
диагностировать: диагностируют
выгнутый: выгнутыми
помощь: помощи
домочадец: домочадцами
слегка: слегка
ценность: ценности
опасный: опасных опасной
область: областях
сжатый: сжатыми
остров: островах
фото: фото
показать: показать
хлеб: хлеба
кончик: кончика
многоочаговый: многоочаговую
выгода: выгоду
игрушка: игрушек игрушки игрушку
брахицефал: брахицефал
готовый: готов
шоу-питомец: шоу-питомец
термический: термическую
яндекс: яндекс
водоросль: водоросли
канарцы: канарцы
шоу-особь: шоу-особями
нести: нести
хотеть: хотите
подбор: подбора
череп: черепа череп
общий: общей
стружка: стружку
стартовать: стартовали
лапа: лапы лап
военный: военный
боков: боков
расценка: расценки
взгляд: взгляде
бюджетный: бюджетные
обязательный: обязательных обязательное
инстинкт: инстинктами инстинкт
утрата: утрате
журнал: журнал
четыре: четыре
скула: скулами
высота: высота высоту
саночки: саночках
томатный: томатный
спутать: спутать
повзрослеть: повзрослев
делать: делать
наложить: наложили
распотрошить: распотрошить
посчитать: посчитали
агрессивный: агрессивного агрессивным агрессивные
предпочитать: предпочитая предпочитают
угс: угс
болезнь: болезни
ребёнок: дети детьми
вызвать: вызвать
ребро: ребрами
светло-серый: светло-серого
либо: либо
зона: зоны зоной
требование: требование требованиям
поиграть: поиграть
микроэлемент: микроэлементов
пункт: пунктам
комната: комнат
упрямство: упрямство
заболевание: заболевание
человек: человека человек
выпас: выпас
уличный: уличную
недоступный: недоступный
сам: само
покровный: покровный
воспитанный: воспитанного
уравновешенный: уравновешенны
кобель: кобели кобелей кобель
скакательный: скакательные скакательных
терпение: терпение
перекус: перекус
вести: ведет
депигментировать: депигментированную
дисплазия: дисплазией дисплазию дисплазия
римский: римских римские
немой: нем
грозный: грозный
категория: категория
нужный: нужен
родиться: род
являться: являются
перейти: перейти
фактурность: фактурности
реально: реально
ткань: ткани тканью
возбудить: возбужденной
канарио: канарио
харизма: харизмы
быстрый: быстрее
из-за: из-за
регулярно: регулярно
истина: истин
безлюдный: безлюдных
кан-корсо: кане-корсо
поведение: поведение
столкновение: столкновения
наследоваться: наследуется
большинство: большинством большинства
задать: заданные
нетипичный: нетипичной
менее: менее
ветеринарный: ветеринарный
удачный: удачных
травма: травмам
бэбиситтер: бэбиситтера
грудь: груди грудь
остро: остро
организм: организмом организма
вместо: вместо
зной: зной
слишком: слишком
одиночество: одиночеству
ошибка: ошибки
продать: продавший
подходящий: подходящих
рацион: рационе рацион
удаститься: удасться
пепелище: пепелищах
видеть: видите
хватаетдушить: хватаетдушит
работа: работа работу
сзади: сзади
ровно: ровно
прогулка: прогулках
задействовать: задействовать
утолить: утолить
аборигенный: аборигенного
бруталый: брутал
говорить: говорили
пигментировать: пигментированные пигментированная
спина: спины спина
гигиена: гигиена
подросток: подросткам
позволить: позволить
собственный: собственную
приучение: приучению
капуста: капуста
спровоцировать: спровоцировать
книзу: книзу
пора: пора пор
зарегистрировать: зарегистрировала
рубль: рублей
тот: тому той
подбирать: подбирайте
наставник: наставником
гречневый: гречневую
излишний: излишне
топ: топ
возможный: возможен
неплохо: неплохо
территориальный: территориальным территориальный
ребятня: ребятню
полость: полости
доминантный: доминантных
нежирный: нежирное
сожаление: сожаления
внимание: внимание
сливочный: сливочным
прикус: прикуса
зеландия: зеландию
варежка: варежкой
жир: жирах
выбирать: выбирая
разнообразить: разнообразить
английский: английскими английский
прокачать: прокачали
круповый: круповую
стоимость: стоимость
приобрести: приобрести
иначе: иначе
особенно: особенно
отметина: отметины
клык: клыками клыки
предельно: предельно
отличие: отличия
страна: стран страна
достаточно: достаточно
обязательно: обязательно
рисковать: рискуете
устраивать: устраивавших
сложность: сложности
привычка: привычки
нянька: нянек
объяснение: объяснением
пара: пару
атипичный: атипичное
контрастный: контрастные
чистопородный: чистопородной
тренировка: тренировки
имя: имя
производить: производят
неделя: неделю
буква: буквы
испортить: испорченные
чрезмерный: чрезмерной
невоспитанный: невоспитанными
управление: управления
поводок: поводке
охотно: охотно
стоячий: стоячее
несмотря: несмотря
купить: купить купите
плотный: плотный плотные
носить: носить
часто: часто
поставить: поставлены
ухаживать: ухаживать
склонность: склонность
исчезнуть: исчезла
масло: маслом
допускаться: допускаются
принимать: принимает принимают
укорачивать: укорачивать
променад: променады
сообразить: сообразит
вейтпуллинг: вейтпуллингу
издревле: издревле
килевидный: килевидную
что: чему
страсть: страстей
шлейка: шлейки
случай: случаях случае
недостаток: недостатки
доступ: доступу
снг: снг
деликатес: деликатес
яблоко: яблоки
польский: польских
начать: начал
подозрительный: подозрительный
провокация: провокации
живой: живой
отработать: отработать
расстройство: расстройство
традиционный: традиционные
пресекаться: пресекаться
наличие: наличие
ромашка: ромашки
вселенная: вселенной
подшёрсток: подшерстка
нежелательно: нежелательно
сердце: сердце
чистый: чистой
обработка: обработку
индивидуальный: индивидуальные
крупа: круп
правильный: правильным правильный правильное
определить: определит
далеко: далеко
дисциплина: дисциплинах
варить: варить
пример: примера
одноклассник: одноклассники
участвовать: участвуют
интерьер: интерьером
сюрприз: сюрпризам
марка: марки
квартира: квартиру квартирах
прислать: пришли
защитник: защитнике
бой: бои
волосок: волоски
команда: команды команда
выпадать: выпадают
возможность: возможности возможность
коробка: коробки
накал: накал
против: против
чистить: чистить
экспериментировать: экспериментировать
сравнение: сравнению
предок: предках
случайный: случайные
кроме: кроме
навык: навыки
движение: движении
почка: почки почками
обострённый: обостренными
пустырь: пустырях
эпилепсия: эпилепсию
среднее: среднем среднего
подвес: подвесом
нечего: нечего
получить: получить
плоский: плоская
сильный: силен
привести: привело
выделяться: выделяющимися
молосса: молоссы
вязать: вязали
привлекать: привлекать
себя: собой
белые: белые
выглядеть: выглядят выглядит
период: период
промах: промахи
помета: помета
явление: явление
подозрительность: подозрительность
направление: направлении
отнимать: отнимает
газета: газет
щётка: щеткой
светлый: светлые
правило: правилах правила
сделать: сделано
дополнительно: дополнительно
сторожа: стороже
выгуливать: выгуливают
потребность: потребность
периодически: периодически
порок: пороки
память: память
гетерохромия: гетерохромию
хозяйский: хозяйского
намерить: намерены
ушной: ушное
хвост: хвостами хвост
генетический: генетическую
недокус: недокус
генофонд: генофонд
позволять: позволяющую позволяйте
капля: капель
жизнь: жизни
два: двух
овчарка: овчарка
забывать: забывайте
пугаться: пугаться
сильно: сильно
едва: едва
мир: мире мира
мешать: мешает
организовывать: организовывать
нанести: нанести
экипировка: экипировку
плечо: плечи
пик: пика
стояние: стоянию
брутальный: брутальным
сородич: сородичи
молоссова: молоссов
изгиб: изгибом
бады: бады
желудок: желудка
тяжёлый: тяжелые
шоу: шоу
относительно: относительно
нужно: нужно
мимимишность: мимимишности
также: также
экстерьер: экстерьера
истребить: истребив
параметр: параметры
русско-европейский: русско-европейская
момент: моменты
внутри: внутри
возможно: возможно
перевернуть: перевернутой
бегать: бегать
уксус: уксуса
очищать: очищают
корпус: корпус
живот: живота
отсюда: отсюда
постановочный: постановочное
лежанка: лежанкой
зарваться: зарвавшимся
заняться: заняться
растянутый: растянутый растянута
переквалифицироваться: переквалифицировались
продолжать: продолжали продолжают
частичка: частичку
умеренно: умеренно
определять: определять
оставаться: остается
доверять: доверяют
выставочный: выставочную выставочных
ранее: ранее
чадолюбие: чадолюбии
впоследствии: впоследствии
обеспечение: обеспечения
подвиг: подвигу
выпуклый: выпуклый
лакомство: лакомства
сложно: сложно
складка: складки складкой
крипторхизм: крипторхизм
рыбный: рыбным
прилегать: прилегающее
сдержать: сдержанный
безоглядно: безоглядно
стоить: стоит
разный: разных
тёплый: теплых
интеграция: интеграцией
скарб: скарб
незнакомый: незнакомого
ножницеобразный: ножницеобразный
ворчать: ворчать
провоцировать: провоцируют
право: правах
филе: филе
закручиваться: закручивается
лайк: лайка
покупной: покупные
отмечать: отмечаемых
вполне: вполне
нагрузка: нагрузка нагрузки
тёмно-коричневый: темно-коричневого
вязка: вязок
внешность: внешности
имущество: имущества
сложноватый: сложновато
стараться: старайтесь
ехать: ехать
угроза: угрозу
ягодичный: ягодичной
включение: включение
собрать: собрать
прочь: прочь
каша: каши
ровный: ровный
повседневный: повседневной
легко: легко
спорт: спортом
профессионал: профессионал
лента: ленту
реакция: реакции
производитель: производителей производители
превосходить: превосходить
здоровье: здоровье
заниматься: занимающиеся
воспитать: воспитать
порция: порции
ошибочно: ошибочно
реалия: реалиями
отправить: отправив
велосипед: велосипедом
возникать: возникает
любознательный: любознательным
погодный: погодными
отличный: отличные
упругий: упругий
безопасность: безопасности
затрачивать: затрачивая
пасти: пасти
взрывной: взрывного
справиться: справится
конкурент: конкурентов
выходить: выходить
локтевой: локтевых
субпродукт: субпродуктами
вакансия: вакансии
родитель: родителем родителей
резина: резины
нарастить: нарастить
площадка: площадки
ограничение: ограничениям
знакомство: знакомство
обойтись: обойдется
вроде: вроде
выделить: выделить выделенной
конфликт: конфликт конфликту
скрестить: скрестив
лишить: лишена
утро: утро
чистокровный: чистокровных
удостовериться: удостоверьтесь
смелый: смелым
молоко: молоко
пищеварение: пищеварением
занятие: занятия
управлять: управлять
тропический: тропического
чересчур: чересчур
несоблюдение: несоблюдение
принадлежать: принадлежавшие
прописной: прописных
кишечник: кишечника
покупка: покупка
гармоничный: гармоничной
сказываться: сказываются
практически: практически
ежемесячно: ежемесячно
цениться: ценится
рейтинг: рейтинг
энтузиаст: энтузиасты
дефект: дефекты
предусмотрительность: предусмотрительность
успешный: успешных
смахивать: смахивают
подписываться: подписывайтесь
продемонстрировать: продемонстрировало
самостоятельно: самостоятельно
жилистый: жилистое
травить: травлю
использовать: использовать
очень: очень
обычно: обычно
особый: особой
аппетит: аппетит
особенность: особенности особенность
бок: бокам бок
вина: виной
встречный: встречного
умение: умение
произойти: произошло
отметка: отметке
ржаной: ржаного
постепенно: постепенно
происходить: происходит
избежать: избежать
кличка: клички
прежде: прежде
держать: держать
готовиться: готовьтесь
разрешить: разрешив
забава: забав
жестокость: жестокостью
касаться: касается
впереди: впереди
возрождение: возрождение
пуховый: пуховой
удалить: удалить
дело: деле
проходиться: проходятся
лидер: лидера
извлечь: извлечет
проект: проекте
цилиндр: цилиндр
сразу: сразу
сигнализировать: сигнализирует
повадка: повадки
потомок: потомки
перекармливание: перекармливание
кг: кг
юный: юных
страж: стража страж
помассировать: помассировать
удовлетворить: удовлетворить
кефир: кефир
сидеть: сидеть
зарождение: зарождение
сей: сих
подружить: подружить
минимальный: минимальная
риск: риск
линька: линька
сдержанный: сдержанны
рисовый: рисовую
низко: низко
отразиться: отразился
специалист-породник: специалистом-породником
экономить: экономьте
причём: причем
подогнать: подогнать
представить: представить
давно: давно
отстоять: отстоят
вольер: вольер
кормление: кормление
конечность: конечности
взрослый: взрослым
слой: слой
сложить: сложенном
доллар: долларов
зверь: зверей
кавказец: кавказца
партнёр: партнеров
допустимый: допустима
хондроитин: хондроитином
гораздо: гораздо
г: г
непослушание: непослушанию
недуг: недуг
разорить: разоренных
стриппинговать: стриппинговать
безупречно: безупречно
канары: канары
осмотр: осмотр
шаг: шаг
