скорее: скорее
уход: уход уходе
дископатия: дископатии
набегаться: набегаются
регулярный: регулярные
самодостаточный: самодостаточная
линия: линия линий линию линиях
деформация: деформацией
бытовой: бытовую
частый: чаще
предать: преданные
раскрытый: раскрытыми
поиск: поиск
шерсть: шерсти шерсть
делать: делают
стать: стать
ненамеренно: ненамеренно
сходить: сходят сходить
установить: установить
эксперимент: экспериментах
тампон: тампоном
существенно: существенно
заводной: заводной заводному
шампунь: шампуней
специализироваться: специализироваться
широко: широко
получить: получить получит
прибор: приборов
средний: средняя среднее средний
повышать: повышало
голубоватый: голубоватый
фу: фу
пакет: пакетом
оптимальный: оптимальный
привить: привить
устраивательница: устраивательница
клетчатка: клетчатки
опыт: опыт опыта
бобовый: бобовые
зуб: зубы зубов
проблема: проблемы проблемами
визг: визгом
оттенок: оттенок оттенки
расположить: расположены расположить
время: времен время
температура: температурам
добавляться: добавляется
смычка: смычка
собака: собака собаку собаке собак собаки
похожий: похожих
финал: финал
оборонительный: оборонительную
одёргивать: одергивайте
аллергенность: аллергенности
посторонний: посторонних
чёрный: черный
использоваться: используются используется
сколько: сколько
соплеменник: соплеменниками соплеменники соплеменникам
кормление: кормление
свой: своей своих свои
вязать: вязали
лестница: лестницам
прорисовать: прорисованными
объясняться: объясняется
шоу-щенок: шоу-щенки
страсть: страсть
коротконогий: коротконогих
содержание: содержанием содержание содержания
утро: утрам
прийтись: пришлось
характер: характер
миссия: миссия
потребоваться: потребуется
гибкость: гибкостью
название: название названия
зарываться: зарываться
бояться: боитесь
роль: роли роль
доминанта: доминанты
стандартный: стандартное стандартные стандартных
мышечный: мышечная
себя: собой
наблюдать: наблюдайте
углевод: углеводов
обходить: обходить
несколько: нескольких несколько
энергичный: энергичная
размер: размеры размеров
подход: подход подходов
наладить: наладить
вокруг: вокруг
отбор: отбора
сырой: сырым
концентрироваться: концентрироваться
информация: информация
обладать: обладает
слегка: слегка
домочадец: домочадцами
тот: те той тех
распределиться: распределится
ваш: вашем ваших вашей
растительный: растительного
телосложение: телосложение
дуга: дугами
заранее: заранее
гастрит: гастритом гастрите
собственный: собственное
отопительный: отопительных
рабочий: рабочей рабочая
обсуждение: обсуждения
максимально: максимально
белок: белком
стремиться: стремящихся
рукавица: рукавицей
год: год
продолжить: продолжили
трёхмесячный: трехмесячные
затерроризировать: затерроризировать
цена: цена
фото: фото
реальность: реальности
цветочный: цветочные
орех: орехи
прогулка: прогулку прогулок прогулкам
маленький: маленького меньше маленькая маленьких
спинка: спинка
энерджайзер: энерджайзеру
сделать: сделано сделайте
поддаваться: поддаваться
пульпа: пульпы
материал: материалов
анна: анна
питомец: питомце питомцами питомцев питомца питомец
клумба: клумбы
сам: самого самой
потребность: потребность
животное: животного животными животные животное животным животных
периодически: периодически
окрас: окрас окрасов окрасы окрасом
мясо: мясе мясо
сохраниться: сохранилась
порок: пороки
низкий: низкие низким низкая
неутомимый: неутомимому
родословный: родословную
обитатель: обитателей
яндекс: яндекс
сарделечный: сарделечное
отвес: отвеса
идеальный: идеальные
охотничий: охотничьими охотничью охотничьим охотничьи
действовать: действует
крепкий: крепкие
перекус: перекусом
ограничитель: ограничителем
предок: предков
правильный: правильного правильное
сливочный: сливочного
россия: россии россия
явный: явными явные
поведение: поведения поведение
польза: пользу
результативный: результативным
аннотация: аннотации
внимание: внимании внимания внимание
миниатюрный: миниатюрные миниатюрное
гармонично: гармонично
габарит: габариты габаритов
страдать: страдает
камешек: камешками
силиконовый: силиконовой
качество: качествами качества качестве
комбинезон: комбинезон
ушной: ушная
вперёд: вперед
хотеть: хотите
сторона: стороны стороной
перепелиный: перепелиным
они: ними
базироваться: базирующийся
дисквалифицировать: дисквалифицирующие
весить: весят
отмереть: отмершие
заболевание: заболеваниями
инстинкт: инстинкты инстинктом
лапа: лапах лапы
собаколичность: собаколичности
самый: самых самая самый самые
мир: мире мира
категорически: категорически
отказаться: отказаться
отношение: отношению отношение отношения
выраженный: выраженный выраженной
ребёнок: детьми
пропитать: пропитана
который: которых которая которые которому который
подружка: подружку
растение: растения
окружающий: окружающую
такой: такую таким такие такими такая
холка: холке
метеозависимый: метеозависимы
степень: степенью
обильно: обильно
итог: итоге
злак: злаков
увильнуть: увильнуть
журнал: журнал
обратный: обратная
телевизор: телевизора
затем: затем
стоять: стоят
вид: виде виды
считаться: считается
начинать: начинают
верхний: верхнюю верхняя
плечо: плечи плечам
серный: серные
радужка: радужки
отвлечь: отвлечет
мини-такса: мини-таксы мини-такс
точка: точке
наполеон: наполеона
выстригать: выстригают
представитель: представителей представителями представители
зашкаливать: зашкаливающей
развитой: развитыми развитым развиты
норма: нормы
межпородный: межпородного
группа: группы
бедро: бедрам
насыщенный: насыщенная
высота: высота высоты
охранник: охранник
формально: формально
выворачиваться: выворачиваются
загривок: загривком
сородич: сородичи
шея: шея шеи
переходить: переходит
гипертрофированный: гипертрофированном
вручную: вручную
просто: просто
собрать: соберет
бедренный: бедренная
ничто: ничем
угощать: угощайте
тигровый: тигровые
заметить: замечена
клык: клыка
подвижный: подвижная
супер-премиум: супер-премиум
такса: такса такс таксы таксам
отличать: отличает
овальный: овальная
нужно: нужно
мимимишность: мимимишности
слабый: слабое
видимость: видимости
мусорный: мусорное
постав: постав
также: также
определить: определить
истребить: истребить
контактный: контактнее
процесс: процесс
полотенце: полотенцем
применение: применения
умный: умная
челюсть: челюсти челюстей
подпалина: подпалинами
метод: метод
воспитание: воспитания воспитание
обои: обоев
потомство: потомства потомство
той-такса: той-таксы той-такс той-таксами той-таксу той-такса
тип: тип типа типу
упражнение: упражнение
узкий: узкая узкой
холистик: холистик
таксеныш: таксенышей
полезный: полезная
аллергия: аллергией
любимец: любимца
болезнь: болезни
походка: походке
момент: моменты момент
шёрстка: шерстка
целиком: целиком
крупный: крупными крупным крупная крупных
уберечь: уберечь
класс: класса
собака-компаньон: собаки-компаньона
аппарат: аппаратом
домашний: домашней домашних домашними домашнего
губа: губами
порция: порциями
ножка: ножки ножкам
отзыв: отзывы отзывах
нижний: нижней нижняя
огород: огород
кроличий: кроличья кроличьей кроличьих кроличьим кроличьи
гигиенический: гигиеническими
угостить: угостить
покупательский: покупательский
морда: мордой
относиться: относится относиться
лилипут: лилипуты
либо: либо
отработка: отработке
анальный: анального
сайт: сайт сайту
требование: требование
давать: давали давать
неоднократно: неоднократно
необходимый: необходимы необходимую
старший: старшего
корпус: корпус
общение: общения
продолжать: продолжает
столь: столь
активно: активно
мягкий: мягче мягкая
симпарик: симпарики симпарика
специальный: специальных
добавить: добавьте
стандарт: стандарт
сера: сера
масло: масел
лаять: лаять
нервный: нервные
нога: ног ноги
предрасположенность: предрасположенность
отличаться: отличается
малыш: малыши
одеялко: одеялко
образ: образом
диабет: диабету
умеренный: умеренная умеренное
происхождение: происхождения
предпочитать: предпочитают
отдел: отдел
козинец: козинец
охота: охоте охоту охоты
важно: важно
небольшой: небольшое небольшими
должный: должно
необходимо: необходимо
умеренно: умеренно
осень: осень
противопоказание: противопоказанием
отрасти: отросшие
глаз: глаз глаза
длинношёрстный: длинношерстной длинношерстными
способствовать: способствует
история: история
омлет: омлетом
шмидт-дуйсберг: шмидта-дуйсберга
пропорциональный: пропорциональны
изображение: изображения
выполнение: выполнение
изначально: изначально
образовать: образуют
кто-то: кого-то
щенок: щенка щенки щенков щенок
удлинённый: удлиненная удлиненный
команда: команда команд команды
задний: задние
дисквалификация: дисквалификации
проход: прохода
найти: найдены найти
редкий: реже
распространить: распространена распространены
широковатый: широковатый
черта: черты
схема: схема
каждый: каждые каждом каждой каждое
тщательно: тщательно
выгнутый: выгнутые
строка: строку
сложно: сложно
оставлять: оставляйте
трагический: трагическим
приобрести: приобретите приобрести
сваливаться: сваливаться
прилегать: прилегает
предосторожность: предосторожности
крайне: крайне
классический: классическая
дрессировка: дрессировка дрессировки
предплечье: предплечья
стоить: стоит
это: это
понизить: пониженным
поваляться: поваляются
рассматривать: рассматривать
форма: форма
сквозняк: сквозняке
естественно: естественно
дать: данные
расслабить: расслабленный
присущий: присуща
жир: жиров
агрессивность: агрессивность
существо: существа
нехватка: нехватка
семья: семьи
добавление: добавлением
яйцо: яиц яйцом
крошка: крошка
калораж: калораж
банхар: банхар
помета: пометах помете
погода: погоду
выбирать: выбираете выбирайте
характеристика: характеристика
шаг: шагу
стоп: стоп
взаимовыгодный: взаимовыгодное
пясть: пясти
другой: другие
жёстко: жестко
скованность: скованности
взросление: взросления
просмотр: просмотров
коротконогость: коротконогости
кролик: кроликов кроликах
гладко: гладко
кузен: кузенов
агрессивный: агрессивные
использовать: используйте
день: дня день дни
растворить: растворят
трудноуправляемый: трудноуправляемых
заинтересовать: заинтересовал
нагрузка: нагрузка нагрузку нагрузки
около: около
нет-нуть: нет-нет
способный: способной
терпение: терпения
куриный: куриных
характерный: характерна
перейти: перейти
нора: норе
посягательница: посягательница
мера: мере мера
скрещивание: скрещивания
постараться: постарается
матрасик: матрасик
перец: перцем
тибетский: тибетский
повышенный: повышенном
яркий: яркой
например: например
любить: любят
негатив: негативе
нуждаться: нуждается
из-за: из-за
лопатка: лопаток лопатки
позвоночник: позвоночник
коготь: когти когтей
родина: родиной родине
ломаться: ломаются
убрать: убрать уберите
стараться: старайтесь
короткошёрстный: короткошерстных
фрукт: фруктов
рост: рост
максимум: максимум
своевременно: своевременно
значит: значит
прыжок: прыжки
когтить: когтя
выведение: выведение
бормотание: бормотание
аккуратно: аккуратно
гриб: грибы
кондиционер: кондиционеров
подушка: подушку
интеллектуальный: интеллектуальной
почистить: почистить
высокий: высокой высокий
менее: менее
девочка: девочек
основное: основном
прочь: прочь
поколение: поколения
хаос: хаос
африканский: африканском
натянутый: натянутые
обувь: обуви
раз: раза
помимо: помимо
континент: континенте
наклон: наклоном наклон
неподходящий: неподходящий
усугубляться: усугубляются
реклама: реклама
подойти: подойдет
полноценный: полноценного
общительность: общительности
белый: белая
утеплить: утепленную
дальнейший: дальнейшего
использование: использованием
начать: начать
вырабатываться: вырабатывается
моляр: моляра
лента: ленту
данный: данном данное
химия: химию
производитель: производителей производители
отказываться: отказываться
полностью: полностью
меню: меню
здоровье: здоровье
лидерство: лидерству
релакс: релакс
ложиться: ложится
поселиться: поселившись
открыть: откройте
плохой: плохой плохую
свинка: свинок
известно: известно
второй: второй
типичный: типичной
соседство: соседство
интенсивно: интенсивно
отсутствие: отсутствие
закон: законам
слишком: слишком
ловкий: ловкие
одиночество: одиночеству
будущее: будущего
ватный: ватным
любознательный: любознательным
получиться: получится
недокус: недокусом
владелец: владельца владельцев
уделить: уделите
обработать: обработайте
германия: германия германии
таксёныш: таксеныши таксеныша
незначительный: незначительный
упрямый: упрямые
нужный: нужна нужного
неугомонный: неугомонные
один: одно одного
перспектива: перспективой
разрядка: разрядку
бесстрашие: бесстрашие
рацион: рациона рацион
запрет: запрет запреты
охотник: охотника
говорить: говорит
кой: коем
выводить: выводили выводить
достойный: достойную
некрупный: некрупными
слуховой: слухового
резец: резца
сфера: сферу
расчёсывать: расчесывать
мелкий: мелких мелкими
подсчитывать: подсчитывать
корма: кормах
результат: результата
спина: спины
гигиена: гигиена
топотушка: топотушек
разновидность: разновидность разновидностей разновидности
сила: силу
особенность: особенностей особенности особенность
полный: полного
попона: попону
чувствительный: чувствительна
задорный: задорного
копчёность: копчености
вакансия: вакансии
решить: решите
задействовать: задействовали
покров: покрова
посыпать: посыпьте
пошуметь: пошумите
упорный: упорная
ноздря: ноздрями
кожа: кожа
квартирный: квартирных
спрей-отпугиватель: спреями-отпугивателями
оценка: оценке
лишь: лишь
прикус: прикус прикуса
вариант: вариант
взаимоотношение: взаимоотношения
банка: банкой
появиться: появились
экстерьер: экстерьер
различаться: различаются
постоянно: постоянно
план: плане план
форум: форум форуме
корректировать: корректировать
связь: связь
сложный: сложнее
подкрепление: подкрепление
разведение: разведения
мочка: мочка
избыточный: избыточной
отрабатывать: отрабатывать
голова: головой голова
возможный: возможен
трусливый: трусливые
длинный: длинная длинный
сушка: сушки
доза: дозу
голень: голени
угол: углом угол
правило: правило правила
разрушительный: разрушительны
ведро: ведро
отверстие: отверстия
вводить: вводят
крыса: крыс
игрушка: игрушки
вода: воде
убедиться: убедиться
мраморный: мраморные мраморным
боль: боль
состав: составе
передний: передним
взрослый: взрослыми взрослом
положение: положение
большинство: большинстве большинство большинства
поясница: поясницу
член: членам
анатомия: анатомии
кандидат: кандидаты
выразительный: выразительны
чересчур: чересчур
любой: любые любой
место: месте места место
покладистый: покладистее
столетие: столетия
копание: копанию
основный: основную
разделить: разделить
запретить: запрещены запрещено
комочек: комочки
дополнить: дополненные
боязно: боязно
месячный: месячных
громкий: громких
п: п
изгиб: изгиб
коричневый: коричневого коричневый
выступать: выступающим
подыскивать: подыскивали
корм: корма корм
племенной: племенных
выставка: выставок
занять: заняли
агрессор: агрессоры
часть: часть
земля: земли
тёплый: теплой
опорно-двигательный: опорно-двигательным
внешний: внешние
собачий: собачьего
описание: описание
объявление: объявлений объявления
главный: главная
изучать: изучают
виноград: виноград
круповый: круповую
причина: причиной причине
начало: начало
стоимость: стоимость
рейтинг: рейтинг
полнота: полноте
пространство: пространство
лай: лая
разозлить: разозлил
отойти: отошли
дефект: дефекты
лёгкий: легким
наказывать: наказывайте
спотыкание: спотыкания
вестись: велось
посадить: посаженные
питомец-лидер: питомец-лидер
ткань: ткань
особенно: особенно
длина: длину
независимо: независимо
подписываться: подписывайтесь
серьёзный: серьезный
мини-кузен: мини-кузенов
удовольствие: удовольствие
заполнить: заполнить
менять: меняйте
дефектный: дефектный
обычный: обычная
предмет: предметы
равномерно: равномерно
соответствующий: соответствующего
карликовый: карликовые карликовая карликовое
вновь: вновь
оказаться: оказался
однако: однако
крысарик: крысарик
барсук: барсуках
выстраиваться: выстраиваются
достаточно: достаточно
сверхразвить: сверхразвитая
пражский: пражский
плотно: плотно
пинчер: пинчеров
обязательно: обязательно
сужаться: сужающейся
комплекс: комплексом
соблюдать: соблюдать
ответ: ответов
хвост: хвоста хвост
стоящий: стоящий
двухцветной: двухцветные
психика: психики
хозяин: хозяина
устраивать: устраивать
закрываться: закрываются
той-терьер: той-терьеров
поэтому: поэтому
очень: очень
особь: особей особи
какой-то: какое-то
обычно: обычно
пара: пару
случай: случаев случаях случае
подтон: подтоном
перекрыть: перекрыт
смотреть: см смотрит
замена: замену
порода: пород породы порода
копирование: копирование
норный: норных
когтереза: когтерез
далёкий: подальше
добрый: добрый
фотография: фотографии
обрезание: обрезание
дегидрированный: дегидрированным
активность: активность
кровь: кровей
нефенотипичный: нефенотипичные
неделя: неделю
понимание: пониманием
бесплатный: бесплатных
работать: работать
прилитие: прилития
продукт: продукта
дружелюбность: дружелюбность
египетский: египетского
доступ: доступ
присутствие: присутствии
обстановка: обстановку
плавно: плавно
повадка: повадкам
активный: активным активной
кличка: клички
лежанка: лежанке
довольно: довольно
рыжеватый: рыжеватым
несмотря: несмотря
иметь: иметь имеющие имея имеют
поясничный: поясничный
смыкаться: смыкающийся
купить: купить
сладость: сладости
питомник: питомники
хороший: хорошей
часто: часто
готовиться: готовьтесь
выпечка: выпечка
подпал: подпалом
надзор: надзором
ввести: введите
срез: среза
следовать: следует
кошка: кошки
прямой: прямые прямой
поладить: поладить
череп: черепом
касаться: касается
подъём: подъемы
конечный: конечном
провод: провода
животный: животному
премоляр: премоляра
шум: шум
создавать: создают
подлежать: подлежат
удалить: удалить
натуральный: натуральное
хантхаузен: хантхаузена
позиция: позицию
специя: специи
фанат: фанаты
масть: масть
мебельный: мебельной
дружелюбно: дружелюбно
мутация: мутации
дрессировщик: дрессировщика
пускать: пускать
поздний: позднюю
устойчивый: устойчиво
хромота: хромоты
уноситься: уносятся
коротенький: коротенькие
проект: проекте
отбирать: отбирали
соление: соленья
грудной: грудной
быт: быту
литература: литература
предотвратить: предотвратит
строиться: строится
вывести: выведенная
темно-карий: темно-карего
комнатный: комнатные
склонный: склонны
баланс: баланс
отличие: отличие
остальной: остальными
порядок: порядки
получать: получает
спаниель: спаниель
пёсик: песика
бульдог: бульдог
манипулятор: манипуляторы
кг: кг
заметный: заметной
краткий: краткая
назад: назад
конец: конец
преимущественно: преимущественно
смочить: смоченным
царство: царства
безоговорочный: безоговорочной
готовый: готова
зона: зону
курица: курицы
линька: линька
субпродукт: субпродуктах
овощ: овощей
сухой: сухих
крутой: крутым
морской: морских
наш: наши
жемчужный: жемчужный
зверёк: зверьков
интерес: интерес
приводить: приводит
мочь: могут
причинить: причинит
локоть: локти
страна: страна
минимум: минимум
сохранять: сохраняют
тканевый: тканевым
провокация: провокации
нести: несет
подвижность: подвижность
верность: верность
первый: первом
возраст: возрастом возраст возрасте
эксперт: экспертов
купать: купать
постный: постном
пшеничный: пшеничная
спрос: спрос
отметить: отмечен
выполнить: выполнил
заинтересованно: заинтересованно
надбровный: надбровными
флегматичный: флегматичном
обивка: обивки
кровать: кровати
обращать: обращайте
клетка: клетки
разводиться: разводится
уменьшиться: уменьшились
вконтакте: вконтакте
свет: свет
сустав: суставов
непросто: непросто
движение: движениях
надежда: надежде
жёсткий: жесткие
крупа: круп
вызвать: вызовет
принести: принес
основной: основные
далее: далее
эффект: эффект
новизна: новизны
весь: всем
интеллект: интеллект
охранный: охранные
семейный: семейных
плюсна: плюсны
спуск: спуски
ждать: ждет
культура: культуры
средство: средств
вес: вес
поисковый: поисковую
отличный: отличную
помечтать: помечтают
одноклассник: одноклассники
смазка: смазкой
путём: путем
странно: странно
конечность: конечности
перекрёстный: перекрестный
попытаться: попытается
собачка: собачкам
свободный: свободное
увеселение: увеселению
собака-подросток: собак-подростков
реакция: реакцией
ежедневно: ежедневно
плоский: плоским
любим: любимом
расставить: расставлены
кончик: кончике
жизнь: жизнь
являться: является
нос: носа
волосок: волоски
сон: сна
осторожность: осторожностью
жировой: жировой
правда: правда
возможность: возможности
позитивный: позитивное
ножницеобразный: ножницеобразного
мнение: мнение
капля: каплями
выбрать: выбрать
повторить: повторите
обладательница: обладательница
однозначно: однозначно
французский: французский
грудь: грудь
будущий: будущие
дом: доме
случайный: случайные
мускулистый: мускулистые мускулистый
скромный: скромные
пластичность: пластичность
унаследовать: унаследовала
соблазн: соблазны
основать: основана
шёрстный: шерстного
допустить: допустим
испугать: испугал
хвалить: хвалите
отвлечься: отвлекитесь
популярный: популярна
плотный: плотными
разводить: разводят
зима: зиму
непривлекательный: непривлекательными
диван: диване
той-кузен: той-кузены
осмотр: осмотр
диванчик: диванчике
позволять: позволяли
