обучать: обучая обучать
уход: уход уходе ухода
совместный: совместной
коленный: коленного
деликатный: деликатной деликатна
отлично: отлично
пятка: пятки
келпи: келпи
пёс: пес пса псам
страна: страны стране страна
держаться: держится
частый: чаще
помета: пометами помета
предать: преданные
поиск: поиск
шерсть: шерсти шерсть шерстью
стать: стать ставшего
тело: тела телу телом
тампон: тампоном
широко: широко
получить: получить
общий: общего общая
средний: средняя среднее средний средней
сторонник: сторонники
интересный: интересный
конкретный: конкретной
положение: положении
опытный: опытный опытные
скот: скота скот
приобрести: приобретенный приобрести
тазобедренный: тазобедренного
переселенец: переселенцами
зуб: зубы
проблема: проблемы проблем
вообще: вообще
пугать: пугает
расти: растет
познакомиться: познакомиться
собака: собака собаку собаке собак собаками собаки
подъём: подъем
подарить: подарили
порода: породам пород породу породы порода породой
месяц: месяцах месяцы месяцев
австралиец: австралийцев австралийцы австралийца австралиец австралийцем
аккуратный: аккуратным
выделяться: выделяется
чёрный: черный черного
процесс: процессу процесс
сколько: сколько
соплеменник: соплеменниками соплеменников
кормление: кормление
свой: своей своих своему свое своими
есть: ест
кинологический: кинологическими
линия: линий линии линиях
содержание: содержанием содержание содержания
произойти: произошедшую
зависимость: зависимости
прийтись: пришлось придется
школьный: школьного
характер: характер
догадаться: догадаться
сложный: сложного сложным
романтичный: романтичный
название: название
однолюб: однолюб
обыденность: обыденностью
сохранять: сохранять
достижение: достижения
кипучий: кипучей
себя: собой
продавать: продавать
добавка: добавок
образовать: образует
округлый: округлой округлый
помощь: помощь
даваться: даются
мера: меру мере
черно-подпалый: черно-подпалый
сухой: сухого сухой сухие
климат: климате климата
система: системе
период: период периоды
информация: информация
переезд: переезда
южный: южных южным
состоять: состоит
таковой: таковыми
друг: друг
ходьба: ходьбе
отменный: отменные
собственный: собственное
рабочий: рабочей рабочих рабочая рабочий
мосс: мосс
обсуждение: обсуждения
проходить: проходят проходит
выгул: выгулами
мериносовый: мериносовые
шоу-особь: шоу-особи
продолжить: продолжили
миска: миску
выдержать: выдержал
ротовой: ротовой
цена: цена
фото: фото
презентовать: презентовал
вдоль: вдоль
короткий: короткая короткие короткими
палец: пальцами
расселить: расселили
сводистый: сводистыми
красиво: красиво
зрение: зрения
щётка: щеткой
правильный: правильный правильному
маленький: маленького меньше
кончик: кончика кончике
сначала: сначала
глубокий: глубоким глубокая
прирождённый: прирожденные
сделать: сделано
печенька: печеньки
выгуливать: выгуливают
нос: нос носа
повторный: повторной
материал: материалов
выбор: выбор
приподниматься: приподнимается
оболочка: оболочкой
чистота: чистоту
грациозно: грациозно
поголовье: поголовья поголовье
новый: нового новому
активный: активных
ставропольский: ставропольском ставропольским
потребность: потребность потребностей
окрас: окрас окраса
яндекс: яндекс
порок: пороки
партнёрство: партнерства
копирование: копирование
пастушеский: пастушескую
крепкий: крепкие
воспринимать: воспринимать
скотоводство: скотоводству
давать: дают давали
трата: трат
владелец: владелец владельцам владельцев владельцу
отапливать: отапливаемом
способный: способна способные способен
повергать: повергает
завезти: завезенные завезенных
джек: джек
природный: природной
линька: линьки линька
польза: пользу
жизнь: жизни жизнью
пастуший: пастушьих пастушья
рекордно: рекордно
ножницы: ножницы
страдать: страдает
старший: постарше
среди: среди
качество: качествами качества качестве качество
плотный: плотного плотных плотные плотная
овчарка: овчарка овчарками овчарки овчарок
скромный: скромных скромный
вперёд: вперед
пушистый: пушистый
кто: кого
предел: пределами
племенной: племенной
собаковод: собаководы
фермерство: фермерству
ухо: уха уши
череп: череп
социализация: социализации
сравнение: сравнении
самый: самых
техника: техника техникой
выраженный: выраженный выраженными
питомник: питомников питомниках питомники
европейский: европейскими
благодаря: благодаря
лапа: лапы
который: которых которого котором которая которые который
мордочка: мордочку
россия: россия
высокий: высшей высоких высокую высокая высший
квартира: квартир квартиры
холка: холке
карьера: карьеру
небольшой: небольшой небольшого
такой: такую таким такими
обратный: обратная
прицельно: прицельно
гасить: гасить
овальный: овальный
корпус: корпусе корпус
акс: акс
угол: углами угол
затем: затем
устанавливать: устанавливает
длинный: длинные длиннее длинная
востребовать: востребованных
предок: предками
ость: ости ость
инстинкт: инстинктами
журнал: журнал
поведение: поведении поведение поведению
пространство: пространства
закат: закат
представитель: представителей представители
скорректировать: скорректировать
учёт: учетом учета
скула: скулами
любимый: любимой
находить: находят
российский: российских российские
высота: высота
загрязнение: загрязнения
обитатель: обитателями
габарит: габаритами габаритах
управляемый: управляемы
загривок: загривком
полный: полной полный
пускать: пускают пускает
шея: шея шеи
переходить: переходит
пример: пример примером
запомнить: запомнить
советский: советский советским
просто: просто
кличка: кличке клички кличку
проходиться: проходиться
отбраковывать: отбраковывая
делать: делать
австралийский: австралийских австралийской австралийский австралийские австралийского австралийская австралийскому
плодиться: плодились
стёганый: стеганая
подвижный: подвижная
вязка: вязкам вязке
минимум: минимумом
чуткий: чуткий
забитый: забиты
придомовый: придомовую
мимимишность: мимимишности
континент: континента континенте
принять: принять
крупа: крупа
постав: постав
неутомимость: неутомимости
также: также
трудиться: трудился
экстерьер: экстерьера
определить: определить
неприятный: неприятная
суховатый: суховатый
подчеркнуть: подчеркнуто
умный: умная
больший: большие больших
челюсть: челюсти
существо: существам
пищеварение: пищеварение
несложно: несложно
минимальный: минимального минимальный минимальная
еженедельно: еженедельно
ширина: ширины
хозяйство: хозяйства
потомство: потомства потомство
тип: тип
покупка: покупки покупкой
шёрстный: шерстный
пастух: пастухом пастухи пастух пастухами
стоячий: стоячем
покров: покров
породный: породного
манящий: манящие
получать: получают
рыжий: рыжий
любимец: любимца
болезнь: болезни
момент: моменты момент
сука: сукой суки сук сукам суку
содержать: содержать
орудовать: орудовать
брать: берут брать
внутри: внутри
кормить: кормят кормить кормящим
аппарат: аппаратом
отмереть: отмерший
один: одной одному одна одного
должный: должна должно должны должен
заводчик: заводчиков заводчик заводчикам заводчику
отзыв: отзывы отзывах
совершенно: совершенно
сохранение: сохранения
качественный: качественное
прочёсывать: прочесывать
территория: территории территорию
подушечка: подушечках
ребёнок: детей
считать: считают считает
вывих: вывих
либо: либо
женский: женского
начинать: начинать начинает
контакт: контакт
добавить: добавьте
активно: активно
волос: волоса
равно: равно
животное: животное животным животных
стандарт: стандарт стандарта
цезарь: цезаря
прогулка: прогулки
человек: человеку человека люди человеком
выводить: выводят
искусственный: искусственному
требоваться: требовалось
рост: росту рост
нога: ног
вдохновляться: вдохновляется
наружный: наружный
выходить: выходящие
умеренный: умеренная
происхождение: происхождения
ровный: ровная
предпочитать: предпочитают предпочитает
важно: важно
резкий: резкий
доказывать: доказывать
первый: первых первого первом первую
необходимо: необходимо
эффектный: эффектны
обладать: обладали
умеренно: умеренно
отыскивать: отыскивающий
удлинённый: удлиненной
возвращать: возвращающий
глаз: глаз глаза
оставаться: остается
история: история
признаваться: признается
сообразительный: сообразительны
известный: известных
привести: привести
карьерный: карьерные
жить: живущие жить живет
косточка: косточки
щенок: щенка щенки щенков щенок
мускулистый: мускулист мускулистой
одёжка: одежке
команда: команда команды
соотношение: соотношение
классический: классическом
задний: задние задней
проверять: проверять
дисквалификация: дисквалификации
кисточка: кисточка
подыскивать: подыскивая
подходить: подходят
белок: белка
черта: черты
безоговорочно: безоговорочно
дешёвый: дешевле
глисон: глисон глисона
кобель: кобеля кобели
внимательный: внимательны внимательный
руководствоваться: руководствуется руководствуясь
вакцинация: вакцинации
разрез: разрез
деятельность: деятельность
овца: овец овцы овцами
импортировать: импортировали импортированных
прилегать: прилегающего
сложно: сложно
подвес: подвеса
крайне: крайне
манёвренность: маневренностью
переквалифицироваться: переквалифицироваться
дрессировка: дрессировка
стоить: стоит
это: это
время: время
питомец: питомцев питомца питомцы питомец
исследовать: исследует
выводиться: выводился
приятно: приятно
запас: запасом
агрессивность: агрессивность
ушной: ушной
метис: метисами метисов
требовать: требует требовали
движение: движения движению
придерживаться: придерживаются
уговорить: уговорить
ожидать: ожидая
воронка: воронки
условие: условиях
балл: балл
характеристика: характеристика
остевой: остевого
стадо: стадо
щенячий: щенячьего
загон: загоне
выставочный: выставочные выставочных
другой: другие других
разводить: разводить
поздний: позднее
воротничок: воротничок
хозяин: хозяином хозяину
взросление: взросления
отказываться: отказывались
выраженность: выраженности
углеводный: углеводную
дело: дело
заканчиваться: заканчиваются
вполне: вполне
темп: темпе
параллельно: параллельно
умение: умений умение
зарождение: зарождения
променад: променадов променада
брюссельский: брюссельский
спортивно: спортивно
избежание: избежание
пол: пола
перейти: перейти
динго: динго
уверять: уверяют
категория: категории
сутки: сутки
довольный: довольная
ч: ч
испытание: испытаний
очищение: очищению
сетчатка: сетчатки
подопечный: подопечными подопечной подопечных
невозможно: невозможно
коготь: когти когтями
верхний: верхняя верхними
лисий: лисьи
проигнорировать: проигнорированы
голова: головы голова
значит: значит
сброс: сбросами
натуральный: натурального натуральными
однажды: однажды
австралия: австралия австралии
отечественный: отечественных
однопомётник: однопометников
выпас: выпасе
толстый: толстым
когтерез: когтерезом
вне: вне
сельхозотрасль: сельхозотрасли
фристайл: фристайл
заблудиться: заблудившийся
мешать: мешают
пропадать: пропадает
напоминать: напоминают
менее: менее
основное: основном
еда: еду
признак: признаков
определять: определяет
шеф: шефом
уровень: уровне
видео: видео
зелёный: зеленого зеленом
наклон: наклоном
реклама: реклама
легко: легко
репутация: репутация
жирный: жирную
высокомерно: высокомерно
изгибаться: изгибаясь
нюанс: нюанс
шоу-соплеменник: шоу-соплеменники
выносливость: выносливость
непромокаемый: непромокаемая
покрывать: покрывать
отец: отцом
мясной: мясного
порция: порцию
лента: ленту
продаваться: продается
производитель: производителей производителя
вода: воды
здоровье: здоровье
остальной: остальные
здоровый: здоровый здоровые
сидя: сидя
релакс: релакс
изогнутый: изогнутая изогнут
требование: требования
понимание: понимании
улица: улицу
обильный: обильная
карантин: карантин
способствовать: способствующие
срезать: срезают
родословный: родословные
второй: второй второго
младший: младшего
врождённый: врожденными
костяк: костяк
обстановка: обстановке
окд: окд
город: городов города
сторона: стороне
разрешить: разрешенные
питание: питания
слишком: слишком
одиночество: одиночеству
остроконечный: остроконечные
бридер: бридерам
спокойно: спокойно
выглядеть: выглядит
характерный: характерны характерная
воспитание: воспитание
диванный: диванных
двуногий: двуногим
пастбище: пастбище
год: лет
понятно: понятно
отличный: отличные отличной
заходить: заходя
зимой: зимой
работа: работы работе работу работой
малыш: малыш
подшёрсток: подшерсток подшерстка
атлетичный: атлетичный
бесконечно: бесконечно
коза: коз
палево-чёрный: палево-черный
носить: носящих носившими
незнакомый: незнакомые
хороший: хорошим хорошее
ген: гены
психология: психологию
день: день
шоу-потенциал: шоу-потенциал
атрофия: атрофия
вложение: вложений
неохотно: неохотно
пасти: пасти пасет пасут
мелкий: мелких
немного: немного
коллективный: коллективного
участвовать: участвовал
морда: морда
спина: спины
приучать: приучать
стресс: стресса
дружить: дружить
гигиена: гигиена
разновидность: разновидность разновидностей
сайт: сайту
регион: регионам регионах
ркф: ркф
кеесхонда: кеесхонд
возможный: возможна
продукт: продуктами
возрастной: возрастных
позволить: позволить
вакансия: вакансии
собрат: собратья
соблюдать: соблюдает
полезно: полезно
получаться: получаются
дошкольный: дошкольного
ринг: ринге рингу
гриффон: гриффон
зима: зима
знакомить: знакомя
отвисания: отвисания
передний: передних
кожа: кожа
книзу: книзу
быть: будут
оценка: оценке
физический: физической
полоса: полосы
прикус: прикус прикуса
рубль: рублей
долго: долго
родина: родине
шерстяной: шерстяная шерстяной
состояние: состояние
убираться: убираются
питательный: питательные
обойтись: обойдется
форум: форум форуме
обходиться: обходясь
слой: слоя слоем
вырастать: вырастают
фермер: фермер фермеры
бедро: бедер
связь: связь
подстилка: подстилки
готовый: готового
расставить: расставленные
стоп: стопом
малоопытный: малоопытным
надколенник: надколенника
конец: конце конец
неплохо: неплохо
холодное: холодные
прояснить: прояснить
сушка: сушки
наблюдаться: наблюдался наблюдается
полость: полости
опорно-двигательный: опорно-двигательным
неистощимый: неистощимым
находиться: находящиеся
энд: энд
звук: звуки
очёс: очесы
граница: границу
удалять: удаляя
обожать: обожающий
переносить: переносившие
расцениваться: расцениваются
попона: попона
тысяча: тысячу
палевый: палевый
единственный: единственное
управлять: управлять управляющим
стоящий: стоящие
энергичный: энергичные
пойти: пойти
ферма: ферме ферму
предположительный: предположительной
мускулистость: мускулистость
радужный: радужной
место: месте место
нижний: нижних
лидер: лидером лидеру
любой: любые любой
класть: кладут
жара: жару
контролировать: контролирует
ценный: ценны
основный: основное
пока: пока
фон: фоне
сконцентрировать: сконцентрировано
месячный: месячных
миролюбивый: миролюбивые
оба: обе оба
гоу: гоу
близко: близко
выставка: выставок выставке
корм: корма корм кормов
подавать: подают
значительно: значительно
часть: часть
энергия: энергией
сокращать: сокращать сокращая
иметь: имеет иметь
большинство: большинство
покладистый: покладистые
развал: развала
описание: описание
карий: карей
главный: главная
начало: начало
внушительный: внушительной
стоимость: стоимость
рейтинг: рейтинг
беременная: беременным
питч: питч
поле: поля поле
дефект: дефекты
оттенок: оттенки
ложиться: ложась
сторожить: сторожит
бок: бока
отбиться: отбившихся
подписываться: подписывайтесь
казахстанский: казахстанским
неприхотливый: неприхотлива
дымчато-голубой: дымчато-голубой
спортивный: спортивные спортивными
дрессировать: дрессируют
живность: живности
милый: милый
очертание: очертания
длина: длина длины
калорийно: калорийно
ошейник: ошейником
существовать: существовать существует существуют
поисковик: поисковик
предельно: предельно
оказаться: оказался
рубеж: рубеж
сильный: сильные
означать: означает
самостоятельно: самостоятельно
учёба: учебой
частота: частоту
достаточно: достаточно
груминг: груминга
позволять: позволяя
плотно: плотно
сменить: сменили
шотландский: шотландских
развивающийся: развивающийся
восточноевропейский: восточноевропейская
расстояние: расстояния расстоянии
хвост: хвоста хвост
отличаться: отличаются
запретить: запрещено
спорт: спорте
поводок: поводком
промежуток: промежутках
очень: очень
обычно: обычно
особь: особей особи
поэтому: поэтому
поворот: поворотах
гигиенический: гигиеническом
смотреть: см
скрестить: скрещенные
объяснять: объясняет
редко: редко
возраст: возраста
набор: набора
превышать: превышает
промышленный: промышленных
специализироваться: специализируется
оформление: оформление
фотография: фотографии
прекрасно: прекрасно
активность: активность активности активностями
четвероногий: четвероногие
кровь: кровей
помогать: помогает
наиболее: наиболее
неделя: неделю
ассоциация: ассоциациями
группа: группе
перекрытие: перекрытие
помещение: помещении
агрессивный: агрессивная
основание: основания основание
русский: русская
дружелюбность: дружелюбность
наоборот: наоборот
европа: европы
сотрудничать: сотрудничать
заинтересованный: заинтересован
силуэт: силуэт
обстоятельство: обстоятельствах
охотно: охотно
теория: теории
форма: формы
довольно: довольно
лосьон: лосьоне
правило: правила
крупный: крупных
список: список
исключительный: исключительных
купить: купить
часто: часто
овечий: овечьим овечьих
лето: лето летом
кошка: кошки кошку
неустановленный: неустановленными
температура: температурах
перемещаться: перемещается
касаться: касается
процедура: процедура
положить: положенный
документ: документов
получение: получении
свободный: свободные
животный: животному
пожилой: пожилым
шум: шум шума
рекорд: рекорды
заболевание: заболеваний
широкий: широкий широкая
союз: союз
допускаться: допускаются
проникаться: проникается
пристрастие: пристрастия
гол: голов
зона: зоной
шоколадный: шоколадный
бобтейл: бобтейл
количество: количеством
ошибка: ошибок
проект: проекте
лояльный: лояльные
крайний: крайнем
век: века
недопустимо: недопустимо
продолжать: продолжают
тонкий: тонкая
оцениваться: оценивается
блестящий: блестящую
мир: миром
спортсмен: спортсмена
выкладка: выкладке
рамка: рамки
случай: случаях случае
стоя: стоя
пора: пор
спин: спинам
колли: колли
кг: кг
аджилить: аджилити
хозяйка: хозяйкой
родоначальница: родоначальницей
социализироваться: социализируется
энергичность: энергичность
краткий: краткая
преимущественно: преимущественно
уроженец: уроженцы уроженец
столетие: столетии
смочить: смоченным
перевозка: перевозку
резец: резцами
сей: сих
пастьба: пастьбе
отношение: отношение отношения
работать: работают работающие
интервал: интервал
рацион: рацион
поясница: поясницей
ссср: ссср
дом: дома
кто-то: кто-то
сегодняшний: сегодняшний
мочь: могут можете
исключительно: исключительно
независимый: независимые
суперспособность: суперспособность
тканевый: тканевым
весь: весь всем
прямой: прямой прямого
ход: ход
руно: руно
эксперт: экспертов
носитель: носителем
очищать: очищающими
середнячок: середнячков
тепло: теплом
прикусить: прикусят
факт: факт
сарай: сарае
разводиться: разводится
трудоголик: трудоголики
нежелательно: нежелательно
вконтакте: вконтакте
очертить: очерченную
целое: целом
объявление: объявления
секция: секции
причём: причем
мягкохарактерный: мягкохарактерных
создать: создать
основной: основные
решение: решение
недлинный: недлинные
возбудить: возбужден
прогрессировать: прогрессирующая
интеллект: интеллект
охранный: охранные
ярко: ярко
далеко: далеко
промышленность: промышленности
вес: вес
степень: степени
постоянный: постоянного
р: р
подтянутый: подтянут
атмосфера: атмосферой
осеменение: осеменению
одноклассник: одноклассники
развитие: развитие
ценник: ценник
транспорт: транспорта
скорее: скорее
конечность: конечности
подсобный: подсобного
загнать: загнать
попутно: попутно
адепт: адепты
исчезать: исчезать
узнать: узнать
свободолюбивый: свободолюбивую
бег: беге
губа: губы
дисплазия: дисплазия
палево-рыжий: палево-рыжий
мнение: мнение мнения
капля: каплями
тон: тон
вопрос: вопросах
бесполезный: бесполезных
доллар: долларов
выбрать: выбрать
чистить: чистить
причина: причине
верность: верности
именно: именно
доступно: доступно
сочетаться: сочетаться
кусочек: кусочки
определённый: определенных
грудь: грудь
стеснённый: стесненного
свисать: свисает
край: крае край
случайный: случайные
молодой: моложе
чётко: четко
гораздо: гораздо
основать: основана
г: г
покупаться: покупаются
хотя: хотя
сустав: сустава
марка: марку
снижать: снижающих
овцевод: овцеводам
продолжительность: продолжительность
интуитивно: интуитивно
двухмесячный: двухмесячный
форс-мажорный: форс-мажорных
процент: процент
стачиваться: стачиваются
подчиняться: подчиняющийся
