травма: травм травмы травмами
спокойный: спокойного
тратиться: тратиться
заметить: заметили
овощ: овощи
ситуация: ситуациях
полумесяц: полумесяца
умение: умении
тело: тела теле тело
кровь: крови
караван: караванами
плоский: плоской
популярность: популярности
опыт: опыт опыта опытом
агрессия: агрессия агрессию
похожий: похожих
подарить: подарили
следить: следить
сколько: сколько
ветеринарный: ветеринарного ветеринарным ветеринарной
тренировать: тренированные
беговой: беговые беговую беговая
название: название названия
часть: частях части частью
овладение: овладении
фактурный: фактурной
собака: собаку собакой собак собака собаках собаке собаки
путаться: путаться
британский: британский британского
источник: источник
европейский: европейская
приятный: приятный
физический: физических физическом физическим
обсуждение: обсуждения
отношение: отношениях отношение отношении
сочленение: сочленений
английский: английских английским английская английской английскую английский английские английского
ретироваться: ретироваться
цена: цена
реальный: реальной
грейхаунд: грейхаунда грейхаундом грейхаунд грейхаунды грейхаундам грейхаундами грейхаунду грейхаундов
реальность: реальности
удаваться: удается
невысокий: невысокие
привести: приведут привели
материал: материалов
подшёрсток: подшерстком подшерсток
племенной: племенными
туманный: туманного
поведение: поведения поведению поведение
распространить: распространено
охотиться: охотятся охотиться
стоять: стоят
ограничиваться: ограничивается
морской: морская
шаткий: шаткая
сторона: стороны сторону
грей: греям греев грей
дисквалифицировать: дисквалифицирующие дисквалифицировали
хороший: хорошую лучший хорошему лучшее
пятно: пятнами пятен
потенциально: потенциально
субпродукт: субпродукты
пробежка: пробежки
спринтер: спринтера
холка: холку холке
зато: зато
россия: россия
спортсмен: спортсмены
растянутый: растянутым растянутые
уиппет: уиппетов
миска: миска миске
обратный: обратная
занятие: занятиям
чуточку: чуточку
рост: ростом рост
длительный: длительные
великобритания: великобритании великобритания
радужка: радужки
ради: ради
мероприятие: мероприятия мероприятиях
статусность: статусности
критерий: критерием
шея: шея шеи
кинодром: кинодроме кинодромах
стричь: стричь
компаньон: компаньон
шерсть: шерсть шерсти шерстью
сделать: сделают сделано сделайте сделает
русачий: русачьего
крупа: крупа
кинолог: кинологи
испортить: испортить
рыба: рыба
челюсть: челюсти
углубляться: углубляясь
зарегистрировать: зарегистрирован
должный: должны должен должна
самый: самая самый самых самые
тип: тип типа
содержать: содержать
энергия: энергию
уступать: уступают
тайтлый: тайтл
ирландский: ирландских
свора: своры своре сворой
необходимый: необходимы
охотничий: охотничью охотничьи охотничьих охотничьими охотничий охотничьей охотничьего
общение: общения
столь: столь
часами: часами
сверх: сверх
родительский: родительских
включая: включая
выбрать: выбрали выбрать
закрытый: закрыты
история: история
гипотиреоз: гипотиреоз
промышленный: промышленные
щенок: щенка щенков щенки щенок щенку
растительный: растительным
проявляться: проявляется
адьос: адьос
тоненький: тоненькие
альтернатива: альтернатива альтернативы
белок: белка
успешно: успешно
обязательный: обязательный обязательные обязательна
подцепить: подцепить
питомец: питомцев питомцу питомец питомца
форма: форма
ожидание: ожиданием
юный: юного юном юных
трёхмесячный: трехмесячного
полноценный: полноценная полноценные
характеристика: характеристика характеристики
бедуин: бедуинов
специалист: специалистами
выставка: выставках выставке
матрас: матрасах
фигура: фигуры фигуру
руб: руб
высокооценивать: высокооцениваемой
релаксу: релаксу
греть: грея
способный: способными способна способен способны
подрыв: подрывом
истребить: истребили
постичь: постигший постигнет
коготь: когти когтями
порода: породе породам породы пород порода породой
значит: значит
долина: долину
требовательный: требовательны
сознательный: сознательному
считать: считает считанные
раздражать: раздражают
первый: первой первом первые первое первый
еда: еду
видео: видео
малышня: малышню
гутиковый: гутиков
меню: меню
племя: племенами племени
полностью: полностью
распасться: распался
полуслово: полуслова
быть: будьте будут
компания: компании
закрепиться: закрепилась
пёс: псы пес псами
домашний: домашних домашними
гиподинамия: гиподинамия
холодный: холодную
октябрьский: октябрьской
каждый: каждой
нормальный: нормальная
расстояние: расстояние
владелец: владельца владельцев владельцы
такой: таких такие такого
незначительный: незначительный
мышечный: мышечной
самостоятельный: самостоятельных
талант: талантов
лопатка: лопатками лопатки
называть: называют
беспричинный: беспричинная
полевой: полевых полевые полевую
усваиваться: усваивается
интернет: интернете
содержание: содержание содержания
ген: гены
собственный: собственного собственной собственную
подпёвка: подпевках
проказа: проказам
невнимательность: невнимательности
походка: походка
рекорд: рекордов рекорды
участь: участь
попытка: попытки
гряда: гряды
составлять: составляет
прилегать: прилегающий
рекомендовать: рекомендуют
ринг: ринге ринга
жить: живет
численность: численность
острый: острое
стартовый: стартовому
давать: дает давать дают
диплом: дипломов
городской: городских
покупка: покупкой покупке
педикюр: педикюра
различаться: различаются
комнатный: комнатный
занимать: занимают
гонка: гонке
спортивный: спортивного спортивных спортивными
кстати: кстати
связь: связь связи
сосуществовать: сосуществуют
механический: механическим механической
кусок: кусок куски
клуб: клуб
соперник: соперников
заячий: заячьей заячьими
сода: сода
старание: старания
разделать: разделать
уметь: умеющий
неточность: неточностей
сухость: сухостью
родство: родстве
бедро: бедра бедер
пока: пока
любительский: любительская
стать: стали станет
старший: старших
осмотр: осмотру осмотре осмотр
антисептик: антисептиком
трудновоспитуемый: трудновоспитуемых
поток: поток
лес: лесах лес
оба: обе
рабочий: рабочий рабочие рабочей
произвести: произведенному
состояние: состоянии
осанка: осанкой
смесь: смеси
потерять: потерять
белый: белыми белых
дословный: дословный
яйцо: яйца
пучок: пучок
благородный: благородной
дважды: дважды
возраст: возрасту возраст возрасте
интерес: интереса интерес
возможность: возможностей возможностям
мир: мир миру мире
исключить: исключено
салюк: салюки
жаждать: жаждут
григхаунд: григхаунд
становиться: становясь
вышеупомянутый: вышеупомянутых
раздобыть: раздобыть
эктопаразит: эктопаразитов
напоминать: напоминающие
анализ: анализа
медаль: медалей
заниматься: заниматься занимающиеся
круговой: круговых
грудина: грудины
проглотить: проглотят
делаться: делается
некондиция: некондицию
плотно: плотно
древнеанглийский: древнеанглийского
той-терьер: той-терьеров
качество: качестве качества
лечиться: лечится
погружаться: погружаясь
поле: поле полях
смотреть: см
вальяжный: вальяжный
смысл: смысла
превышать: превышает
детализация: детализацию
фотография: фотографии
широкий: широкие широкая широких
работать: работать работайте
современный: современные
холод: холоду
уход: уходе уход
знать: знать
курсинга: курсинга
помнить: помните
противник: противники
высокий: высокая высоким высокие высокий
питомник: питомники питомника
артрит: артрит
пара: пары пара
пространство: пространству
находиться: находиться
перемещаться: перемещается
отдавать: отдавать отдают
глаз: глаза глаз глазами
генерировать: генерировать
тёмный: темному
иерархия: иерархия
дистанция: дистанций дистанция дистанции
прийтись: придется
обезжиренный: обезжиренные
нерадивый: нерадивых
покреативить: покреативить
масть: масть
шотландский: шотландский
шкура: шкуру
сословие: сословий
век: века веке веку
малыш: малышу малышей малыш малыша
год: года лет год гг году
буквально: буквально
полустоячий: полустоячее
получать: получает
поскольку: поскольку
утончить: утонченной
создание: созданий создание
опасный: опасные
краткий: краткая
весьма: весьма
дополнительный: дополнительные
погоня: погони
плотный: плотная плотными плотную
место: место места
грех: грех
поясница: поясницей поясниц
неуёмный: неуемную
пилочка: пилочкой
масса: массы
пищевой: пищевая
ветвь: ветви ветвь
исключительно: исключительно
ввести: ввести
зверь: зверю
сородич: сородичей сородичи
камень: камнями
перевод: перевод
дезорганизовать: дезорганизует
эксперт: экспертов
красный: красными
вкус: вкуса
факт: факт
выуживать: выуживая
любимец: любимцем любимцами
вконтакте: вконтакте
впечатление: впечатление впечатлению
версия: версии
лежебок: лежебоками
переход: переход переходом
разведение: разведением разведение разведению
ярко: ярко
столетие: столетию
достоинство: достоинствами
молодой: молодая молодые
животное: животных животным животного животные животное
сша: сша
деликатность: деликатность
лепить: лепить
увеличить: увеличить
завершение: завершением
чреватый: чревато
бег: беге бега бег
лидер: лидер
волос: волос
какой: каком каким какого
основать: основана
хотя: хотя
интеллектуальный: интеллектуальным
низкий: низших низкая низкой
порядок: порядок
х: х
служака: служака
кожа: кожу
определиться: определитесь
перо: перьев
шоу-класс: шоу-класс
ворс: ворса
квалификация: квалификациями квалификаций
генетический: генетическое генетического
витамин: витаминов
подражать: подражать
свободно: свободно
серый: серая
состроить: состроить
середина: середины
хорошенько: хорошенько
покусывание: покусывания
живот: животу живота
доминанта: доминанты
кальцинированный: кальцинированный
квартира: квартире квартирах
мера: меру мере
палевый: палевыми
информация: информация
охотник: охотник
клещ: клеща
бокс: боксе боксу
друг: друг
резиновый: резиновой
деформироваться: деформируются
воспринимать: воспринимайте
любой: любую любые любой
сустав: суставы
палец: пальцами
нарастить: нарастившие
будущее: будущем
мочь: могли могут
подогрев: подогревом
проводить: проводить
замешкаться: замешкаться
автоматизм: автоматизмом
ниже: ниже
мышца: мышцах
приложить: приложить
калорийный: калорийные
окрас: окрас окрасом окрасы
площадка: площадках
крепкий: крепкие крепкая
трещинка: трещинки
исторический: исторических
скрещиваться: скрещиваться
польза: пользу
управляться: управляться
ощупь: ощупь
среди: среди
зарекомендовать: зарекомендовали
говяжий: говяжьи
потуга: потуги
учесть: учесть
комплимент: комплимент
лингвист: лингвисты
испытывать: испытывать
утеплить: утепленным утепленных
помочь: помогло поможет
длинный: длинные длинный длинная
излишек: излишек
сила: силам силу силе
щекотливый: щекотливых
вычёсывание: вычесыванием
симптом: симптом
руль: руль
урок: уроке
безружейный: безружейной
просто: просто
четверолапый: четверолапых
аллергия: аллергия
мало: мало
прессовать: прессовать
борзая: борзой борзым борзая борзых борзые борзую
карма: карму
конец: конца конец
неприятно: неприятно
обнаглеть: обнаглевшего
последующий: последующих
смыкаться: смыкаются
ромашковый: ромашковый
старый: стар
равнодушный: равнодушным
умный: умных
выход: выходом выхода
кельт: кельты
фрукт: фрукты
возрастной: возрастной
спасти: спасли
лорд: лорда
гладкий: гладкий
нил: нила
скалистый: скалистые
важный: важным важный
лапа: лапой лапы лапам
мощный: мощном мощным
логичный: логичным
напрыгивание: напрыгивания
добавить: добавьте
тушка: тушки
чистка: чистка
прогулка: прогулки прогулках
гоняться: гоняется
собачий: собачьим собачьих собачьи собачье
интересоваться: интересуйтесь
происхождение: происхождения происхождении
трепать: трепать
благо: благо
резец: резцы
готовый: готовы
заканчивать: заканчивают
аккуратный: аккуратные
удлинённый: удлиненная
какой-нибудь: какой-нибудь
салатик: салатиков
задний: задние
быстроходный: быстроходными
тщательно: тщательно
дрессировка: дрессировку дрессировка дрессировки
бульдог: бульдога
предплечье: предплечья
стандартный: стандартный стандартное
полагать: полагая полагают
время: время времени
наследование: наследование
ватный: ватными
отдельно: отдельно
сука: суки сук
испачкаться: испачкался
трек: трек треков
агрессивность: агрессивность
поедание: поедание
колесо: колесами
линия: линиям линий линии
фанатичный: фанатичной
защищать: защищать защищает
набрасываться: набрасываясь
день: дней день дни
погода: погоду
местность: местности
достижение: достижениями
показывать: показывает
пясть: пясти
кость: костей
систематический: систематическая
другой: другие других другими другим
участник: участники
взрослый: взрослого взрослых
тщательный: тщательному
заменять: заменяют
настой: настой
предпочитать: предпочитает предпочитают
пушистиковый: пушистиков
поставить: поставить поставлены
бегун: бегунами бегунов бегуна
например: например
несколько: несколько
соня: соня
закон: закона
множество: множество
родина: родиной
голова: головы голова
ответ: ответа
подвес: подвесов
отечественный: отечественных
согласно: согласно
скучно: скучно
заставить: заставило
зарваться: зарвавшихся
добыть: добытой
девочка: девочек
процедура: процедурой
совет: советы
кмч: кмч
прошлый: прошлом
резко: резко
необученный: необученное
реклама: реклама
силуэт: силуэта
соответственно: соответственно
исполниться: исполнится
уроженец: уроженцев
заводчик: заводчиком заводчики
средний: среднее средней
репутация: репутация
мягкий: мягкая мягких мягким
будка: будок
косуля: косуля косулю
лосьон: лосьоном
сладостный: сладостных
положить: положивших положено положенную
приглушить: приглушит
организм: организм
остальной: остальные
врождённый: врожденный врожденные
посадка: посадки
мелкий: мелкой мелкие
мускулатура: мускулатурой
второй: второй вторая втором
полагаться: полагается полагаясь
сухощавый: сухощавых сухощавой
окд: окд
оказаться: оказавшись
спокойно: спокойно
характерный: характерны
воспитание: воспитание
диск: дисками
безусловно: безусловно
работа: работы
мирно: мирно
отрасти: отросшая
звезда: звезды звезда
дичь: дичи дичь дичью
плачевно: плачевно
уберечь: убережет
сам: самой
изматывать: изматывающие
сайт: сайту
усиление: усиления
черепной: черепной
выстраивать: выстраивают
выкладываться: выкладываться
особенность: особенностей особенности
тёрка: терку
выбор: выбора
натереть: натертыми
позволять: позволяет
верёвочка: веревочку
пригласить: пригласите
бешеный: бешеную
экскурсия: экскурсии
паста: пастой
аккуратист: аккуратисты
отпор: отпор
подранок: подранком
успеть: успевшего успел
лишь: лишь
относиться: относиться
вариант: вариант
долго: долго
опытный: опытные
степной: степной
оттенок: оттенку
тесный: тесном
форум: форум форуме
остепеняться: остепеняются
предпочтение: предпочтение
минерал: минералов
начало: начала начало начале
требовать: требуют
гальго: гальго
образовать: образуя
проверить: проверенного
хлынуть: хлынул
тяжело: тяжело
наш: нашей
психотип: психотип
положение: положение положении
рельефный: рельефным
прочность: прочность
копаться: копаются
анатомия: анатомии
внешне: внешне
мадьяр-агар: мадьяр-агаров
собиратель: собиратели
мясо: мяса мясу мясо
умопомрачение: умопомрачения
шлифовать: шлифуя
развал: развала
казаться: казаться
описание: описание
один: одна одной одном
непринуждённый: непринужденные
породный: породных
объявление: объявлений объявления
горизонт: горизонте
коротконогий: коротконогие
добыча: добычу
толчок: толчка толчке
встречаться: встречаться
бродячий: бродячим
соревнование: соревнований соревнованием
пугаться: пугаются
выставочный: выставочный выставочном выставочную выставочных
дорога: дорогой
декоративный: декоративные декоративных
серьёзный: серьезный серьезной
оглядка: оглядкой
клиентский: клиентскую
потроха: потрохами
габарит: габаритам
озаботиться: озаботиться
венгрия: венгрии
гречневый: гречневая
однако: однако
коллектив: коллектив коллектива
германия: германии
имидж: имиджа
который: которой котором которая которых которые который
красавчик: красавчики
устраивать: устраивать
зарядка: зарядки
поэтому: поэтому
попасть: попал
пробежаться: пробежаться
справедливо: справедливо
копирование: копирование
дружелюбный: дружелюбная
оттачивать: оттачивают
длинноногость: длинноногостью
заточить: заточенные
активность: активность
помещение: помещении помещениях
основание: основания
дружелюбность: дружелюбность
отзыв: отзывах отзывы
заключаться: заключается
кошка: кошки
следовать: следует
комиссия: комиссии
нереально: нереально
приманка: приманкой
животный: животному
шум: шум
выдвинуть: выдвинуть
дать: дайте
отчётливый: отчетливые
собачник: собачников
особь: особи особей
наблюдать: наблюдать
верхний: верхние
покровительственный: покровительственный
отличие: отличие
стройный: стройное
рамка: рамки
книга: книгу
актуально: актуально
запереть: запертом
час: час часов
назад: назад
преимущественно: преимущественно
пожалуйста: пожалуйста
лето: летом
кое-что: кое-что
запрет: запреты
состоять: состоят
поначалу: поначалу
сеттер: сеттер
нечасто: нечасто
дом: дома доме
заставлять: заставляют
локоть: локти
вывозить: вывозить
плавный: плавным
носитель: носителем
привязанность: привязанность
известность: известность
фрикаделька: фрикадельки
полно: полно
творог: творог
ухо: ушей уши
пробуждение: пробуждение
профессиональный: профессионального профессиональная
целое: целом
учёба: учебу
лишить: лишено
котироваться: котируются
основной: основные
решение: решение
новый: новую
интеллект: интеллект
охранный: охранные
покупать: покупайте
многие: многие
ждать: жди
вес: вес
распустить: распущенными
социализировать: социализированной
ступенька: ступеньку
попытаться: попытается
ежедневно: ежедневно
приучить: приучить
рада: рады
дождливый: дождливые
автотранспорт: автотранспортом
подразнить: подразнить
именно: именно
будущий: будущие
выдержка: выдержкой
вредный: вредны
коробка: коробкой
судейский: судейские
улица: улице
сутки: сутками
добродушный: добродушный
продолжительность: продолжительность
отапливать: отапливаемых
переводить: переводят
качка: качки
счёт: счета
курс: курс
допускать: допускают
аппетит: аппетитом
расположить: расположенные
шалость: шалостям
подавлять: подавляющем подавляющее
повзрослеть: повзрослеть
спешить: спешить
неизменно: неизменно
предельный: предельная
дешёвый: дешевая дешевле
накопление: накоплением
интересный: интересный интересная
прославить: прославленных
витаминно-минеральный: витаминно-минеральные
полотно: полотно
развитие: развития
основный: основным основными
отдых: отдыха
диагностировать: диагностируют
даваться: даются
выгнутый: выгнутыми
тот: те та тех той
выпуклый: выпуклых
иметься: имеются
поглощать: поглощают
псарня: псарнях
протекция: протекции
фото: фото
оригинальный: оригинальный
понюхать: понюхать
м: м
прирождённый: прирожденные
возбудитель: возбудителей
искать: ищете
болонка: болонок
два: две
мальчик: мальчиков
яндекс: яндекс
роза: розу
считаться: считаются считался
детский: детским
голубой: голубыми
обожать: обожают
почерк: почерк
бега: бегах
ножницы: ножницы
пунктик: пунктик
олфорд: олфорда олфорд
заветренный: заветренное
нестись: несется
пытаться: пытаться пытаясь
оставлять: оставлять
хотеть: хотите
кто: кого
белка: белку
азарт: азарт азартом
общий: общей общего общему
завзятый: завзятым
овчарка: овчарками
служебный: служебных служебным
ухватить: ухватить
провести: провели проведенного
пластина: пластина
молочка: молочкой
журнал: журнал
неделя: недели неделю
высота: высота
месяц: месяца месяцев
игривый: игривые
стиль: стиль
нога: ногами
делать: делать делает делают
чей: чьи
клан: клан
минута: минуты
несостоявшийся: несостоявшиеся
сужаться: сужающийся
хозяин: хозяину хозяев хозяина хозяева
отрезать: отрезать
уживаться: уживаются
контроль: контроля
ящик: ящике
покров: покров
болезнь: болезни болезнь
ребёнок: дети
взрослеть: взрослеют
преимущество: преимущества
ребро: ребрами
великолепный: великолепных
выдрессировать: выдрессировать
преобладать: преобладают
совершенно: совершенно
обоняние: обоняние
древний: древние древний
либо: либо
метод: метода
внешний: внешними внешнюю
начинать: начинать
правильный: правильная правильный
поиграть: поиграть
беспощадный: беспощадный
этот: этому этих
сырой: сырыми
присесть: присел
доля: доля
человек: человека
охота: охоте охота охоты охоту
простой: проще
ведать: ведала
секунда: секунды
подопечный: подопечным подопечного
грациозный: грациозное
вода: водой
усиленный: усиленная
изображение: изображения
промысловый: промысловых
элегантность: элегантностью
страна: страну страна
оценивать: оценивают
признание: признание
молниеносно: молниеносно
чехословакия: чехословакии
укусить: укусить
обновление: обновлению
маневрировать: маневрировать
любовь: любви
перебор: перебор
веймаранер: веймаранер
проявить: проявить
развивать: развивая
увеличивать: увеличивая
обнаружить: обнаружившему
кобель: кобели кобелей
предложить: предложенное
тигровый: тигровыми
плохо: плохо
глухота: глухота
движение: движения движении
скакательный: скакательные
терпение: терпение терпением
надевать: надевайте
душок: душком
условие: условиях
заметно: заметно
порог: пороге
взросление: взросления
заслонка: заслонки
дело: дело
омускуленный: омускуленная
практика: практика
заяц: зайца зайцем зайцев
неуправляемый: неуправляемы
македонский: македонского
нужный: нужен
развитой: развитой
перейти: перейти
египетский: египетскими
ваш: вашей вашего ваших
продажа: продаже
размашистый: размашистым
вооружиться: вооружиться
из-за: из-за
учёный: ученых
красивый: красивый
главное: главное
быстрый: быстрее быстрая
рысистый: рысистых
детство: детство
суждение: суждения
менее: менее
складка: складок
во-вторых: во-вторых
требование: требования
клетка: клетка
морозный: морозные
вместо: вместо
дорожка: дорожки
бросить: бросит
отказываться: отказывается
спин: спин
обстановка: обстановке
ровный: ровной
англичанин: англичане англичанина
препятствие: препятствиями
отсутствие: отсутствие
вести: ведут
европа: европе
одиночество: одиночеству
водить: водят
рацион: рационе
опираться: опираясь
зимой: зимой
альбион: альбиона
потерпеть: потерпеть
поисковый: поисковые
стандарт: стандарта стандарту стандарт
неформальный: неформальной
последний: последнем последней
говорить: говорили говорит
морда: морда
гигиена: гигиена
гиннесса: гиннесса
внешность: внешностью
наступить: наступил
фирменный: фирменные
экономия: экономия
жаль: жаль
расправиться: расправится
подобный: подобные
вожак: вожаку
браковаться: бракуются
небольшой: небольшие невелика
семья: семью
густой: густой
квартирный: квартирных
оценка: оценке
полоса: полосы
нагрузка: нагрузок нагрузка
принцип: принципы
рубль: рублей
искажённый: искаженная
встретить: встретишь
пообщаться: пообщаться
трудяга: трудяге
команда: команд команды команда
чистокровный: чистокровной
учить: учили
неплохо: неплохо
борзятник: борзятникам
переохлаждение: переохлаждения
нежирный: нежирное
ослабить: ослабленным
внимание: внимание
наличие: наличии
стайный: стайным
зубной: зубной
стенли: стенли
облизать: облизать
клише: клише
нижний: нижних
профилактика: профилактике
психологический: психологическом
три: трем
мытьё: мытью
короткий: короткие коротких
глубокий: глубокая
иметь: имеет иметь имеющим имеют
непревзойдённый: непревзойденными
обратиться: обратиться
обстоятельство: обстоятельства
стоимость: стоимость стоимости
привязать: привязанной
особенно: особенно
ткань: ткань
бок: бока
луг: лугам
стойка: стойке
участие: участию
жёсткий: жесткая
пол: полом
шоу-производитель: шоу-производителями
обычный: обычная обычное
отсутствовать: отсутствует
забег: забегов забегах
достаточно: достаточно
свой: свое своего своих
обитать: обитающих обитающему
ход: ходе
сложность: сложности
сбалансированность: сбалансированность
обязать: обязан
полениться: поленитесь
показатель: показателям
машина: машин
редко: редко
зрение: зрение
перекрывать: перекрывают
производить: производят
смешанный: смешанное
связанность: связанности
заложить: заложено
нетипичный: нетипичное
поделиться: поделитесь
потренироваться: потренируйтесь
попона: попоной
список: списке
поводок: поводке поводка
сталкиваться: сталкивается
точнее: точнее
связанный: связанные
англия: англии
любитель: любителей
понимать: понимать понимающий
охотно: охотно
несмотря: несмотря
купить: купить
часто: часто
нянька: няньках
прямой: прямые
эра: эры
сырость: сырости
намордник: намордниках намордник
выступать: выступают
специалист-кинолог: специалиста-кинолога
пачка: пачке
бессмысленно: бессмысленно
масло: маслом
неплохой: неплохие
пренебрегать: пренебрегают
овальный: овальные
принимать: принимает
открытый: открытыми
фанат: фанаты
протирание: протиранию
гость: гостей
вписываться: вписывающаяся
спина: спина
тонкий: тонкая
что: чему
разводить: разводили
сверчок: сверчков
период: периоды период
баловень: баловень
аджилить: аджилити
нейропатия: нейропатию
пациент: пациентом
наклонный: наклонном
выбирать: выбирать
паразит: паразитов
база: базу
испытание: испытания
ссср: ссср
мотивировать: мотивируя
революция: революции
контур: контуров
обработка: обработку
чистый: чистой
чувствительный: чувствительны
сомневаться: сомневайтесь
угол: углы
ветклиника: ветклиники
перечисленный: перечисленные
мясо-овощной: мясо-овощные
поза: позу
погулять: погулять
трусость: трусость
комплекс: комплексы комплексом
варежка: варежки
укрепление: укрепления
обладатель: обладатели
участвовать: участвуют
одноклассник: одноклассники
постольку-посколька: постольку-поскольку
приобрести: приобрели
правда: правда
таскать: таскать
скорость: скорость
внутристайный: внутристайные
против: против
однозначно: однозначно
мина: мину
подмешать: подмешав
случайный: случайные
наработать: наработать
дебютировать: дебютировали
стремительный: стремительные
кроме: кроме
открыть: открыт
элитарный: элитарного
взять: взять
недоросль: недорослей
борзая-сверчок: борзая-сверчок
мускулистость: мускулистостью
техника: технику
кот: коту
среднее: среднем среднего
сегодня: сегодня
нечего: нечего
шкурка: шкуркой
ксолоитцкуинтли: ксолоитцкуинтли
частый: чаще
предать: преданные
поиск: поиск поиска
зависимый: зависимы
слышный: слышно
оптимальный: оптимальный
зуб: зубы зубов
закисание: закисания
терпеливый: терпеливы
волосок: волосков
обобщение: обобщений
стеснять: стесняет
характер: характер
практиковать: практикуют
некоторый: некоторые
себя: собой
официальный: официальное
запастись: запаситесь
отбор: отбора
продукт: продукт
разместить: разместить
помета: помета
ухватистый: ухватистые
тонкость: тонкости
пересидеть: пересидев
приносить: приносить
скованно: скованно
фаворит: фаворита
спускать: спускают
щётка: щеткой
светлый: светлые
дерево: деревьями
корить: корена
натаскивание: натаскивания
потребность: потребность
периодически: периодически
порок: пороки
главный: главным главная
ушной: ушное
интервал: интервале
геркулесовый: геркулесовая
занять: занял
предок: предков
вовсе: вовсе
жизнь: жизни жизнью жизнь
абсолютно: абсолютно
забывать: забывайте
они: ними
рука: руку
сильно: сильно
собаколичность: собаколичности
весенний: весенним
мешать: мешает
выходить: выходя
согревать: согревает
всё-таки: все-таки
вид: виде
рявкнуть: рявкнув
азартный: азартный
российский: российских
непременный: непременной
снисходительный: снисходительны
влюбить: влюбленный
союз: союза
обучение: обучение обучением
нарисоваться: нарисовавшейся
нужно: нужно
статность: статностью
мимимишность: мимимишности
атлет: атлет
крошечный: крошечного
также: также
экстерьер: экстерьера
пригодиться: пригодятся
сновидение: сновидений
баснословный: баснословной
идеал: идеале
настроение: настроение
притворно-равнодушный: притворно-равнодушную
кайфовать: кайфовать
шёрстный: шерстный
тепло: тепло
момент: моменты момент
окружающий: окружающих
перегрузка: перегрузки
толика: толику
бегать: бегать
корпус: корпус
инвалидность: инвалидности
прыжок: прыжок
работёнка: работенка
умеренно: умеренно
маячить: маячит
оставаться: остается
лёгкий: легкие легких
косточка: косточки
изначально: изначально
ранее: ранее
сводить: сводите
найти: найдены
гонять: гоняя
удачный: удачного
текстура: текстуру
сложно: сложно
отмереть: отмерших
крипторхизм: крипторхизм
новичок: новичкам
стоить: стоит
это: это
генотип: генотип
спринтерский: спринтерских
массивный: массивные массивной
разный: разных
максимальный: максимальную
заслужить: заслужил
роща: рощи
представитель: представителями представители
уплощённый: уплощенными
выжидательный: выжидательную
тренировочный: тренировочных
кормить: кормить
заканчиваться: заканчиваются
отличаться: отличаться
крупный: крупные
стараться: стараться старайтесь
беспамятство: беспамятства
фишка: фишек
курсинг: курсингом
недуг: недуги
любить: любят
ряженка: ряженка
буржуазный: буржуазный
страх: страх
исход: исход
дирхаунд: дирхаундов
наращивать: наращивать
вольер: вольеров
заправить: заправленными
фантастически: фантастически
калека: калекой
объёмный: объемные
сезон: сезон
упадок: упадка
каша: каши
лента: ленту
производитель: производителей
экономичный: экономичный
здоровье: здоровье
сторож: сторожей
показать: покажите
порция: порции
сочетание: сочетании
вверх: вверх
мороз: морозы
добавка: добавки
велосипед: велосипедом
лицо: лицо
исключение: исключением
выглядеть: выглядит выглядела
ванная: ванную
аристократ: аристократа
преследовать: преследуют
половина: половине
инициатива: инициативе
селекционер: селекционера
линейный: линейным
вестись: ведется
начать: начните
колено: колена
лентяй: лентяев
прибыть: прибывших
пасти: пасти
во-первых: во-первых
двигаться: движутся
затянуться: затянулось
разновидность: разновидность
подмешивать: подмешивать
вакансия: вакансии
угощение: угощение
гипотеза: гипотезу
базовый: базовым
пережиток: пережиток
египет: египет
перенимать: перенимая
знакомство: знакомство
обойтись: обойдется
бегов: беговыми
план: плане
вроде: вроде
леность: лености
исчезнуть: исчезнуть
ставка: ставка
минутный: минутное
тренировка: тренировок
голень: голени
специфический: специфических
выше: выше
грудной: грудная
мурлыка: мурлыкой
разбавить: разбавленную
единственный: единственное
большинство: большинстве большинство большинства
вместе: вместе
чересчур: чересчур
глянцевый: глянцевой
погоняться: погоняться
веганский: веганских
летальный: летальный
медленный: медленнее
изгиб: изгиб
посадить: посажены
корм: корма
рисовый: рисовая
рейтинг: рейтинг
выясниться: выяснилось
александр: александра александр
финансовый: финансовом
выступление: выступлении
проблема: проблем
дисциплина: дисциплины
длина: длину
подписываться: подписывайтесь
ранка: ранки
обуздать: обуздать
вытянутый: вытянутая
основа: основы
самостоятельно: самостоятельно
жилистый: жилистое
запретить: запрещено
очень: очень
обычно: обычно
выполнять: выполнять
шагнуть: шагнуть
наиболее: наиболее
подбегать: подбегают
толстый: толстый
разнообразный: разнообразных
постепенно: постепенно
составить: составила
кличка: клички кличку
шаг: шагом
отождествлять: отождествляют
правило: правила
довольно: довольно
частность: частности
держать: держать
отловить: отловить
замечательный: замечательный
отпускать: отпускать
свидетельствовать: свидетельствуют
срез: среза
удаление: удаления
касаться: касается
документ: документов
строительство: строительством
разборка: разборки
подлежать: подлежат
преследование: преследованию
пружинистый: пружинистый
сократить: сократить
проект: проекте
сразу: сразу
пора: пор
во-второй: во-втором
кг: кг
настороженный: настороженного
насколько: насколько
необходимость: необходимости
блестящий: блестящие
кефир: кефир
сидеть: сидеть
темперамент: темперамента
минимальный: минимальная
непромокаемый: непромокаемой
линька: линька
отзываться: отзываться
научиться: научится
действительно: действительно
потенциальный: потенциальные
низко: низко
чужак: чужака
кожный: кожных
банный: банные
внутренний: внутренней
осилить: осилить
тень: тень
косовато: косовато
причём: причем
вырождение: вырождения
лежанка: лежанку
осенний: осенним
недостаток: недостаток
вкусный: повкуснее
сметана: сметаной
оценить: оценит
кормление: кормление
конечность: конечности
артистичный: артистичны
проваривать: проваривать
несовместимый: несовместимые
волкодав: волкодавов
являться: является
старт: старте
хвост: хвост
просмотр: просмотра
случай: случае
стимул: стимулом
чёрный: черными
удовольствие: удовольствия
оккупировать: оккупирующий
гораздо: гораздо
комбинезон: комбинезоном
донести: донести
типичный: типичные
коврик: коврике
выделяться: выделяясь
