радость: радостью
процесс: процессе
событие: событий
использовать: используя использовали использовать
отличать: отличают отличает
сельский: сельским
кинолог: кинологов кинологи кинолога
подозрительный: подозрительных
тело: тела телом
пигментация: пигментацию пигментация
широко: широко
осторожничать: осторожничать
средний: средняя среднее средних средней
популярность: популярности популярность
выдиться: выдатся
пища: пища пищи пищу
оставить: оставят
из-под: из-под
четвероногий: четвероногих четвероногие четвероногими четвероногого
познакомить: познакомить
выделяться: выделяется
участвовать: участвовать
чёрный: черный
красный: красный
сколько: сколько
лохматый: лохматая лохматыми лохматых
ранний: ранней ранним раньше
морской: морскую
спрятать: спрячет спрятан
солновать: солную
предоставить: предоставить
название: название названием
собака: собаку собаками собак собака собаке собаки
жестковатый: жестковатой
хороший: лучшим хорошие лучшего хороший хорошими хорошей
растительный: растительного
ноздря: ноздри ноздрями
обсуждение: обсуждения
состояться: состоялся
следовать: следуют следует следовать
другой: другое другого других другими другим
агрессия: агрессии агрессию
сочленение: сочленений
обитать: обитали
цена: цена
рыба: рыбу рыбы
оставаться: оставалась
подушечка: подушечки подушечками
расположение: расположения
смысл: смыслах
вмешательство: вмешательство
материал: материалов материала
мастиф: мастифа
казаться: кажется кажутся
домовятаха: домовятах
дыхание: дыхание
размер: размерам размеров размеры размерами размера
постирушка: постирушки
книга: книги книга
бугор: бугры бугор
храп: храп храпом
качество: качествами качества
любовь: любовь любовью любви
сторона: стороны сторон сторону
долгий: дольше
дисквалифицировать: дисквалифицирующие
обучаться: обучаются
привлечта: привлечт
город: город городах
поголовье: поголовье
холка: холку холка холке холкой
россия: россия
живот: живот
морда: морде морду морды мордой морда
обратный: обратная обратный
услуга: услугам
восхищаться: восхищалась восхищаться
маленький: маленьким маленький маленькими маленького маленьких
лгкость: лгкостью
начало: началом начало
получаться: получается
великобритания: великобритании великобританию
ежедневный: ежедневные
радужка: радужки
ревностно: ревностно
представитель: представителей представителя представителем представитель представители
предложение: предложение
шея: шея шею
пагля: пагль
развитой: развитым развитой развиты
вкус: вкусом
гарантировать: гарантирует
шерсть: шерсть шерсти шерстью
раковина: раковинах
победитель: победитель
специально: специально
провести: провести
крупа: крупа крупы круп
гость: гостя гостей
челюсть: челюсти челюсть
украшать: украшающей украшающих
должный: должны должен должна
несложно: несложно
частый: частыми чаще
тип: тип типом
записаться: записаться
значительный: значительном значительную значительного
кандидат: кандидатам
взгляд: взгляд взгляду взгляде
исключение: исключение
проконсультироваться: проконсультироваться
детектив: детектива
косвенный: косвенные
лакомство: лакомству лакомства
человек: людям людей человеку человека
относиться: относится относятся
питомец: питомцами питомцев питомцам питомца
месяц: месяц
шкаф: шкафов
большой: большой
бдительный: бдительного
участок: участки участков
столь: столь
некоторый: некоторых некоторые
назвать: назвать
спустя: спустя
шрстный: шрстного шрстный
ценность: ценность
отличаться: отличается отличавшиеся отличаются отличались
выраженный: выражен
формат: формат
обильный: обильные
покладистый: покладистого
важно: важно
дополнительный: дополнительный
формула: формулы
главный: главный главным главные главная
рис: рис
душа: душе
встретить: встретить
оружие: оружием
способствовать: способствует
история: история
провиснуть: провисшую
бельгийский: бельгийская бельгийский бельгийскую
забота: заботой
щенок: щенка щенков щенки щенок
среда: среда
проявляться: проявляется
грудной: грудную
худоба: худоба
закрытый: закрытая
видно: видно
причинять: причиняйте
подстричь: подстриженную
миловидный: миловидной миловидного
попросить: попросите
проявлять: проявляет проявляют проявлять
кристи: кристи
насторожить: насторожить
прилегать: прилегающие прилегают
пытливый: пытливым
картина: картине
дикий: дикие
любимица: любимицей
форма: форма форму
брюсселец: брюсселец брюссельца брюссельцы
положительный: положительной положительным
создиться: создатся
семья: семьи семье семьям семей
гречка: гречку
базовый: базовых
игривый: игривыми
пролететь: пролетит
упрямиться: упрямятся
выбрать: выбранного выбрать
выпуклый: выпуклые выпуклым выпуклая
характеристика: характеристика
быть: е будьте будут
ошпарить: ошпаренное
этот: этими эта этих
стоп: стоп
выставка: выставках выставки выставке
всеобщий: всеобщему
награда: наград
чрный: чрный
предать: преданным преданного
ветеринар: ветеринаром ветеринара
визит: визитов
около: около
заводчик: заводчик заводчиком заводчика заводчики
купание: купания купанием
следующий: следующие следующий
брюссельский: брюссельский брюссельского брюссельские брюссельскими брюссельскую брюссельских брюссельским
пол: пола пол полом
пятно: пятна
война: войны
зоомагазин: зоомагазинах зоомагазине
чихать: чихать
даться: даться
брюссель: брюсселе брюсселя
еда: еды
копчный: копчные
веслый: веслыми
коготь: когти когтей когтями
одевать: одевать
приподнять: приподнята приподнят
порода: породе породам породы породах пород породу порода
стать: стала станут стать станет
удаление: удалении удаления
состав: составу
неприметный: неприметны
маска: маска маской
считать: считает считают
кардинально: кардинально
уютный: уютная
яичко: яичек
первый: первой первое первого первый первая первую
основное: основном
ложка: ложку
видео: видео
помимо: помимо
приобретение: приобретении приобретения
супер-премиум-класс: супер-премиум-класса
бородач: бородача бородач бородачам бородачи бородачей
начать: начать
долгожданный: долгожданной
психический: психическое
организовать: организовать организованной
конец: концом конец
ручка: ручки
внимание: внимания вниманием внимание
меню: меню
полностью: полностью
герой: героем
самочувствие: самочувствием самочувствия
возможный: возможные возможную
углеводный: углеводные
изучить: изученные
компания: компании компанию
передвигаться: передвигаются
каждый: каждой каждым каждому
вакцинация: вакцинация вакцинации
привлекать: привлекал
генриетта: генриетта
известный: известная известны
позаботиться: позаботьтесь позаботилась позаботиться
небольшой: небольших небольшая небольшую небольшие небольшим
гриффон: гриффоном гриффон гриффона гриффонами гриффонов гриффоны гриффонам
чай: чай
косточка: косточками
рацион: рациона рацион
доля: долю
прежний: прежний прежнего
называть: называют называемые называемое
содержание: содержание содержании содержания
чистый: чистыми чистой
мордочка: мордочки
сера: серы
немного: немного
увидеть: увидят
свет: света свет
приплюснуть: приплюснутой
печальный: печальным
допускать: допускать допускает допускают
движение: движение движения движении
слово: слово слову слова
зря: зря
мощный: мощный
игра: играм
стратегия: стратегия
требовательный: требовательных
рекомендовать: рекомендуют
борода: бороду
защита: защиты
путь: путь пути
окрас: окраса окрас окрасом
сравниться: сравниться
бельгиец: бельгийцы
покупка: покупкой покупки
специальный: специальная специальную специальный
привыкнуть: привык привыкли
связь: связь
приподниматься: приподнимаются
баранина: баранину
круглый: круглыми круглый
спинной: спинном
режим: режиме режим
жизнерадостный: жизнерадостный жизнерадостного
вода: воде вода водой
внешность: внешность внешностью внешности
месье: месье
признать: признает признали
прижать: прижатые прижаты
энергичный: энергичные
брабантский: брабантскую
острый: острую острый
владелец: владельцев владельцу владельцы
переводиться: переводится
прослеживаться: прослеживается
опустить: опущенную
бытовать: бытует
опрятно: опрятно
племенной: племенная племенной
пока: пока
осмотр: осмотру осмотре
сводистый: сводистые
прозвучать: прозвучал
любопытный: любопытных любопытными
состояние: состоянии состояние
подойдт: подойдт
официальный: официальный
обладать: обладают
программа: программа
вязка: вязки
многочисленный: многочисленной
очаровательный: очаровательным очаровательный
типичный: типичный
собачка: собачкой
восхищение: восхищение
основный: основного основное
отведнный: отведнном
уровень: уровнем уровне
предмет: предметы
подтверждать: подтверждают
заниматься: заниматься
неплотно: неплотно
пресекать: пресекать
подвергать: подвергать
частота: частоту
домовятами: домовятами
длинный: длинных длинные длинная длинными
изучение: изучения
плотно: плотно
комплекция: комплекцию
поднять: поднятым
проверить: проверить
толчок: толчками толчок
ликвидировать: ликвидировать
плоский: плоскую
ян: яна
сосуд: сосудами
смотреть: см смотрит
впитывать: впитывает
превышать: превышает
доверие: доверие
фотография: фотографии
огюст: огюст
гордо: гордо
порция: порцией
заслужить: заслужить
уход: уходе уход
подозрение: подозрения
чтко: чтко
вредитель: вредителями
охранный: охранными охранные
знать: знать
помнить: помните
губа: губа губ губы
оститься: остатся
результат: результат
высокий: высокая высокий
питомник: питомники питомника питомник
завоевать: завоюет
настроиться: настроится
вирусный: вирусным
чета: четы
глаз: глаза глаз
густой: густыми густой
пугливый: пугливы
приняться: принялись
муха: муха
создавать: создают
мягкий: мягкий мягким
задержаться: задержаться
корм: корм кормом корма
вопреки: вопреки
самый: самым самое самую самых самые
сопровождение: сопровождении
веселие: веселья
вниз: вниз
неприхотливый: неприхотливы
ус: усы усами
холод: холодов
век: века век
собачий: собачьей собачье
малыш: малышу малышей малыши малыша
складочка: складочки
год: года лет году
желаемый: желаемое
доработать: доработали
поскольку: поскольку
тапочки: тапочки
прочий: прочие
необходимость: необходимостью необходимости
краткий: краткая
весьма: весьма
язык: язык
свой: своими своим свой своего своих свои
сильный: сильная сильные сильными
натуральный: натуральная натуральный натуральную натурального
отношение: отношение отношению отношения
заболевание: заболеваниям
место: место месте места
приводить: приводит
объединять: объединяет
отметить: отметить
эксперт: экспертов
ранненидерландский: ранненидерландского
узкий: узкие узкую
купать: купать
мозг: мозге мозга
десять: десять
факт: факт
доверить: доверить
любимец: любимцем любимцу любимца любимец любимцах
шерстинка: шерстинок
вконтакте: вконтакте
рядом: рядом
впечатление: впечатление
создать: создать создал
агрессивный: агрессивны агрессивное агрессивные
разновидность: разновидности
незамеченный: незамеченной
обращение: обращения
примечательный: примечательны примечательна примечателен
роль: роль
выражение: выражением
потребовать: потребует
гусар: гусара
туловище: туловища
подбородок: подбородок подбородке
наблюдение: наблюдением
французский: французского
вывоз: вывозе
животное: животных животным животного животными животные животное
один: одного одна одной одном
сша: сша
общий: общий общая
появление: появления
навязывать: навязывать
переводить: переводить
характер: характером характеру характер
преследование: преследования
волос: волос
длина: длины длиной длина
светлый: светлая светлые
упасть: упал
поездка: поездка
метод: методам
эффект: эффектом эффект
протянуть: протяните
основать: основана основали
хотя: хотя
нижний: нижняя нижнюю нижних
заворчать: заворчит
жизненный: жизненным
стачиваться: стачиваются
расстояние: расстоянии
обманчивый: обманчиво
определиться: определитесь определились
планировать: планирует
видный: видны
содержаться: содержаться
сомкнутый: сомкнутой
менять: менять
свый: свом
хвост: хвостом хвоста хвост
больший: большая
избежать: избежите избежать
пасть: пасть
щека: щеках
собаководство: собаководства
веко: веко веки
малый: малейшие меньшую
вид: видов виду виде видах
информация: информация
подходить: подходит подходят
телосложение: телосложение
слякоть: слякоть
друг: друг другом друга
масса: масса массу
любой: любую любом
сустав: суставы
палец: пальцами пальцев
помт: помту помта
мочь: могли могут можете
прогулка: прогулку прогулки прогулках
проживать: проживая проживаете
наступление: наступлением
клуб: клуба
приятель: приятеля
авторитет: авторитет
негативно: негативно
распространнный: распространнные распространнных
дружба: дружбе дружба
мириться: мириться мирятся
настоять: настоянная
крепкий: крепкие крепким крепкий крепкая крепкими крепкого
подходящий: подходящий подходящие
окружающий: окружающие
вздрнуть: вздрнутой
сухой: сухой сухие сухое сухим
польза: пользу
резвиться: резвиться
протереть: протереть
отзываться: отзываются
габарит: габариты
кончик: кончик
ощупь: ощупь
среди: среди
дом: дом доме
дуга: дуги
параллельный: параллельных
категорически: категорически
линия: линию линиях линия линий линии
рельефный: рельефной
проточина: проточины
испытывать: испытывать
вскоре: вскоре
легендарный: легендарного
окружный: окружен
собаковод: собаководов
центр: центре
ведение: ведение
новичок: новичков новичкам
пристальный: пристальным
зерно: зерно
становиться: становились становятся
тревожный: тревожный
полный: полной
терпимо: терпимо
рука: руки рук руку
макушка: макушке
аллергия: аллергия
обусловить: обусловлена
берег: берегу
подтвердиться: подтвердились
болезнетворный: болезнетворных
орёл: орла
счастливый: счастливым
мир: миру мира
урожай: урожая
вперд: вперд
возрастной: возрастной
мировой: мировой
квадратный: квадратный
одиночество: одиночеством одиночеству
который: которое которой котором которая которых которые который
немногочисленный: немногочисленной
территория: территории
декоративный: декоративная декоративные декоративным
укромный: укромное укромный
усилие: усилия
делиться: делилась
чистка: чистка
добавить: добавьте
знатный: знатные
человеческий: человеческие человеческим
пушистик: пушистика
умеренный: умеренная
происхождение: происхождения происхождением
зуб: зубьями зубы зубов
резец: резцы
задуматься: задуматься
необходимо: необходимо
понимать: понимают
хвостик: хвостиках
терьер: терьер
выходец: выходцы
оторвать: оторвали
заблуждение: заблуждению
добродушный: добродушному добродушный
задний: задние
бдра: бдра
укорочнный: укорочнный
звоночек: звоночек
редкий: реже редкая
гидроцефалия: гидроцефалия
черта: черты
тмный: тмную
тщательно: тщательно
терпеть: терпеть
георг: георга
предплечье: предплечья
дрессировка: дрессировка дрессировки
симптом: симптомов
последовательность: последовательностью
время: время времени
агрессивность: агрессивность
таков: таковы
полость: полость
п-образный: п-образную
нм: нм
социализировать: социализированные социализированный
формировать: формирует
тплый: тплое
противный: противном
пясть: пясти
скрещивание: скрещивание
кость: костей кости
блюдо: блюдо
шелковистый: шелковистый
хозяин: хозяином хозяевам хозяина
ротовой: ротовая
труднодоступный: труднодоступные
взять: возьмите взяв
тотчас: тотчас
параллельно: параллельно
мифологический: мифологического
непослушный: непослушной
благоприятный: благоприятные благоприятное благоприятная
речной: речную
приближение: приближении
мера: мере
неприспособленный: неприспособленными
ничто: ничто
бойкий: бойкого бойкий
заострнный: заострнную
сетчатка: сетчатки
охрана: охраны
полка: полках
объединиться: объединились
связка: связку
постоянный: постоянный постоянного постоянном
рост: рост роста
порадовать: порадовать
иоганн: иоганна
сумасбродный: сумасбродную
касательно: касательно
скрытый: скрыты
зимний: зимних
сила: силы сил
крысолов: крысоловов
спонтанный: спонтанная
лишиться: лишиться лишилась
резко: резко
человечность: человечность
к: ко
реклама: реклама
наклон: наклоном
получить: получите получат получили
раздражение: раздражению
выделять: выделяют выделяет выделяйте
кровать: кроватью
важный: важную важный
поставить: поставленную поставлены поставленные
грызун: грызуны грызунам
необходимый: необходима необходимых
равный: равным
звук: звук
мускулатура: мускулатурой мускулатуру
второй: второй
ягода: ягоды
сука: сук
ум: умом
эйк: эйка
дистихиаз: дистихиаз
процедура: процедуру процедуры процедурах процедура
выразить: выражена
рекомендоваться: рекомендуется
мочка: мочки мочка
грубый: грубыми грубое грубее
отдать: отдайте
характерный: характерны характерен
сонный: сонным
воспитание: воспитание
препятствовать: препятствует
подрезать: подрезайте
шлейка: шлейка
связать: связана
правильно: правильно
воспитанный: воспитанные
седалищный: седалищные
проступать: проступает
лапа: лапами лапы лапу
сайт: сайту
карандаш: карандаши
ужин: ужинах
родословная: родословной
энтузиазм: энтузиазмом
специалист: специалисту
занять: занять
активный: активная
понять: понять
птица: птицам
оповестить: оповестит
ласковый: ласковому
обустроить: обустройте
лхаса: лхаса
лишь: лишь
бакенбарда: бакенбарды
соотношение: соотношении
дама: дамы
получасовой: получасового
стрижка: стрижка
течка: течке
домашний: домашними домашним
убираться: убираются
старичок: старичка
половина: половиной половине
рбра: рбра
жесткошрстный: жесткошрстный
тесный: тесном
форум: форум форуме
вырастать: вырастают
немецкий: немецкого
оберегать: оберегать
спорт: спорта
варный: варную
предпочтение: предпочтение
голова: головой голову голова
подтянутый: подтянутый
хромота: хромота
белка: белки
трхразовый: трхразовые
паспорт: паспорт
хотеть: хотят хотите
углма: углм
требовать: требуют
боль: боль
тяжело: тяжело
устать: уставшим
мальчик: мальчики
такой: такие такого таким такими
десяток: десятка
советовать: советуют
внешне: внешне
любитель: любители
добавлять: добавляйте
ухо: ухом ушей уши ушам
проникать: проникали
пигментировать: пигментирована пигментированы
снискать: снискали
мясо: мяса мясо
ключ: ключей ключи
простригать: простригать
подтверждение: подтверждение
распространение: распространения распространении
выразительный: выразительный
читать: читать
подразумевать: подразумевая
изрядно: изрядно
значительно: значительно
земля: земли
ресница: ресниц ресницами
добросовестный: добросовестный
описание: описание
рано: рано
будни: будни
лай: лая лай лаем
капризный: капризных
военный: военных
налта: налта
обратить: обратили
гигиена: гигиены
приступать: приступать
лопатка: лопатки
простудный: простудным
здоровье: здоровьем здоровью здоровье
округлый: округлые
спальня: спальни
кровеносный: кровеносными
неуклюжий: неуклюжий
кобылий: кобылье
гребень: гребень
однако: однако
выбираться: выбирайтесь
искренне: искренне
овсянка: овсянку
преданность: преданность
обработка: обработка
поэтому: поэтому
коричневый: коричневый коричневую
случай: случаев случаи случае
пертёс: пертеса
консультация: консультацию
чайный: чайную
копирование: копирование
дружелюбный: дружелюбная
нужда: нужду
активность: активность
предусматривать: предусматривает
мечтать: мечтать
осматривать: осматривайте
дружелюбность: дружелюбность
коричневатый: коричневатой
иить: иили
доступ: доступ
пьер: пьер
иммунитет: иммунитет
отзыв: отзывах отзывы
размножение: размножения
порядок: порядку
крупный: крупных крупной крупными
обязательство: обязательствам
упитанный: упитанного
тримминг: тримминге тримминга
сокровище: сокровища
кошка: кошки кошкам
способ: способ
однообразный: однообразные
коммуникабельность: коммуникабельность
выделение: выделения
эркюль: эркюлем
отсутствие: отсутствии
поощрение: поощрению
мимо: мимо
бежевый: бежевый
шум: шум
внутренний: внутреннему
поиск: поиску поиск
ванная: ванной
покупатель: покупателю
дрессировать: дрессируемых
испуг: испуг
сквозняк: сквозняков
мопс: мопсов
ввиду: ввиду
лишний: лишних
допустимый: допустимо
мать: матери
идея: идею идеей
придться: придтся
клетка: клетку
ренуар: ренуар
назад: назад
мордах: мордаха
поначалу: поначалу
цвет: цвет цвета
носить: носила носящего
клиника: клинику
настоящий: настоящий
интерес: интерес
сердце: сердца
осторожно: осторожно
локоть: локти
минимум: минимум
принятие: принятия
пята: пятам
скосить: скошен
профессиональный: профессионального
целое: целом
объявление: объявления
неаккуратно: неаккуратно
подарить: подарив
основной: основные
полова: половой
новый: новую новыми нового новый
опыт: опытом
какой: каким какого
интеллект: интеллект интеллектом
напоминать: напоминающая
настороженно: настороженно
культура: культуры
вес: вес
спина: спину спина
сэкономить: сэкономит
святой: святого
осторожный: осторожного
окрестность: окрестности
полотенце: полотенцем
действие: действиях
питание: питания питание
француз: француз
голос: голос
возраст: возраст возраста
ежедневно: ежедневно
приучить: приучить
нос: носа носом нос
сон: сна
разведение: разведение
бег: бега
своевременный: своевременная
светло-бежевый: светло-бежевого
норвич-терьер: норвич-терьер
именно: именно
бельгия: бельгии бельгия
тмной: тмной
отклонение: отклонения
набег: набегов
рот: рта
улица: улице
отсутствовать: отсутствуют отсутствующая
расчсывать: расчсывать
грубоватый: грубоватые
кот: котом
продолжительность: продолжительность
недоверчиво: недоверчиво
пользоваться: пользуйтесь
кашлять: кашлять
покров: покрове покров покрова
член: членов члены
излишний: излишняя
окантовка: окантовки
хьюберт: хьюберта
спутываться: спутывалась
затылочный: затылочный
вряд: вряд
датироваться: датируются
паста: пасту
положение: положении
бобовый: бобовые
расположить: расположены
оттенок: оттенок
шампунь: шампунь
хрупкий: хрупкие
низкий: низкого
отдых: отдыха
прийтись: пришлось
первоначальный: первоначальной
доминирование: доминированию
вокруг: вокруг
скрыться: скрыться
утром: утром
слегка: слегка
шрстка: шрсткой
найтись: нашлось
неповрежднный: неповрежднными
фото: фото
обзавестись: обзаведясь обзавелась
проволокообразный: проволокообразный
прибылой: прибылых
регулярный: регулярном регулярному регулярных
сам: самого
миниатюрный: миниатюрных
готовый: готов
яндекс: яндекс
уголок: уголок уголках уголку
обед: обед
амбар: амбаров
оджка: оджку
непромокаемый: непромокаемый
остальной: остальным
ребнка: ребнка
франция: франции
череп: череп
социализация: социализации
сравнение: сравнении
проводить: проводят
вентиляция: вентиляции
получение: получение
склонный: склонно склонны
существо: существом существа
журнал: журнал
тщательный: тщательном
жсткий: жсткими
семьть: семьй
высота: высота
заметить: заметив
художник: художника
вилять: вилять
внешний: внешнему
обнажнный: обнажнная
универсальный: универсальный
нуждаться: нуждаются нуждается
постав: постав
ванна: ванны
мариновать: маринованную
образование: образование
уживаться: уживаются
контроль: контроля
кисломолочный: кисломолочными
холистик: холистик
обнажить: обнажить
болезнь: болезни болезнь
уличный: уличные
ребёнок: дети детьми
охранник: охранниками
косо: косо
прохладно: прохладно
изогнутый: изогнута
мундир: мундир
помесь: помесь
угодный: угодно
приобретать: приобретая
начинать: начинать начинает
вдоволь: вдоволь
роды: родах
активно: активно
мой: мое
кипяток: кипятком
напиток: напитки
третий: третье
драга: драга
упрямство: упрямство
образ: образом
местечко: местечко
придт: придт
головной: головного
копировать: копировать
обеспечивать: обеспечивают
внимательно: внимательно
облегчнный: облегчнное
яйцо: яйцами
живописец: живописца
объединнный: объединнного
очередной: очередного
подсушивать: подсушивающим
полтора: полутора
утратить: утратили
пахнуть: пах
взрослый: взрослые взрослых
желать: желать
присущий: присуща присущ
кофе: кофе
корпус: корпуса корпусу корпус
плохо: плохо
глухота: глухота
весь: всему всеми
скакательный: скакательные
чужой: чужим
шесть: шесть
перекус: перекус
королева: королева королевы
сородич: сородичами
скрывать: скрывая скрывает
слабый: слабыми
труд: труда
жирный: жирное
перейти: перейти
внести: внесли
счастие: счастью
суровый: суровые
климатический: климатические
обнаружение: обнаружении
чрной: чрной
ваш: вашей ваш вашего
из-за: из-за
верный: верного
костяк: костяком
своенравие: своенравие
ионидес: ионидес
широкий: широкими
поведение: поведение
грация: грация
овощ: овощами
фурминатор: фурминатор
прима: прима
коренастый: коренастые
собранный: собранными
апсо: апсо
сигнал: сигнал
определять: определяет
пойдт: пойдт
пти-брабансон: пти-брабансон
тот: тех тому
лад: лад
первичный: первичной
коровий: коровье
успешный: успешной
упаковка: упаковке
прим: примом
команда: командам команд команды команда
во-вторых: во-вторых
разбавить: разбавить
дворянство: дворянства
вместо: вместо
наблюдать: наблюдая
кавалер-кинг-чарльз-спаниель: кавалер-кинг-чарльз-спаниелей
ровный: ровной
препятствие: препятствиями
будущее: будущего
растительность: растительность
уделить: уделите
никто: никто
последний: последний последние последним
нескоро: нескоро
реестр: реестр
успех: успехом
женщина: женщина
стандарт: стандарта стандарт
всевозможный: всевозможных
окружить: окружите
день: день
вывихнутый: вывихнутые
задействовать: задействовать
атрофия: атрофия
тревога: тревоги
белый: белый
неться: нестся
играть: играют
выдворять: выдворяли
хозяйство: хозяйством
удаться: удастся
пример: примеру
унижение: унижения
пелнка: пелнке
поглаживание: поглаживанию
тёмный: темнее
экспортировать: экспортировали
вольер: вольере
ван: ван
дождь: дождем
мускулистый: мускулистая
вещество: вещества
подумать: подумать
вынести: вынесены
оценка: оценке
кусочек: кусочка
зарегистрировать: зарегистрировала
звонкий: звонким звонкий
рубль: рублей
погремушка: погремушку
невольно: невольно
сперва: сперва
родина: родине родина
появиться: появились появилась
спереди: спереди
исключить: исключить
королевский: королевское
сказываться: сказывается
долголетие: долголетию
вещь: вещей
упоминание: упоминания
жить: жила
принять: принят
трх: трх
опасность: опасность
правило: правило правила
игрушка: игрушки
очертить: очерчен
выпадение: выпадение
зубной: зубной
поясница: поясницу
варварский: варварских
общение: общение общении
переносица: переносицу
неделя: недель неделю
расспросить: расспросить
здоровый: здоровые здоровый
кармашек: кармашки
граница: границ
незаурядный: незаурядному
короткий: короткие короткая короткой
мисс: мисс
повышать: повышать
ассоциация: ассоциация
часть: часть
иметь: имеет имеют
обратиться: обратиться
стоимость: стоимость
приобрести: приобрести
ручной: ручном
осмотреть: осмотрите
поддерживать: поддерживать поддерживала
иначе: иначе
особенно: особенно
желательно: желательно
орлеанский: орлеанский
учебный: учебный
личный: личное
час: часов
окончание: окончания
возле: возле
очертание: очертания
неожиданный: неожиданное
включать: включать
современный: современным современных
достаточно: достаточно
обязательно: обязательно
радостный: радостного
фактор: факторов
миска: миски
свинина: свинину
умудрнный: умудрнными умудрнного
незваный: незваного незваных
когтереза: когтерез
косвенно: косвенно
имя: имя
жених: женихов
страница: страниц
двухмесячный: двухмесячные
переходить: переходят переходит
посетитель: посетителями
европа: европы
заскучать: заскучать
продумать: продумайте
несмотря: несмотря
сладость: сладости
купить: купить
часто: часто
подопечный: подопечных
среднеазиатский: среднеазиатская
склонность: склонность
находиться: находятся
прямой: прямые прямой
периферия: периферии
ушко: ушки
выступать: выступают
альф: альфы
предел: пределах
меняться: меняться
жстка: жсткой
осуществляться: осуществляется
вынуждать: вынуждая
свежий: свежем
период: периоды
прекрасный: прекрасного прекрасным
задача: задача
аджилить: аджилити
рождение: рождения
выбирать: выбирать
полустоячий: полустоячем
паразит: паразитов
дополнять: дополнять
беззаветный: беззаветной
слыть: слывут
судьба: судьба
рекомендация: рекомендации
глазной: глазных
сожаление: сожалению
продаваться: продаются
лоб: лоб лбом
послушание: послушание
наличие: наличие
проблема: проблему
обращать: обращайте
бровь: брови
прожорливость: прожорливостью
непроизвольно: непроизвольно
уверенность: уверенность
угол: углы угол
мысль: мысли
открытый: открытых
сырой: сырое
цоффаня: цоффани
похожий: похожими
совпадать: совпадает
джентльмен: джентльмен
патология: патологии
далеко: далеко
обладатель: обладатели
яблоко: яблок
одноклассник: одноклассники
избыточный: избыточную
скорее: скорее
славиться: славится славятся
вс: вс
кожный: кожные
элитный: элитным
волосок: волоски волосков
привычка: привычку
возможность: возможности
сходство: сходство
мнение: мнение мнению
позиция: позицией
счт: счт
чистить: чистить
известить: известит
привнесть: привнест
грудь: грудь
употреблять: употребляют
случайный: случайные
край: край
передний: передние
навык: навыки
кобель: кобелей
лев: льва
сплошной: сплошной
трубчатый: трубчатые
выбрасываться: выбрасываются
пострелёнок: пострелята
водный: водных
гигиенический: гигиеническим
перепелиный: перепелиными
оптимальный: оптимальный
бочкообразный: бочкообразную
шиповать: шипованная
шедевр: шедевр
бал: балах
объясняться: объясняется
потребоваться: потребуется
себя: собой
насчитывать: насчитывал
белые: белые
помощь: помощь
постараться: постараться постараются
выглядеть: выглядят выглядит выглядела
вынужденный: вынужденных
влага: влагу
квартира: квартира
специфичный: специфичного
удивительный: удивительного удивительной
направление: направлении
путешествие: путешествие
лежать: лежать
завоевание: завоевание
независимость: независимость
сделать: сделано сделает
задевать: задевая
кайма: кайму
будущий: будущему
присмотреться: присмотритесь присмотреться
потребность: потребность
дать: дай
порок: пороки
река: реки
разомнт: разомнт
средство: средство средства средством
недокус: недокус
сократиться: сократилось
остевой: остевой
вовсе: вовсе
жизнь: жизни
рьяный: рьяной
два: двух
киста: киста
идеальный: идеальное
комбинезон: комбинезон
рукавица: рукавица
овчарка: овчарка
они: ними
общество: обществе общество
британский: британского
сезонный: сезонными
едва: едва
говорить: говорить
благодаря: благодаря
уйти: уйти
измениться: изменилась
плодотворный: плодотворной
уменьшить: уменьшить
выпуклость: выпуклость
ветеринарный: ветеринарную
длительный: длительных
запах: запах
действительный: действительна
находить: находят
рабочий: рабочем
терпение: терпением
ключик: ключик
тон-два: тон-два
борозда: бороздой
вправду: вправду
обучение: обучение
нужно: нужно
мимимишность: мимимишности
обязывать: обязывали
также: также
параметр: параметры
коричневато-красный: коричневато-красной
умный: умная
бактерия: бактерий
замертво: замертво
спутник: спутники
ждать: ждать
момент: моменты момент
найти: найден
активированный: активированным
разделить: разделена
покой: покое
лежак: лежак
фамильярность: фамильярности
мария: мария
добрый: добрых
одержимый: одержима
моторчик: моторчик
пуарый: пуаро
король: короля
старший: старшего
клык: клыки
размягчение: размягчения
американский: американского американская
частичный: частичная
испачкаться: испачкаться
бочкообразность: бочкообразности
растянутый: растянутый
умеренно: умеренно
дискомфорт: дискомфорт
оставлять: оставляет
портрет: портрете
образовать: образуют
высоко: высоко
сложно: сложно
предпочитать: предпочитаемый
стоить: стоит
это: это
очевидный: очевидным
ворчать: ворчать
чужак: чужаку чужака
закручиваться: закручивается
щенячий: щенячьего
выбор: выбору выборе
принадлежать: принадлежавший
нелюдимый: нелюдимые
осложнение: осложнения
исходить: исходя
заканчиваться: заканчиваются
питаться: питается
любить: любят
верхний: верхняя
имущество: имущества
отвесный: отвесные
профиль: профиль
однажды: однажды
забавный: забавную забавными
аккуратность: аккуратность
трусливый: трусливое
отдельный: отдельных
версия: версия
алабай: алабай
подробный: подробнее
удача: удача
легко: легко
многий: многих
манера: манера
идеально: идеально
лента: ленту
увенчаться: увенчалась
остроконечный: остроконечными
словно: словно
столетие: столетий
седина: седина
вверх: вверх
возникать: возникает
слепота: слепота
водянка: водянка
помещение: помещение
уверить: уверены
английский: английского
воздух: воздухе
пасти: пасти
во-первых: во-первых
аффенпинчер: аффенпинчеров
заплатить: заплатить
проплешина: проплешин
продукт: продуктами продукты
выход: выход
вакансия: вакансии
адаптация: адаптации
шрстном: шрстном
вычсывать: вычсывать
толпа: толпы
прикус: прикус
приходиться: приходится
борьба: борьбы
незнакомец: незнакомцев
лобный: лобная
деликатес: деликатесы
полусмерть: полусмерти
выделить: выделить
специализироваться: специализируются
украсить: украшены
сей: сей
выше: выше
молоко: молоко
сказка: сказок
простудиться: простудиться
большинство: большинстве большинства
изобразить: изображена
вместе: вместе
течение: течение
чересчур: чересчур
изучать: изучать
специя: специями
сошлый: сошл
смотр: смотрах
ещ: ещ
строптивый: строптивого
тумбочка: тумбочках
публика: публики
зацеловывать: зацеловывать
катаракт: катаракта
утяжелнный: утяжелнной
рейтинг: рейтинг
смывать: смывайте
купирование: купирование
кран: крана
ряд: ряд
подписываться: подписывайтесь
появляться: появлялись
соответствующий: соответствующего
ты: тебе
самостоятельно: самостоятельно
запретить: запрещено
очень: очень
обычно: обычно
бутилировать: бутилированную
селекционер: селекционеры
горбатый: горбатую
произойти: произошло
натирать: натирать
второе: второе
постепенно: постепенно
происходить: происходит
кличка: клички
затруднительный: затруднительной
довольно: довольно
частность: частности
вариант: варианта варианты
надбровный: надбровные
обойдться: обойдтся
небрежный: небрежного
касаться: касается
скрываться: скрываться
документ: документов
повторить: повторит
неразвитый: неразвитую
вырастить: вырастить
променад: променада
хранить: хранили
погладить: погладить
лидер: лидера
сократить: сократить
проект: проекте
найдт: найдт
повадка: повадки
потомок: потомки
пора: пор
отравление: отравления
экипаж: экипажей
кг: кг
красивый: красивую
модный: модная
сидеть: сидеть
среднее: среднего
носка: носки
выщипывание: выщипывании
дефект: дефектами
линька: линька
фрукт: фруктами
ответ: ответ
требоваться: требуются
окрасить: окрашенными
страна: страна
низко: низко
прибегать: прибегайте
встречаться: встречались
замедлять: замедляющим
справлять: справлять
общительный: общительные
комнатный: комнатной
смышлный: смышлными
сербский: сербская
ребяческий: ребяческим
кормление: кормления
зоошампунь: зоошампуня
громкий: громким громкого
плюсна: плюсны
родитель: родителей
титул: титулов
вывести: вывели
прогуляться: прогуляться
конечность: конечности
глубокий: глубокий
привезти: привезена
расставить: расставлены
минимальный: минимальное
живой: живым
сыграть: сыграла
арнольфиня: арнольфини
рысью: рысью
поздний: поздней
масло: масла
житель: жителей
нежирный: нежирными
скромный: скромные
условие: условия
гораздо: гораздо
роман: романов
неопущение: неопущение
свидетельство: свидетельство
шаг: шаг
