приподнимать: приподнимающую
америка: америке
заметить: заметили
необязательно: необязательно
территориальный: территориальные
овощ: овощи
приемлемый: приемлем приемлемы
событие: событий
кинолог: кинологов
тело: тела тело
кровь: крови
подвергать: подвергает
здоровый: здоровых здорового
сколько: сколько
соплеменник: соплеменниками соплеменников
быть: будете
энтропия: энтропия
целый: целой
экстерьерный: экстерьерными
название: название названия
ковровый: ковровых
собака: собаку собаками собак собака собакам собаке собаки
примерно: примерно
переезд: переезда
когтевой: когтевая
обсуждение: обсуждения
приветствоваться: приветствуется
оно: оно
цена: цена
смышлёный: смышленые
вентилировать: вентилируемые
материал: материалов
служебный: служебная
племенной: племенные
приподнять: приподнимите
бескостный: бескостное
исчезновение: исчезновению
стараться: старается
феноменальный: феноменальная
эффектный: эффектными эффектного
обратить: обратите
владелец: владельцам владельца владельцев владельцы
объёмность: объемности
стоять: стоят
дисквалифицировать: дисквалифицирующие
украшение: украшение
силиконовый: силиконовая
насадка: насадка
семейство: семейства
режим: режиму режима
субпродукт: субпродукты
поголовье: поголовье
россия: россия россии
живот: живот
обратный: обратная обратный
итог: итоге
потискать: потискать
богатый: богатых
покровный: покровная
серный: серные
палевый: палевая
первоначальный: первоначальный
вскарабкаться: вскарабкаться
скрасить: скрасит
перевести: перевести
представитель: представителей представителя представители
искать: искать
покрыть: покрыть покрытые
команда: команду командам команда
попробовать: попробовать
шея: шея
сильный: сильнейший сильным
стричь: стричь стригут
лосьон: лосьона
фокстерьер: фокстерьер
получать: получать
шерсть: шерсть шерсти шерстью
ласково: ласково
последующий: последующему
одиночество: одиночества одиночеству одиночество
концентрация: концентрацию
качество: качеств качестве качества
произносить: произносить
пережить: пережило
челюсть: челюсти челюстей
метод: метод
кресло: кресло
самый: самая самый самых
должный: должны должен должна
потомство: потомства
тип: тип типах типа
слабослышащий: слабослышащие
взгляд: взгляд взгляде взгляда
протестировать: протестируйте
защита: защита защитой
сегодняшний: сегодняшних
человек: людям человеком
месяц: месяц месяцы месяцев
питомец: питомцами питомцев питомцу питомец питомцы питомцам питомца
относиться: относится относиться
необходимый: необходимы
сверху: сверху
равно: равно
масть: масти
дверь: дверью
включая: включая
участие: участием участие
укоротить: укоротив укоротить
важно: важно
щадить: щадящего
формула: формулы
собачка: собачками
способность: способность
норма: норм
душа: душе душу
история: история
брать: брать
диковинка: диковинки
кинологический: кинологических кинологическими
зрелый: зрелых
щенок: щенка щенков щенки щенок
откликаться: откликаться откликался
проявляться: проявляется
избыточный: избыточное избыточной
ножницеобразный: ножницеобразная
конкуренция: конкуренция
податься: подались
миловидный: миловидной
наш: наших
морозный: морозную
кипа: кипой
прилегать: прилегающие
подбирать: подбирать
паста: пастами
маниакальный: маниакальной
учитель: учитель
взрослый: взрослый взрослая взрослых
голова: голове головы голова
дожить: дожил
семья: семьи
метис: метисами метисов
тесно: тесно
воронка: воронки
характеристика: характеристика
стоп: стоп
такой: таком такие
помощь: помощью
успех: успеха успехи
коричневый: коричневая коричневого
миниатюрный: миниатюрными миниатюрный миниатюрных
витаминно-минеральный: витаминно-минеральных
брюссельский: брюссельский
красно-коричневый: красно-коричневая
пол: пола полу
пятно: пятна
перегрев: перегрева
общение: общению общении
коготь: когти
касаться: касающиеся касается
порода: породе породы пород породами породу порода
осветлять: осветляющие
считать: считает считать
быстро: быстро
менять: меняет
входить: входят
угол: углам углу
бишон: бишоном бишону бишоны бишонам бишонов бишон бишонах бишона
удаться: удалось удастся
гаванец: гаванец гаванцам гаванца гаванцев гаванцы
раз: раза
видео: видео
обследование: обследования
стресс: стрессу стресс
кубинец: кубинец кубинцы кубинцем кубинца
имя: имена имя
восстановление: восстановления
природа: природе
табачный: табачный табачная
внимание: внимания внимание
меню: меню
полностью: полностью
лексикон: лексикон
компания: компании
одетый: одетой
домашний: домашних домашней
атласный: атласного
способный: способный способен способны
придумать: придуманных
частота: частота
передаваться: передаются
талия: талия
рацион: рациона
садовый: садовом
речь: речь
раздумье: раздумий
содержание: содержание содержанию содержания
минерал: минералах
мелкий: мелких мелкий
работа: работе работы
немного: немного
походка: походка
попытка: попытки
туалетный: туалетными туалетной
составлять: составляет
лидерствовать: лидерствует
сигнальный: сигнальных
радужка: радужкой
рекомендовать: рекомендуют рекомендованы рекомендованных
характеризоваться: характеризуется
стимулировать: стимулирующей
гриффон: гриффон
численность: численность
предел: пределы пределах предел
брид-тип: брид-типе
подвес: подвес
специальный: специальная
кубинский: кубинская кубинской кубинский кубинские кубинских кубинскими
кстати: кстати
подчиняться: подчиняется
связь: связь
выраженный: выраженная выраженной
комфортный: комфортные
превышать: превышать
граница: границу границы
единственный: единственный
энергичный: энергичные
выяснить: выяснить
диарея: диареи
сухость: сухостью
бытовать: бытует
пока: пока
принимать: принимая
хаванеза: хаванезы хаванеза хаванезам хаванез хаванезу
год: годах лет году
прикупить: прикупите
типичный: типичный
структура: структуру
гаванский: гаванских гаванские гаванского гаванским гаванский
давать: давать
член: члена членом членов членами
среднестатистический: среднестатистический среднестатистического
коробка: коробка
частенько: частенько
складка: складку
придавать: придавайте
просить: просите
приключение: приключениях
заниматься: заниматься занимающихся
лидерство: лидерство
прочный: прочным
выставка: выставки
питать: питаете
плотно: плотно
родительница: родительницей
запрещаться: запрещается
утопить: утопить
бумага: бумаги бумага
полениться: полениться поленитесь
смотреть: см
точный: точные
еда: едой
лёгкий: легкий
фотография: фотографии
обзаводиться: обзаводитесь
визжать: визжит
невзирая: невзирая
ассоциация: ассоциациями ассоциаций
агрессивный: агрессивная
работать: работать работает
уход: уходе ухода уход
капуста: капусты
суточный: суточный
подпитывать: подпитывает
революция: революция
создание: создания созданием
чёрный: черная черного
помнить: помните
миллиметр: миллиметров
ушко: ушком
климат: климат
страдать: страдают страдающим
высокий: высокая высокий высокое
особь: особь особей
питомник: питомники питомника питомников
отдавать: отдавать
глаз: глаза глазами
обрывок: обрывков
подавать: подавая
прийтись: придется
сбросить: сбросить
чистить: чистящая чистят
чистопородный: чистопородного
педикюр: педикюр
список: списки список
часть: части часть
сказать: сказать
поздний: позже
век: века веке век
форма: форме форму
вести: вести ведет
право: праву
предмет: предмет
остальной: остальными остальных
поскольку: поскольку
следить: следящие
ошпарить: ошпаренным
повториться: повториться
простой: простой
краткий: краткая
приплыть: приплыли
любой: любого любую любые любой любом любым
химия: химии
рыба: рыб
начать: начавшие начали начал
отношение: отношение отношении отношением
место: место
сушка: сушкой
закономерность: закономерность
игривость: игривость
эксперт: экспертов эксперты
купать: купать
выполнить: выполнил
вконтакте: вконтакте
участок: участка участке
свет: свет
ведро: ведра
устраивать: устраивая
впечатление: впечатление
версия: версии
создать: создать
разведение: разведением
ярко: ярко
проявлять: проявлять
шубка: шубки
изюминка: изюминок
требовательный: требовательный
животное: животных животным животного животные животное
моляр: моляры
сша: сша
увеличить: увеличить
волос: волос волоса
длина: длины длина длину
тон: тон
закрывать: закрывайте
неприятный: неприятному
выбрать: выбрать
распространить: распространенный распространенная
скула: скулы скул
оценить: оцените
мясистый: мясистые
куда-нибудь: куда-нибудь
находиться: находящаяся находящиеся
бланкито-де-ла-абан: бланкито-де-ла-абана
основать: основана
сустав: сустава
классический: классические
хотя: хотя
х: х
бритва: бритвой
мягкий: мягкие
друг: друзей друг друга
редкий: редкой редкий
импортировать: импортировать
обладать: обладая
выгуливать: выгуливать
получасовой: получасовых
который: которую которыми которого котором которая которых которым которые которому который
обстоятельство: обстоятельств
эктропий: эктропия
местный: местной местные
породный: породный
познакомиться: познакомиться
собственно: собственно
пудра: пудры
страсть: страсть
установленный: установленному
прокатиться: прокатитесь
ценник: ценником
балкон: балкон
безопасный: безопасные
квартира: квартире квартирах квартиры
опыт: опыта
ограждение: ограждение
выскользнуть: выскользнув
облаивать: облаивать
мера: меру
сырой: сырым
плод: плоды
проживать: проживавшим
информация: информация информации
большой: большое
двухразовый: двухразовое
котироваться: котируется
палец: пальцами
третий: третьи
западать: западающий
мочь: могли могут можете
баловать: баловали
округлить: округленные
поиск: поисков поиск
ребро: ребра
активный: активного
авторитет: авторитет
выбор: выбор выбора выбору
наноситься: наносятся
половина: половины половина половину половине
характер: характера характеру характер
окрас: окрас окрасов
сдержать: сдержанного
обитание: обитания
аз: азы
воспринимать: воспринимать воспринимающие
слышать: слышали
исторический: исторических
низкий: низким низкая
лапа: лапах лапы
политический: политического
веко: веки
сформировать: сформировали
колено: колени
витамин: витамины
собирание: собиранию
длинный: длинные длинного длинной
считаться: считается считаются
земля: землей
строгий: строгих
пребывание: пребывания
дреды: дреды
подход: подходе
полный: полной
контакт: контакте контакт контакту
коммуникабельный: коммуникабельная
просто: просто
остаться: оставшаяся
энергетический: энергетический
мало: мало
имиджевый: имиджевых
насыщенность: насыщенности
конец: конца конец
водить: водить
мир: миру мире
пёс: псов пса
одинаковый: одинаковым
учитывать: учитывая
хитрый: хитрые
фрукт: фрукты
звать: зовут
массово: массово
вывих: вывих
территория: территории
являться: являетесь являются является
размещать: размещают
виртуальный: виртуальных
добавить: добавьте
вычёсывать: вычесывать
заслонять: заслонять
человеческий: человеческие
пушистик: пушистика
происхождение: происхождения
кнут: кнута
игривый: игривых
наследственный: наследственные
русскоязычный: русскоязычных
необходимо: необходимо
первый: первые первое первого первый первую первых
натянутый: натянута
груз: груз
психика: психику психики
резвый: резвый
дрессировка: дрессировка дрессировке дрессировкой
голос: голосом
время: время
подряд: подряд
лидер: лидерами
скотч-терьер: скотч-терьер
агрессивность: агрессивность
остров: острова острове островов остров
ушной: ушной ушное
сунуть: сунуть
день: дней день
погода: погоду
лоб: лбу
другой: другие другого других
забросить: заброшен
хозяин: хозяином хозяина
ладить: ладить
предпочитать: предпочитает
пушистиковый: пушистиков
например: например
питаться: питаться питающимся
несколько: несколько нескольких
сетчатка: сетчатки
экзотический: экзотические
рост: рост
глухота: глухоте глухота
отечественный: отечественных
понравиться: понравившийся
согласно: согласно
контрабанда: контрабандой
прилить: прилили
сложный: сложные сложный
хотеться: хочется
понять: понял понять
тёмно-коричневый: темно-коричневый
умеренный: умеренную
реклама: реклама
соответственно: соответственно
наклон: наклоном
средний: среднее средние средний
нюанс: нюанс
предложение: предложения
лакомство: лакомствами лакомства
готовый: готовых готов
любовь: любовью любви
качественный: качественные
второй: второй
крепкий: крепкое крепком
удлинённый: удлиненного
учебный: учебные
единица: единицы
вкус: вкус
рекомендоваться: рекомендуется
получиться: получится
вывезти: вывезли
воспитание: воспитание воспитанию воспитанием
прибалтика: прибалтики
привыкнуть: привыкнуть
один: одно одна одном
малыш: малыш малышами
одиннадцать: одиннадцать
потомок: потомков
куриный: куриный
вид: виду виде
завоевать: завоевать
хороший: хороший хорошее
сайт: сайту
сухой: сухие
тяга: тягу
гость: гость
вывозить: вывозили
селить: селили
плечо: плечу
социализация: социализация
пища: пищей
атака: атак
кожа: кожа
этот: эта этому
прямолинейный: прямолинейные
лишь: лишь
пытаться: пытается
вариант: вариант
долго: долго
любопытный: любопытного
производить: производить производит
сбежать: сбежали
форум: форум форуме форумах
тискать: тискать
детский: детскую
гладкий: гладкой
начало: начала начало начале
действие: действия действии
проходиться: проходитесь
беззлобный: беззлобным
манипуляция: манипуляции
переставать: перестает
скоро: скоро
гавана: гавана гаваны
нежность: нежности
комочек: комочки
гореть: горят
шерстяной: шерстяные
признак: признак признаков
подпитка: подпитки
натуральный: натуральной натуральное
описание: описание
объявление: объявлений объявления
будни: будни
виноград: виноград
упражнение: упражнениями
куба: куба кубы
стандарт: стандартом стандарт
страна: странам стране страну страна
ромашковый: ромашковом
военный: военных
развитой: развит
опрятность: опрятность
белый: белых белая белый
найти: найти
собачий: собачьих
однако: однако
рулон: рулоном
монотонный: монотонные
отличаться: отличаются
бланкито: бланкито
поэтому: поэтому
чашка: чашки
пертёс: пертеса
случай: случаев случае
хондродисплазия: хондродисплазия
копирование: копирование
дружелюбный: дружелюбная
черепной: черепная
активность: активность активностью активности
аккуратный: аккуратная
существовать: существует
дружелюбность: дружелюбность
отзыв: отзывах отзывы
пелёнка: пеленками
саша: саше
искоренить: искорените
нога: ноги
крупный: крупных крупнее
заключаться: заключается
бишоноподобный: бишоноподобные
кошка: кошки
очаровательный: очаровательный
слеза: слез
хаванез: хаванезов хаванезом
шум: шум
обязать: обязана
контактировать: контактируя
постав: поставом постав
черта: черт черта
потроха: потроха
неизбежный: неизбежная
лишний: лишних
мёрзнуть: мерзнут
идея: идею
смена: смену
значение: значение
настоятельно: настоятельно
нарушить: нарушил
породистый: породистого
оттенок: оттенка
постоянный: постоянному
лето: летом
цвет: цвет цвета
чайный: чайном
привязка: привязки
интерес: интерес
дом: дома
сердце: сердца
непрощупываться: непрощупывающиеся
задача: задачи
пенсионный: пенсионного
обивка: обивки
пята: пятам
хватать: хватает
компанейский: компанейскому
всячески: всячески
депигментировать: депигментированные
творог: творог
ухо: ушей уши
ножницы: ножницами
профессиональный: профессионального
злоумышленник: злоумышленников
целое: целом
миндалина: миндалин
хвостик: хвостиком хвостик
основной: основные
какой: каким
интеллект: интеллект
охранный: охранные
низкокалорийный: низкокалорийные
конечность: конечностей конечности
вес: вес весом
спина: спину спиной
степень: степени
эмоциональный: эмоциональном
называться: называется
приучить: приучить
нос: носа нос
результат: результаты результате
откладывать: откладывать
изогнутый: изогнут
именно: именно
серьёзно: серьезно
отклонение: отклонения
отсутствовать: отсутствуют отсутствует
продолжительность: продолжительность
подопечный: подопечный подопечному подопечного
полустоячий: полустоячие
питание: питанию питание
вряд: вряд
сование: сование
стать: стать
принадлежать: принадлежит
обеспечить: обеспечить
смычка: смычка
лестница: лестнице
маленький: маленькими маленького меньше маленькая
процесс: процессу процесс
окрестить: окрестили
шествие: шествие
питательность: питательность
полотно: полотно
американский: американские
доминирование: доминированию
способ: способом
повседневный: повседневном
продавец: продавца продавцы
запоминать: запоминает
слегка: слегка
тот: те тех тому
больший: большую
доска: досках
ожидание: ожидания
периодический: периодические
найтись: нашлось
фото: фото
бобовый: бобовых
интонация: интонации
болонка: болонок
сам: самого самом
яндекс: яндекс
аристократия: аристократии
свой: свой свое своей
нестись: несется
хотеть: хотите
оставлять: оставлять оставляя
череп: череп
прямой: прямую
тренировочный: тренировочную
общий: общей
боков: боков
холка: холке
предпочтение: предпочтений
пластина: пластина
двор: дворе
официальный: официальной
журнал: журнал
высота: высота высоты
делать: делать делают
покрытие: покрытий
внешний: внешнему внешнюю
испанский: испанские
след: следов
секрет: секреты
мореплаватель: мореплаватели
картофель: картофеля
разовый: разовую
болезнь: болезни болезнь
ребёнок: дети
кормить: кормят
сумма: сумма
заводчик: заводчиков заводчики
пружинистый: пружинистые
настой: настое
весёлый: веселого
лоток: лоток
летие: летие
контролировать: контролировать
либо: либо
требование: требование
волосатик: волосатик
аборигенный: аборигенными
штат: штатах
минута: минут
моющий: моющие
тальк: тальки
абразив: абразива
живой: живая живой
прийти: пришло
нежелательный: нежелательны
масса: массой
достигать: достигать
простуда: простуду
экстерьер: экстерьере
привезти: привезли
укусить: укусить
условие: условиям условия
дешёвый: дешевле
фирменный: фирменная
рассматривать: рассматривать
допустимый: допустимы
движение: движения
перекус: перекус
коготок: коготки
пушистость: пушистость
порог: пороге
помета: помете помета
контактность: контактность
контраст: контрастах
гигиенический: гигиенического
перейти: перейти
статус: статус статусе
невыраженный: невыраженная
ткань: ткани
эксклюзивный: эксклюзивных эксклюзивной
из-за: из-за
главное: главное
запрет: запретом
костяк: костяком
вооружаться: вооружаться
поведение: поведение
задать: заданные
собранный: собранными
менее: менее
временной: временной
сигнал: сигнал сигналом
уровень: уровне
пуфик: пуфик
шёрстка: шерсткой
пробежка: пробежек пробежкой
организм: организма
цель: целью
родословный: родословные
дорожка: дорожки
ровный: ровной
служебник: служебник
отсутствие: отсутствие
слишком: слишком
уделить: уделите
разнообразный: разнообразным
требоваться: требуется
прорваться: прорваться
подшёрсток: подшерсток подшерстка
оформиться: оформились
рука: рук
море: море
морда: морда
гигиена: гигиена
микроэлемент: микроэлементах
стандартный: стандартная
игрушка-антистресс: игрушка-антистресс
позволить: позволить
желание: желанием
замашка: замашек
собственный: собственную собственное
свобода: свободы
зимний: зимнее
оценка: оценке
кусочек: кусочка кусочками
пора: пора
поведенческий: поведенческие
уникальный: уникальный
рубль: рублей
появиться: появились
спереди: спереди
исключить: исключить
депигментация: депигментацией
пообщаться: пообщаться
постигать: постигать
закрепить: закрепите
мочка: мочка
зеркалить: зеркалить
небольшой: невелика небольшой невелико
стая: стаи
обводка: обводкой
постный: постное
иерархический: иерархической
правило: правило правила
слабо: слабо
декоративный: декоративных декоративными декоративной
зубной: зубной
аномалия: аномалии
встречать: встречать
дружелюбие: дружелюбия
короткий: короткие
забавный: забавных
продолжительный: продолжительную
иметь: имеет иметь имел имеют
позитивно-доброжелательный: позитивно-доброжелательный
стоимость: стоимость стоимости
удалять: удалять
приобрести: приобрести
иначе: иначе
особенно: особенно
новый: новым новый
бок: бока
желательно: желательно
час: часов
очертание: очертания очертаний
печень: печени
бытовой: бытовой
дрессировать: дрессировать
обязательно: обязательно
урок: уроков
доминантский: доминантских
пара: пару
локальный: локальному
возраст: возраста возрасте
угощать: угощать угощайте
обладатель: обладателем
утеплить: утепленный
отличать: отличающих отличает
неделя: неделю
слушать: слушать
однородность: однородность
зоомагазин: зоомагазина
лежанка: лежанке
понимать: понимать
несмотря: несмотря
купить: купить
сковывать: сковывать
солнечный: солнечный
меланхолик: меланхоликом
часто: часто
среднеазиатский: среднеазиатская
уплощённый: уплощенную
ввести: введите
перспективный: перспективных
компактный: компактные
характерный: характерная
процедура: процедура
проводить: проводит
одноразовый: одноразовыми
оказаться: оказаться оказались
бессмысленно: бессмысленно
заболевание: заболеваний
твёрдый: твердыми
допускаться: допускаются
укорачивать: укорачивать
комплекс: комплексов
обожать: обожаемым
лохматый: лохматые
целлюлозный: целлюлозных
период: периоды
поясница: пояснице
непременно: непременно
подготовка: подготовкой
кончик: кончики
пупочный: пупочной
поглощать: поглощает
продвигать: продвигать
садиться: садиться
лицо: лица
задаток: задатками
нестабильный: нестабильной
незлобливый: незлобливому
подпасть: подпал
сожаление: сожалению
мотивировать: мотивируя
функция: функцию
уступка: уступку
традиционный: традиционные
зарасти: зарастет
наличие: наличие
похвалить: похвалите
дисплазия: дисплазию дисплазия
чистый: чистой
чувствительный: чувствительную
домочадец: домочадцев
крупа: круп
весь: всем
патология: патологии
одноклассник: одноклассники
хаос: хаосу
слезотечение: слезотечение
захотеть: захотят
волосок: волоски
необыкновенный: необыкновенную
привычка: привычку
мнение: мнение мнению
проблема: проблема
выполнять: выполняющими
случайный: случайные
насущный: насущной
кроме: кроме
мясо: мясо
панический: панических
знать: знати
ошалеть: ошалевшим
среднее: среднем
десна: деснам
сегодня: сегодня
три: трех
восполнить: восполнить
адресовать: адресована
частый: чаще почаще
мусорный: мусорного
квадратный: квадратного
тазобедренный: тазобедренного
зуб: зубы
отнести: отнеси
туда: туда
есть: ест едят
лишить: лишены лишена
потребоваться: потребуется
несвойственный: несвойственно
обнимать: обнимать
непосредственность: непосредственности
белые: белые
запастись: запаситесь
выглядеть: выглядят выглядит
ваш: ваших
промах: промахи
покопаться: покопаться
див: дивы
стачиваться: стачивается
вдоль: вдоль
поощряться: поощряется
триумфальный: триумфальное
сделать: сделано сделайте
дополнительно: дополнительно
ранний: раньше
поощрение: поощрений
ультрафиолет: ультрафиолета
потребность: потребность
порок: пороки
резать: режут
национальный: национальные
действовать: действует
воспользоваться: воспользоваться
недокус: недокус
репутация: репутацию
дело: делами деле
жизнь: жизни
два: двух
пушистый: пушистый
комбинезон: комбинезон
овчарка: овчарка
средство: средства
отмереть: отмершие
проделываться: проделываются
роскошный: роскошный
поползновение: поползновениями
груминг: груминг
затем: затем
отмечать: отмечающие
собака-компаньон: собака-компаньон
группа: группы
российский: российских
висеть: висят
проживание: проживания
домосед: домоседов
признание: признании
сетка: сетка
бады: бады
обучение: обучение
почесать: почесать
игрушка: игрушка
относительно: относительно
шоу: шоу
нужно: нужно
мимимишность: мимимишности
также: также
приусадебный: приусадебного
умный: умная
настроение: настроение
покой: покоях
чей-то: чьи-то
вкусный: вкусных
момент: моменты
последний: последним
внутри: внутри
почёт: почете
обаяние: обаяния
истязать: истязать
выпуклый: выпуклой
возможно: возможно
шоу-питомец: шоу-питомца
ставка: ставку
зов: зов
двигательный: двигательной
крупяной: крупяные
голливудский: голливудской
одной-единственный: одной-единственной
корпус: корпус
потешный: потешный
волноваться: волноваться
серьёзный: серьезному
прогулка: прогулок
способствовать: способствовала
пользоваться: пользовались
исключение: исключения
высоко: высоко
агрессия: агрессию
соболиный: соболиная
позитивно-расслабить: позитивно-расслабленным
впоследствии: впоследствии
болтливый: болтлива
настоящий: настоящее
палитра: палитрой
смочь: смогут сможет
крипторхизм: крипторхизм
крайне: крайне
область: области
стоить: стоит
это: это
требовать: требуйте
калораж: калораж
отличный: отличным отличными
чашечка: чашечки
филе: филе
щенячий: щенячьего
вопрос: вопрос
приобретение: приобретение
разводить: разводить
дрессура: дрессуры
ласка: ласки
тупой: тупая
внешность: внешности
недуг: недуги
щётка: щетки
параллельный: параллельным
убрать: убрать
переселенец: переселенцы
начинать: начинайте
наращивать: наращивать
собрать: собрать
каша: каши
алабай: алабай
клан: клана
легко: легко
употребление: употреблению
склонный: склонна
лента: ленту
производитель: производителей
игра: игра
здоровье: здоровье
очёс: очесами
подумать: подумайте
столетие: столетий столетия
порция: порции
искоренение: искоренением
звонкий: звонкий
всякий: всяком
скрещиваться: скрещиваясь
методика: методика
слабовыраженный: слабовыраженная
дисциплинировать: дисциплинируйте
желток: желток
лай: лай
расчёт: расчеты
многое: многом
выдать: выдав
расчёсывать: расчесывать
тайный: тайную тайная
пасти: пасти
гладкошрстный: гладкошрстный
навык: навык
сила: силу
выход: выход
истинный: истинным
упорство: упорством
удивляться: удивляйтесь
вакансия: вакансии
продукт: продукты
передний: передних
затрачивать: затрачивает
выйти: выйдете
план: плане
цунами: цунами
европа: европу
путать: путать
чистокровный: чистокровных
сей: сей
таковой: таковой
смочить: смоченной
диета: диету
сумочный: сумочным
неопрятно: неопрятно
грыжа: грыжи
занятие: занятия
похвала: похвала
премоляр: премоляры
большинство: большинстве
вместе: вместе
течение: течение
окрасить: окрашенной
научиться: научиться
покупка: покупка
заменитель: заменителем
изгиб: изгиб
надёжный: надежной
корм: корма
сигнализация: сигнализации
укладываться: укладывающийся
главный: главная
катаракт: катаракта
полгода: полугода
рейтинг: рейтинг
генетический: генетических
красный: красной
проход: проход
ряд: ряд
подписываться: подписывайтесь
привести: приведет
обзор: обзор
означать: означает
товарищ: товарищ
идеальный: идеальная
запретить: запрещено
очень: очень
бело-бисквитный: бело-бисквитная
площадка: площадку
обычно: обычно
пёсик: песиков
канарский: канарских
милашка: милашка
истреблять: истребляли
выщипать: выщипать
перенять: переймет
гламурный: гламурном
ребятня: ребятней
постепенно: постепенно
кличка: клички кличку
довольно: довольно
прежде: прежде
частность: частности
тряпочка: тряпочкой
готовиться: готовьтесь
удивительный: удивительной
возможность: возможность
локоть: локтя
документ: документов
подхватить: подхватить
мясной: мясными
проект: проекте
сразу: сразу
житель: жители
кругленький: кругленькая
обширный: обширной
продолжать: продолжают
наследство: наследству
повадка: повадки
кг: кг
необходимость: необходимости
тресковый: тресковых
кефир: кефир
цокать: цокающая
гонка: гонки
хождение: хождение
развитие: развитием
линька: линька
липучка: липучками
коленный: коленной
волнистый: волнистую
блондинистый: блондинистого
высаживать: высаживайте
важный: важный
наедине: наедине
победить: побеждены
котофей: котофеем
робость: робость
кормление: кормления кормление
необоснованный: необоснованную
подтянутый: подтянут
энергия: энергии
вызывать: вызывает
упитанный: упитанными
затруднять: затрудняет
выпрашивание: выпрашивания
тягость: тягость
заузить: зауженная
хвост: хвост
ккал: ккал
постараться: постарайтесь
губа: губы
собака-долгожитель: собаки-долгожители
доллар: долларов
хвалить: хвалите
встречаться: встречаются
пет-класс: пет-класса
осмотр: осмотр
