америка: америке
туалет: туалет туалету
тримминг: триммингом тримминг тримминге триммингов тримминги
сиверский: сиверского
убойный: убойные
товар: товар
овощ: овощи
состоять: состояли состоит
отдавать: отдавайте
мускулистый: мускулистых
тело: тела
десятилетие: десятилетиями
своевременный: своевременный
кофеварка: кофеварки
таковой: таковые такового
четвероногий: четвероногих
чёрный: черный черные черными
ответственный: ответственные
сколько: сколько
отвар: отваром
догадаться: догадалась
предсказать: предсказать
уходить: уходит
уметь: умеют умеющем
высокий: высока высокая
шоу-собака: шоу-собак
уэльс: уэльса
послушный: послушные
название: название названия
весёлый: веселый
добавка: добавок
домой: домой
собака: собаку собаками собак собака собакам собаке собаки
примерно: примерно
ржаной: ржаные
вельштерьер: вельштерьеру вельштерьеры вельштерьером вельштерьерами вельштерьеров вельштерьер вельштерьера
ограждение: ограждения
крыса: крысами крысы
обсуждение: обсуждения
сушка: сушке сушкой
агрессия: агрессии
противник: противнику
цена: цена
зачастую: зачастую
отмирать: отмирать
сахар: сахара
блеск: блеска
расставаться: расставаться
материал: материалов
природа: природы
имитация: имитации
рыбий: рыбий
питомец: питомце питомцами питомцев питомец питомца
падкий: падки
обратить: обратите
стража: стражей
построить: построили
пылевой: пылевые
тренировка: тренировками тренировках тренировки тренировок
изучить: изучив
шуба: шубу
стоять: стоят
качество: качествами качеств качестве качество качества
сторона: стороны
заинтересовать: заинтересовать
дисквалифицировать: дисквалифицирующие
водоём: водоеме
жидкий: жидкой
семейство: семейства семейство семейств
уэльский: уэльского уэльский уэльские уэльскими уэльских
поголовье: поголовье
холка: холку холке
побегать: побегать
расчёсывание: расчесывании
россия: россия россию россии
спортсмен: спортсмены
карьера: карьеру
спрятаться: спрячется
обратный: обратная
начинать: начинают
скорость: скоростью
предварительно: предварительно
ради: ради
представитель: представителей представителем представителями представители
ограничить: ограничив
метка: меткой
гризли: гризли
игрушка: игрушкой игрушки
шея: шея шее
отмечать: отмечают
положительный: положительные
поползновение: поползновения
собственный: собственная собственный собственном собственными собственные собственной
шерсть: шерсть шерсти
бескровный: бескровными
низкий: низкий низкое
напоминать: напоминая напоминающих
неглубокий: неглубокую
подготовиться: подготовиться
запретить: запрещена запрещены запрещено
тоннель: тоннелям
челюсть: челюсти
должный: должны должен должно
частый: частыми чаще почаще
потомство: потомства
равноценный: равноценной
покупка: покупку покупки покупке
дрессировать: дрессируйте
заменять: заменять
класс: класса
дефицит: дефицитом
нерафинированный: нерафинированным
несбалансированный: несбалансированный
отмереть: отмерший
губа: губами
начать: начнет начали начал
рождаться: рождаются
необходимый: необходимы необходима необходим
иметься: имеется имеются имелись
колтунорез: колтунорезы
сера: серу
великобритания: великобритания
участок: участки участках
ромашковый: ромашковым
дело: дел дело деле
эрдельтерьер: эрдельтерьеров эрдельтерьера
включая: включая
рост: росту рост
отличаться: отличается отличаются
тарелка: тарелки
эффектный: эффектная
важно: важно
промышленный: промышленной промышленным
рубец: рубца
история: история
гипотиреоз: гипотиреоз
месяц: месяцы месяца месяцам месяцев
камера: камеры
щенок: щенка щенков щенки щенок
откликаться: откликаться
завидеть: завидев
растительный: растительным растительной
матерой: матерые
видно: видно
нормально: нормально
уступить: уступив
ёмкость: емкость
произнесение: произнесением
разместить: размещены
ограничитель: ограничителей
требовать: требовать
успешно: успешно
практиковаться: практиковался
прилегать: прилегающие
тренд: трендам
ринг: ринг ринге
туалетный: туалетные
кисломолочный: кисломолочные
воронка: воронки
характеристика: характеристика
поблизости: поблизости
начинающий: начинающим
стоп: стоп
выставка: выставках выставок выставкой
такой: таком таких такое такая
хитрый: хитрый
несколько: несколькими несколько нескольких
помощь: помощью помощи
дом: дому дом дома доме
мешок: мешок
следование: следования
родоначальник: родоначальники
черно-подпалый: черно-подпалые черно-подпалым черно-подпалый черно-подпалого
наткнуться: наткнулись
год: годы годах лет год году
нора: норе нору норами нора норах
война: войны
изыск: изыски
враждебный: враждебный
месячный: месячный
еда: еды
признать: признан
двухмесячный: двухмесячного
сводить: сводив
быстро: быстро
маленький: маленькой маленький поменьше маленькие
руководствоваться: руководствоваться
удаться: удалось удастся
видео: видео
записать: записать
пасовать: пасовать
внимание: внимания внимание
меню: меню
полностью: полностью
улица: улицу улицы улицах улице
требование: требованию требования
находиться: находясь находиться находится
домашний: домашних домашние домашнего
развлечение: развлечениями развлечений развлечением развлечение
фауна: фауны
капуста: капусту
знание: знаний
позаботиться: позаботьтесь
раскапывать: раскапывать
бесконечно: бесконечно
выбор: выбором выбору
суждение: суждений
интернет: интернете
соревноваться: соревноваться
насечка: насечками
содержание: содержание содержания
дать: данная
щипка: щипку щипок щипкой щипка щипках
опытный: опытного опытному
приучать: приучать
постель: постели
нестись: несущиеся
международный: международных
свежий: свежих свежие
жесткошёрстный: жесткошерстных жесткошерстные
приятный: приятное
жить: живет
подзывать: подзывать
пет-категория: пет-категории
метёлочка: метелочкой
окрас: окраса окрас окрасом окрасами
предел: пределы
последующий: последующую
игроман: игроман
вносить: вносит
орган: органов
несложный: несложный
занимать: занимают
кстати: кстати
провоцировать: провоцирующих
вельший: вельшем
пёсик: песику песика
поиск: поиски поиск
появляться: появляться
связь: связь связи
точно: точно
надёжный: надежного
контакт: контакта контакт
оставить: оставил оставивших
кусок: кусок
клуб: клуб
портфолио: портфолио
отделаться: отделаться
соблазнить: соблазнить
система: система систему
издать: изданный
соломенный: соломенных соломенные
единственный: единственный единственное
владелец: владельцев владельцу владельцем
родство: родстве
довольствоваться: довольствующиеся
пока: пока
ориентироваться: ориентироваться
дружелюбие: дружелюбию
уточнить: уточните
смелость: смелостью
состояние: состоянии
доверие: доверием
внешний: внешние внешних
забор: забор
собачий: собачьего собачьей собачьим собачьи
обладать: обладают
ветеринарный: ветеринарные
дважды: дважды
интерес: интереса интерес
продолжить: продолжит
среднестатистический: среднестатистический
расчесать: расчесать
структура: структурой
данный: данного данный
злобность: злобностью злобность
заниматься: заниматься
право: права
поклонник: поклонникам
поактивничать: поактивничав
плотно: плотно
пищалка: пищалку
тримминговать: тримминговать
срываться: срывается
плоский: плоскую
неприятный: неприятную
поле: поле полям
смотреть: см
исполнительность: исполнительности
лёгкий: легкий
фотография: фотографии
океанический: океанических
инструмент: инструмент
невзирая: невзирая
ассоциация: ассоциациями
агрессивный: агрессивная агрессивных
работать: работать работающим работающие
наглядно: наглядно
овчарка: овчарок
провокация: провокацию провокации
нож: ножи
уход: уходе уход
смотреться: смотрятся
страшный: страшного
помнить: помните
результат: результат результате
питомник: питомники питомника питомнику
конструкция: конструкции
анатомический: анатомические
сухофрукты: сухофрукты
выбирать: выбирайте
глаз: глаза глаз глазами
электроошейник: электроошейника
рубеж: рубежа
самый: самый самое самых самые
квашеный: квашеную
отправлять: отправляет
прийтись: придется
питаться: питаются
творить: творить
слабый: слабую
закормить: закормленными
гипнотизировать: гипнотизировать
тщательный: тщательный
часть: части
век: века век веками
буквально: буквально
хитрость: хитрость
обожать: обожает
поскольку: поскольку
прочий: прочие прочих
проявлять: проявляют проявлять
косматый: косматый косматых косматая косматые
уплощённый: уплощенный
краткий: краткая
существо: существо существами
весьма: весьма
невоспитанность: невоспитанности
свой: своими свое своей своему свои
выстроить: выстроенного
рыба: рыб
отношение: отношение отношении
место: место местах места
систематический: систематическом
поясница: поясницей
компания: компанию
зверь: зверю зверя зверем
модный: модным
способ: способов способ
сородич: сородичей
ролик: роликов
весь: весь всем
первый: первом первые первую первых
нетипичный: нетипичными
эксперт: экспертов
расценить: расценит
лис: лисы лису
ранний: раннего
японский: японский
классовый: классовые
факт: факт
отказываться: отказывайтесь
доверить: доверить
ждать: ждут ждите ждет
парижский: парижских
вконтакте: вконтакте
старый: старый старая
чуть-чуть: чуть-чуть
финляндия: финляндии
создать: создать
грумера: грумеру
задиристый: задиристых задиристый
срок: срок
хозяин: хозяин хозяином хозяина
включать: включающие
поинтересоваться: поинтересуйтесь поинтересоваться
приучить: приучите приучить приучены
животное: животных животным животного животные животное
размер: размерах
уяснить: уяснить
округлость: округлости
серьёзный: серьезная серьезных
общий: общий
сша: сша
тренировать: тренируют
земля: земле
вельша: вельша вельш вельши вельшам вельшу
верх: верх
официальный: официальные официальным
волос: волос
длина: длины
тон: тон
охотничий: охотничьих охотничьими охотничьим охотничья
выбрать: выбрать
экспонирование: экспонирование
неутолимый: неутолимой
наводить: наводить
специализация: специализациях
быть: суть будь
считать: считанные
беззлобно: беззлобно
основать: основана
шёрстный: шерстного
хотя: хотя
подкоп: подкоп
х: х
кожа: кожу кожа кожи
мячик: мячиком
бег: бегу бега
сногсшибательный: сногсшибательный
везде: везде
который: которую которыми котором которая которых которым которые который
форма: форму формы
пасть: пасть
разбегаться: разбегаются
свободно: свободно
середина: середины
хорошенько: хорошенько
полость: полостью полость
разрушение: разрушениям
уверять: уверяя
квартира: квартире квартиры
измотать: измотать
мера: меру мере
мыслить: мыслит
выпуклость: выпуклости
информация: информация
вельшея: вельшей
охотник: охотник охотники
рабочий: рабочими рабочих
друг: друг другом
барнхант: барнхант
жир: жир
будущее: будущем
обнажать: обнажает
ниже: ниже
кошка: кошкой кошки
шустрик: шустрика
уговор: уговоры
импортирование: импортированием
крепкий: крепкие
копия: копии
сухой: сухой
протереть: протереть
хотеться: хотелось хочется
габарит: габариты габаритов
кончик: кончик
среди: среди
талант: таланты
любой: любое любой
крупа: крупы круп
выправка: выправка
это: этим это
колено: колени
новый: новых новой новый
длинный: длинные длинная
считаться: считается
ость: ости ость
собаковод: собаководов
развитой: развитыми развиты
пребывание: пребывания
пол: полу
подвижный: подвижных подвижного
чудо: чудеса
полный: полной
противопоказание: противопоказаний
затылочный: затылочного
иметь: имейте имеет иметь имеют
просто: просто
экспрессивный: экспрессивный
ничто: ничем
слизистая: слизистую
человек: людей человека человек человеком
выйти: выйти
образный: образной
подрощённый: подрощенным
водить: водить
вид: видом виду виде
звонкоголосый: звонкоголосых
подчеркнуть: подчеркнуто
пёс: псов пес пса
неглупый: неглупое
уделяться: уделяться
смыкаться: смыкаются
учитывать: учитывая
гулять: гуляя
выбраться: выбраться
разобрать: разобрав
вывих: вывих
начинаться: начинаются
добавить: добавьте
прогулка: прогулки прогулках
аксель: акселя
дог-шоу: дог-шоу
происхождение: происхождения
вязкость: вязкости
необходимо: необходимо
вызвать: вызвали вызвать
готовый: готовы
исторически: исторически
заставить: заставив
пожалуй: пожалуй
выдрать: выдрать
терьер: терьер терьера терьеры терьерами терьерам терьеров
отлучаться: отлучаясь
задний: задние
пр: пр
распространить: распространена распространены
редкий: реже
терпеть: терпеть терпят
лакомство: лакомство лакомств
дрессировка: дрессировка
предлагать: предлагает
время: время временем
мочка: мочкой мочка
трусливый: трусливых
агрессивность: агрессивность
устроить: устроить
ушной: ушной
добавляться: добавляются
день: дней дня дни
наказание: наказания
схожий: схожие
англ: англ
пясть: пясти
другой: другие других другими другая
взрослый: взрослого взрослых
слабость: слабостям
уступать: уступает уступающими
знакомство: знакомстве
слух: слуха
яростно: яростно
пожевать: пожевать
столкнуться: столкнулись
отдельный: отдельные отдельных
например: например
ботинок: ботинки
жаждать: жаждет
газета: газеты
прививка: прививки
подобный: подобными подобные подобных
сила: силы
крысолов: крысоловов
удобный: удобнее
мирамистина: мирамистине
надеяться: надейтесь
умеренный: умеренное умеренной
видение: видение
резко: резко
к: ко
староанглийский: староанглийского староанглийский
реклама: реклама
жизнедеятельность: жизнедеятельности
щипать: щиплют
уроженец: уроженцев
йоркшир: йоркшира
просить: просят
предложение: предложения
звук: звук
продавец: продавец продавца
катакомба: катакомб
живучий: живучим
процедура: процедуру процедура
страничка: странички
рекомендоваться: рекомендуется
грядка: грядок
спокойно: спокойно
получиться: получится
хомяк: хомяки
грубый: грубыми грубейшая грубой
характерный: характерны
воспитание: воспитание воспитании
разбросать: разбросанные
здоровый: здорового
малыш: малыш малыша
наследственный: наследственных
правильно: правильно
жаловать: жалуют
оба: обоих
стать: стало стать станет
сайт: сайту
купать: купайте
бывать: бывает
родословная: родословной
похвала: похвалу
переноситься: переносятся
полезно: полезно
любознательный: любознательных
водород: водорода
средний: средних средними
паста: пастой пасты
недуг: недугов
герой: герои
долго: долго
поймать: поймать
навредить: навредить
называть: называемый
компактный: компактная компактные
выводить: выводить выводите
тесный: тесном тесного
форум: форум форуме
упорный: упорного
принуждать: принуждают
спорт: спорта
предпочтение: предпочтение
бежать: бегущей
белка: белки
просиживать: просиживать
дружелюбный: дружелюбные дружелюбная
игровой: игровую
минеральный: минеральным
любитель: любитель
три-четыре: три-четыре трем-четырем
скоро: скоро
дешёвый: дешевые
мясо: мяса
прямолинейный: прямолинейных
комочек: комочки
грейхаунд: грейхаунд
многообещающий: многообещающей
ровный: ровные
явный: явной
гореть: горят
задействовать: задействуют
речной: речных
описание: описание
чувство: чувств
породный: породных
убирать: убирать убирают
начало: начало
посадить: посаженные
равномерный: равномерный
лопатка: лопатки
лоск: лоск
бассейн: бассейн
белый: белых белой
найти: найти
однако: однако
купировать: купировали купирован
похожий: похожим
схема: схемами
искусственный: искусственный
германия: германии
становиться: становится
хлопотный: хлопотно
магазин: магазина
устраивать: устраивать
свободный: свободный
поэтому: поэтому
случай: случаев случаях
копирование: копирование
нужда: нужду
привыкать: привыкать
короткий: короткий короткая
активность: активность
аккуратный: аккуратная
ти: ти
дружелюбность: дружелюбность
попасть: попали
плавно: плавно
спортивный: спортивных
отзыв: отзывах отзывы
переходить: переходить переходит
нога: ноги ногу
ротовой: ротовую ротовой
крупный: крупных крупные
заключаться: заключается
настоящий: настоящая
чистокровный: чистокровного
следовать: следует следуйте следовать
очаровательный: очаровательный
перемещение: перемещения
животный: животному животный
шум: шум
натуральный: натуральными
длинныйскошенный: длинныйскошенный
преклонный: преклонного
поделиться: поделиться
особь: особи особям особей
столбик: столбики
рамка: рамки
допустимый: допустимо
худой: худыми
сварить: сваренные
похлёбка: похлебки
миска: миске
аксессуар: аксессуар
назад: назад
планировать: планируете
бросаться: бросаются
отставать: отстающий
шалопай: шалопай
поначалу: поначалу
цвет: цвет
сеть: сети
отвести: отведенные отведенной
мочь: могут можете
локоть: локти
игра: играх игры
славиться: славящихся
ламинария: ламинария
возраст: возрастом возраста возрасте
порода: породы пород порода породой
сконцентрироваться: сконцентрироваться
уединённый: уединенных
полно: полно
получить: получена получили
профессиональный: профессионального
бридер: бридерами
объявление: объявления
мелочь: мелочи
будущий: будущая
нахально: нахально
вступить: вступить
сделать: сделать сделано
частное: частного
основной: основные
пенсия: пенсию
интеллект: интеллект
охранный: охранные
скрещивать: скрещивали
квест: квесты
жаркое: жаркие
проявление: проявления
средне: средне
вес: вес
конец: конец
команда: командой командам команды командах команда
справить: справит
половник: половником
швеция: швеции
попытаться: попытается
выгуливать: выгуливайте
широкий: широкая
успевать: успевать успевает
ежедневно: ежедневно
сон: сна
по-настоящему: по-настоящему
научиться: научился
родственник: родственники
голова: голову голова
именно: именно
чрезвычайно: чрезвычайно
подобие: подобии
отклонение: отклонения
злоупотреблять: злоупотреблять
палец: пальцах
сутки: сутками
продолжительность: продолжительность
учение: учении
подопечный: подопечный подопечных
нормальный: нормальной
фермер: фермеры
отлично: отлично
шалость: шалостям
потенциал: потенциалом
усердствовать: усердствовать
положение: положении
разгуливать: разгуливали
кинологический: кинологическими
линия: линий
утро: утрам
колпак: колпаком
доминирование: доминированию
оценка: оценка оценке
учиться: учиться
лужа: лужу
походный: походных
слегка: слегка
амуниция: амуниции
солдат: солдаты
фото: фото
отвлечься: отвлекшегося
окультурить: окультурить
отвертеться: отвертеться
русачий: русачьи
активный: активных
сам: самого самом
сустав: суставами суставов
яндекс: яндекс
прилежание: прилежания
мордашка: мордашка
количество: количество
вдогонку: вдогонку
грызун: грызунов
петлять: петляя
стандартный: стандартной
гармонично: гармонично
ножницы: ножницы
выглядеть: выглядеть
уменьшить: уменьшенные
пытаться: пытаться
терьерный: терьерной
успех: успехов успех успехи
череп: череп
реактивный: реактивной
одёжка: одежка
дикий: диким
шейный: шейные
лапа: лапы
хороший: лучшее хорошей
относить: относят
искусно: искусно
двор: дворе
грумерский: грумерский грумерскими
решить: решит решить
журнал: журнал
голышом: голышом
высота: высота
ответственно: ответственно
советский: советскими
глаукома: глаукома
непримечательный: непримечательных непримечательные
действие: действий действием действие действию
клетчатка: клетчаткой
делать: делать делает
морковь: морковь
отстоять: отстоять
минута: минуты
обработать: обработать обработанные
тот: та тому
клумба: клумб
тождественно: тождественно
предпочитать: предпочитая предпочитают
завидный: завидный
ширина: ширины
обычный: обычной обычная обычные
покров: покров покрова
тапка: тапок
болезнь: болезни
ребёнок: дети детей детьми
кормить: кормят кормить
ухо: ушами уши
приусадебный: приусадебных
совершенно: совершенно
чрезмерно: чрезмерно
либо: либо
зона: зоны
пятно: пятен
нападать: нападает
облечь: облечь
возникнуть: возникнуть
удлинённый: удлиненных
какой: какие
охота: охоте охота охоту
взгляд: взглядом
квалификация: квалификации
простой: проще
обстоять: обстоит
вода: водой
внимательно: внимательно
страна: страну страна
обезопасить: обезопасить
победа: победе
очередной: очередного
чувствительный: чувствительной
устанавливаться: устанавливаются
поддаваться: поддавайтесь
навстречу: навстречу
корпус: корпуса корпусу корпус
миниатюрный: миниатюрную
раскусить: раскусил
диплом: дипломы
истинный: истинного
условие: условиях
заметно: заметно
разнообразие: разнообразие
бриар: бриар
аттракцион: аттракциона
запустить: запущенный
проволокообразный: проволокообразной
взросление: взросления
встряхнуть: встряхнуть
хвост: хвосты хвост
летний: летние
труд: труда
плюшевый: плюшевую
немой: нем
курс: курсе
родиться: род
консервант: консервантов
броситься: броситься
являться: являются является
перейти: перейти
счастие: счастью
скрещивание: скрещивания
разумный: разумнее
разный: разные
из-за: из-за
главное: главное
регулярно: регулярно
оживлённый: оживленные оживленных
лисий: лисьи
вооружаться: вооружаться
эрделить: эрделя
начищать: начищающие
фукус: фукус
прижать: прижать
рынок: рынке
шлёпать: шлепайте
скакательный: скакательными скакательных
менее: менее
скулить: скулить
сигнал: сигнал
выставочный: выставочным выставочную
иностранный: иностранных
ген: генов
картина: картина
терять: теряет
грудь: груди грудь
прогулочный: прогулочной
вольер: вольеры
корень: корнями
подстерегать: подстерегая
утренний: утренняя
ткань: тканью
невероятно: невероятно
думать: думайте
европа: европе
одиночество: одиночеству
слишком: слишком
содержать: содержа содержат
провокатор: провокатор
родословный: родословная
запрет: запрет запретов
стандарт: стандарта стандарт
лабиринт: лабиринты лабиринта
прямоугольный: прямоугольная
работа: работа
морда: морда
гигиена: гигиена
внешность: внешностью внешности
комплекс: комплексам
бдительность: бдительность
участник: участников
желание: желанием
некрупный: некрупные
придерживаться: придерживаться
ваш: ваш вашем
замена: заменой
спровоцировать: спровоцировать
пора: пора
рубль: рублей
поступать: поступает
растрепать: растрепанная
гречневый: гречневую
очертить: очерченные
круг: кругу
сложный: сложнее сложным
подстилка: подстилки
глубина: глубиной
успеть: успеет
правило: правило правила
незначительный: незначительную
линейность: линейность
зубной: зубной
разумеется: разумеется
каждый: каждый
достигнуть: достигших
глубокий: глубокая
забавный: забавных
зарядить: заряжены
племенной: племенных племенным
доставить: доставили
происходить: происходило
наполнить: наполнив
позволять: позволяющие
знак: знаков
стоимость: стоимость
перевозить: перевозить
подойти: подойдут
приобрести: приобрести
экстерьерный: экстерьерном
иначе: иначе
особенно: особенно
отметина: отметины
обучать: обучаем
жёсткий: жесткая жесткие
строго: строго
метеор: метеор
последний: последние
час: часов
возле: возле
обиженно: обиженно
предельно: предельно
бытовой: бытовой
крупногабаритный: крупногабаритных
повышенный: повышенное
современный: современный современных
субпродукт: субпродуктов
распространяться: распространяется
типичный: типичных
обязать: обязан
краситель: красителей
клетка: клетке клетки
пара: пару
мебель: мебели
висок: вискам
неделя: неделю
возвращение: возвращении
получение: получению
присутствие: присутствии
реагировать: реагируют
поводок: поводке поводка
точнее: точнее
понимать: понимать
мечтать: мечтаете
ходить: ходить
первопроходец: первопроходцы
купить: купить купите
плотный: плотный
часто: часто
предок: предок
опустить: опущенными
подпал: подпалом
ухаживать: ухаживать
прямой: прямые
мелкий: мелкими
сбрасывать: сбрасывает
традиционный: традиционное
объединять: объединяющие
масло: маслом
заболевание: заболеваний
невероятный: невероятное
промывать: промывать
вертикально: вертикально
сообразить: сообразит
спина: спина
путь: пути
разветвить: разветвленная
дальний: дальний
что: чему
разводить: разводили разводить
дотянуть: дотянул
великий: величайший великой
подготовка: подготовкой
степень: степень
миссия: миссию
почитатель: почитателей
утаить: утаить
зенненхунд: зенненхунд
ссср: ссср
недостаток: недостаткам
галоп: галоп
сохранять: сохраняют
этот: этих
рассчитывать: рассчитывать
крыться: кроется
потребность: потребности потребность
постный: постного
четырехлапый: четырехлапый
живой: живой
следующий: следующий
проблема: проблему проблема
оказаться: оказалось
рыжий: рыжую
чаемый: чаем
подшёрсток: подшерстка
нежелательно: нежелательно
чистый: чистой
мимикрировать: мимикрировать
бугор: бугра
желательный: желателен
выстрел: выстрел
племя: племени
педигря: педигри
отечественный: отечественное отечественной
вспомогательный: вспомогательные
болезненный: болезненный
неправильно: неправильно
одноклассник: одноклассники
энергичный: энергичный
попутно: попутно
переживание: переживаниями
классический: классическую
изящный: изящный
депигментировать: депигментированными
доза: дозы
заточить: заточен
хозяйский: хозяйские
подходить: подходить подходите
против: против
выгнать: выгнать
определённый: определенных
случайный: случайные
сильный: сильной сильные
чётко: четко
кроме: кроме
взять: взять
шоу-особь: шоу-особей
вкусняшка: вкусняшкой
эпилепсия: эпилепсию
последовательность: последовательности
пресечь: пресечь
сегодня: сегодня
щенячий: щенячьем
слышный: слышно
звезда: звезда
идеальный: идеальный
зуб: зубы
вообще: вообще
парка: парку
конкурент: конкурент
выполнить: выполнили
тусклый: тусклой
характер: характер
отлов: отлове
подать: поданной
барсучий: барсучьими
существование: существовании
некоторый: некоторые
себя: собой
глухота: глухоту
отверстие: отверстие
термически: термически
фокстерьер: фокстерьеров
помета: помета
выдра: выдр
одёрнуть: одернуть
салфетка: салфеткой
хина: хин
вдоль: вдоль
миндалевидный: миндалевидные
поощряться: поощряется
реалия: реалиях
зрение: зрения
щётка: щеткой щетки
дисплазия: дисплазии
тыква: тыква
молниеносный: молниеносного молниеносный
нос: нос
терьеристый: терьеристых
колтун: колтуны
порок: пороки
помешанный: помешанный
упитанность: упитанности
элегантный: элегантные
короткошёрстный: короткошерстного
своенравие: своенравию
жизнь: жизни
абсолютно: абсолютно
выход: выхода
смешанный: смешанный
сильно: сильно
европейский: европейскими
благодаря: благодаря
бурно: бурно
груминг: груминг
двигаться: двигаться движутся движется
угаснуть: угас
запрыгнуть: запрыгнет
рука: рукой
плечо: плечи
пространство: пространства
группа: группы
азартный: азартный
российский: российских
твёрдость: твердости
отвага: отвагой
прибрюшистость: прибрюшистость
повязать: повязанные
энерджайзер: энерджайзер
шоу: шоу
нужно: нужно
мимимишность: мимимишности
принять: принять
также: также
экстерьер: экстерьера
укромный: укромном
процесс: процесс
умный: умная
обои: обоев
текстиль: текстиль
приличный: приличной
момент: моменты момент
манера: манере
белок: белок
возможно: возможно
желать: желающая
мощный: мощные
ножка: ножки
зов: зов
энтлебухер: энтлебухер
бульон: бульоне
свирепость: свирепостью
витаминный: витаминных
атопический: атопические
отмечаться: отмечающиеся
подыскивать: подыскиваете
заняться: заняться
глай-эрик: глая-эрика
говорить: говоря
выудить: выудили
изначально: изначально
высоко: высоко
выявить: выявлено
впоследствии: впоследствии
вестись: вестись
поваляться: поваляться
служебный: служебным
прошлое: прошлым
ошейник: ошейника
книга: книгах
присущий: присущей
сложно: сложно
заправить: заправленные
крайне: крайне
стоить: стоит
массивный: массивные
отличный: отличным отличные
ворчать: ворчать
филе: филе
правильный: правильных правильной
показатель: показатели
переубедить: переубедить
смахивать: смахивающие
прыгучий: прыгуч
подземный: подземным
кусочек: кусочек
захватывать: захватывать
амбарный: амбарная
любить: любят
нуждаться: нуждается
способный: способен способны
пнуть: пнете
разыграть: разыграет
своевременно: своевременно
провиниться: провинилось
стол: стола
пыль: пыль
положить: положивший
прочь: прочь
страсть: страстью
каша: каши
клан: клана
потомок: потомкам потомки
легко: легко
ежеминутно: ежеминутно
вымах: вымах
линять: линять
лента: ленту
производитель: производителей производители
выгул: выгула
отпочковаться: отпочковалось
здоровье: здоровье
подвернуться: подвернувшуюся
воспитать: воспитать
порция: порции
дефект: дефектом дефекты
вводиться: вводятся
исключение: исключением
крипторхизм: крипторхизмом
английский: английского
освежиться: освежиться
салат: салаты
что-либо: что-либо
нужный: нужного
обновиться: обновился
якобы: якобы
вакансия: вакансии
прямо: прямо
лоно: лоне
юдита-йожо: юдиты-йожо
ошибка: ошибка
специалист: специалисты
ринговой: ринговой
продукт: продукты
экстраверт: экстраверт
прикус: прикус
приходиться: приходится
массивно: массивно
шалун: шалунов
жизнерадостный: жизнерадостные
уснуть: уснувший
встречаться: встречается встречаются
план: плане
вроде: вроде
глори-мерси: глори-мерси
бедро: бедер
дальнейший: дальнейшем
рысь: рысь
выше: выше
смочить: смоченной
иллюстрировать: иллюстрируют
пищеварение: пищеварением
разрешительный: разрешительное
управлять: управлять
большинство: большинстве
случаться: случается
плавный: плавный
чересчур: чересчур
кошачий: кошачью
столетие: столетия
потратить: потратить
удовлетворять: удовлетворять
вырастать: вырастает
изгиб: изгиб
зарегистрировать: зарегистрированные
главный: главная
рейтинг: рейтинг
цель: целей
мышца: мышцы
подписываться: подписывайтесь
пениться: пенятся
погоня: погоня
переносить: переносить
самостоятельно: самостоятельно
передаваться: передается
товарищ: товарищ
использовать: использовать
экстрасенс: экстрасенс
затягиваться: затягивается
сухарик: сухарики
хлоргексидин: хлоргексидине
очень: очень
заводчик: заводчики
закрепить: закрепить
семья: семей
обычно: обычно
ладить: ладит
плутовка: плутовку
эмигрант: эмигранты
норный: норных норную
огородить: огороженном
узнать: узнайте
наоборот: наоборот
движение: движений
кличка: клички
частность: частности
отыскать: отыскать
отпускать: отпускать
готовиться: готовьтесь
чистопородный: чистопородный
пробежка: пробежка
завтра: завтра
окрасить: окрашена
стимул: стимулы
разборка: разборки
блюдо: блюдами
перекись: перекиси
удалить: удалить
обеспечивать: обеспечивающими
прочёсывать: прочесывайте
пускаться: пускаются
соображать: соображают
проект: проекте
сразу: сразу
число: числе
комнатный: комнатные
наследство: наследству
нетерпение: нетерпением
снизить: снижена
кг: кг
насколько: насколько
шоу-питомец: шоу-питомцы
юный: юных
условный: условная
сидеть: сидеть
среднее: среднего
минимальный: минимальная
хрусталик: хрусталика
мукракер: мукракеры
линька: линька
идти: идти
ответ: ответ
рацион: рацион
рисовый: рисовую
рот: рот
фокса: фокса
низко: низко
темперамент: темперамент
подвижность: подвижность
уголок: уголке
ход: ход
профи: профи
прожить: прожили
ругать: ругайте
прокачка: прокачке
улучшить: улучшило
меняться: меняется
непросто: непросто
кормление: кормления кормление
причём: причем
проточина: проточиной
развить: развитая
ситуация: ситуации
холодный: холодным
полноценно: полноценно
дружба: дружба
родитель: родителей
ареал: ареал
щеголять: щеголять
суперпремиум-класс: суперпремиум-класса
вздумать: вздумала
выщипывать: выщипывают
конечность: конечности
обзаводиться: обзаводясь
натуралка: натуралкой
волкодав: волкодавов
слой: слой
знающий: знающий
рысью: рысью
сообщить: сообщить
тип: типы
чепрачный: чепрачного
скромный: скромные
особый: особый
соплеменник: соплеменников
проворный: проворным
темпераментный: темпераментный
тюк: тюков
пет-класс: пет-класса
осмотр: осмотр
