движение: движениями движении движению
туалет: туалет
кангала: кангалам кангал кангалу кангалы кангала
существование: существование
рабочий: рабочее рабочая рабочим рабочих рабочие рабочей
гарантия: гарантия
отличать: отличают
тело: тела тело
средний: средняя средних средней средними
уложить: уложен
скот: скота скот
невысокий: невысоким
необходимость: необходимость необходимости
агрессия: агрессия агрессию
следить: следить
ответственный: ответственные
сколько: сколько
отвар: отваром
ранний: ранней
название: название названия
взбираться: взбираясь
собака: собаку собак собака собаке собаки
примерно: примерно
отлучить: отлученные
вывести: вывести выведена выведены
вывоз: вывоз
переезд: переезда
палевый: палевого
заранее: заранее
склонность: склонности склонностью склонность
обсуждение: обсуждения
сушка: сушке сушка сушку
купаться: купаются
миска: миску
ретироваться: ретироваться
цена: цена
узбекистан: узбекистана
размышление: размышлению
расставаться: расставаться
подушечка: подушечки
материал: материалов
подшёрсток: подшерстком подшерстка
выслеживать: выслеживать
пастуший: пастушьих
собственный: собственных
нюанс: нюансы
дисквалифицировать: дисквалифицирующие
знакомый: знакомыми
больший: большим наибольшее
активизироваться: активизируется
волков: волков
субпродукт: субпродукты субпродуктов
крадущийся: крадущимися
россия: россия россии
подробный: подробные
обладатель: обладателям
морда: морде морда
национальный: национального
карьера: карьеру
обратный: обратная обратные
компактный: компактный
отчётливо: отчетливо
получаться: получается
длительный: длительные
радужка: радужки
волчий: волчьего
представитель: представителей представители
показатель: показателем
искать: искать ищите
контроль: контролем
охранник: охранник
довод: довод
шея: шея шею шеи
волос: волосом
овчарка: овчарки овчарок овчарками овчарка
особенность: особенностью
фокстерьер: фокстерьер
шерсть: шерсть шерсти
тверь: тверь
низкий: низкий низкая
документ: документы
приобщить: приобщили
кальций: кальция
тугой: тугое
один: одним одна одну
челюсть: челюсти челюстей
взрывной: взрывной
должный: должны должна
тип: тип типов типом типа
предупреждение: предупреждения
переедание: перееданию
врождённый: врожденным врожденная
возникнуть: возникнет
вздуматься: вздумается
чёрный: черные черная
большой: большой
переноситься: переносится
сх: сх
сера: серу
общий: общим общий
некоторый: некоторых некоторые
дело: дел
включая: включая
нога: ног ноги
логичный: логичное
важно: важно
упругий: упругие
главный: главный главная
стабильный: стабильной
моментально: моментально
встретить: встретить
история: история
свирепость: свирепость
брать: брать берите
турция: турция турции
щенок: щенка щенков щенки щенок щенками
тревога: тревога
обл: обл
анатолиец: анатолиец анатолийцем
нормально: нормально
выгул: выгул
голень: голень
новый: новые новый
заворот: заворота
питомец: питомцев питомцу питомец питомца питомцем
форма: форма
чувствовать: чувствуют
обучение: обучении
семья: семьи
живот: животы
воронка: воронки
характеристика: характеристика характеристики
грубый: грубого грубое
выставка: выставках выставкам
выставочный: выставочные выставочную
поздний: позднее
физически: физически
включить: включить
аборигенный: аборигенные
коричневый: коричневая
пахнуть: пахнет
часок: часок
повод: поводу повода повод
вид: виды видом вид
конура: конуре
еда: еды
коготь: когти
ежегодный: ежегодные
порода: породе породы пород породу порода
общаться: общаться
маска: маска маску маской маски
считать: считает считают считать
быстро: быстро
сужаться: сужается
тупиковый: тупиковый
вырасти: вырасти
вест-хайленд-уайт-терьер: вест-хайленд-уайт-терьер
раз: раза
видео: видео
обязать: обязаны
усиливаться: усиливающейся
молчаливый: молчаливых
базироваться: базируется
меню: меню
вода: воды воду
полностью: полностью
лидерство: лидерству
расти: росли растут растущих
консультация: консультациях
быть: будьте
улица: улицу улице
домашний: домашних
проживать: проживающей
каждый: каждой
отражать: отражающим
площадь: площадь
идти: идущей идет
такой: таких такое такие такую таким
шуба: шубе шуба
мирный: мирными
продажа: продажей продаже
рацион: рациона рационе рацион
называть: называют
речь: речь
содержание: содержание содержанием содержания
дать: данная данной дайте
нужный: нужны
немного: немного
носить: носят
чужак: чужак
голод: голода
попытка: попытки
вертикальный: вертикальном
мощный: мощный мощное мощнейший мощная мощных
типичный: типичны типичной
составлять: составляет
рекомендовать: рекомендуют
жить: живет
холка: холки холке
защита: защиты
массивный: массивный массивные
путь: путь
оставаться: остаются
окрас: окраса окрас окрасов
намерение: намерения
пигмент: пигмента
кстати: кстати
территория: территорию территорий
связь: связь
неожиданный: неожиданными
высаживать: высаживает
нормальный: нормальными
бояться: боятся бояться
точно: точно
вызвать: вызванные
казахстан: казахстана
набитый: набитым
владелец: владельцев
длина: длине длины длина
разный: разными
бедро: бедра бедер
пока: пока
выложиться: выложиться
состояние: состоянии состоянию состояние
завиток: завитком
хищник: хищника хищником хищников хищниками
обладать: обладают
подкормка: подкормками
возбудить: возбужденного
вольер: вольерах
протирать: протирать
сильный: сильных сильная сильной сильные
завезти: завезли
неправильный: неправильному
спокойный: спокойный спокойной
ночь: ночам
анализ: анализа
московский: московская
злобность: злобностью
плотно: плотно
район: районах районе
хвост: хвостов хвосты хвоста хвост
разобраться: разберется
качество: качестве качество качествам качества
срываться: срывается
шарик: шарику
крупный: крупный крупных крупного крупные
смотреть: см смотрите смотреть
несокрушимый: несокрушимое
фотография: фотографии
уход: уходе уход
столько: столько
помнить: помните
высокий: высокая высокую высокие высокий
питомник: питомники питомниках питомников питомнике
перемещаться: перемещается
глаз: глаза глаз
самый: самый самым самое самых
специальность: специальности
рогатый: рогатый
прийтись: придется
позиция: позицию
корм: корм корма
масть: масть
смешанный: смешанного смешанное смешанный
неприхотливый: неприхотливы
толстой: толстая толстого
отменно: отменно
быт: быту
светло-желто-коричневой: светло-желто-коричневого
сказать: сказать
древний: древнейших
капризуля: капризуля
существовать: существуют
покровный: покровным
купировать: купированными купируют
остальной: остальными остальных
поскольку: поскольку
степенно: степенно
увеличение: увеличения
краткий: краткая
уязвимый: уязвимых
турецкий: турецкая турецким
отношение: отношение отношении отношению отношения
место: место местах месте места
поясница: поясницей
полный: полную
кангальский: кангальская кангальские кангальских кангальский
ветвь: ветви
исключительно: исключительно
тёмный: темной темные темного
сородич: сородичей сородичами
превосходство: превосходство
эксперт: экспертов
навязывать: навязывайте
разделить: разделите
босс: боссом
взмах: взмах
факт: факт
остыть: остывшей
доверить: доверить
высота: высоте высота
вконтакте: вконтакте
отказаться: откажется
тысяча: тысячи
совершать: совершать
человек: людьми человека человек человеком
лёгкий: легче
создать: создать
тазобедренный: тазобедренных
разведение: разведением
ярко: ярко
овечий: овечьих овечьи
роль: роль
просьба: просьбы
отличительный: отличительная
рекордный: рекордным рекордную
развитие: развитие развития
накладывать: накладывать
ценник: ценник
транспорт: транспорта
животное: животных животным животного животными животные животное
занимать: занимает
достояние: достояния
клык: клыкам
земля: земле
соприкасаться: соприкасается
производитель: производителях
освоиться: освоиться
шпиц: шпиц
конституция: конституции
выбрать: выбрать
облик: облик обликом
докучать: докучать
организм: организму организм
счёт: счет счетов
обводка: обводка
основать: основана
хотя: хотя
спускаться: спускающиеся
смыкаться: смыкающихся
серьёзный: серьезные серьезный серьезному серьезными
обманчивый: обманчиво
предпочтительный: предпочтительнее
унаследовать: унаследуют
качественный: качественный
соплеменник: соплеменника
хлопчатобумажный: хлопчатобумажной
двойной: двойная
старый: старейших
размер: размеры размер
непропорционально: непропорционально
информация: информация информации
местный: местными
телосложение: телосложение
оттенок: оттенков оттенки
приблизить: приближенное приближенная
максимально: максимально
натуральный: натуральный натуральной натуральное
физический: физического
палец: пальцами
делиться: делится
малый: малую малой
отвыкание: отвыкания
ребро: ребра
ниже: ниже
родитель: родители родителей
обитатель: обитателей
крепкий: крепкие крепкий крепкими крепкой
сухой: сухой сухие
дикий: диких
кончик: кончик
среди: среди
дом: дом дома доме
лапа: лапах лапы
категорически: категорически
линия: линию линия линий
голос: голосами голос
веко: веки
колено: колени
гасить: гасить
посмотреть: посмотреть
кангалов: кангалов
считаться: считается считаются
длинный: длинные
нянька: няньками
взаимоотношение: взаимоотношений
чуткий: чуткие
тряпочка: тряпочку
пол: полу
квартирный: квартирное
анатолийский: анатолийские анатолийской анатолийских анатолийскими анатолийская анатолийском
рука: руки
сайт: сайтах сайту
проходиться: проходиться
возрастать: возрастает
образовать: образующие образованная
миндалевидный: миндалевидной
доверие: доверия
наличие: наличия наличие
час: часа
последовательный: последовательной
утяжелитель: утяжелителями
угол: углах углами углы
развивать: развивать развивая
добавить: добавьте
чистка: чистка
животный: животном животному
прогулка: прогулки
предрасположенность: предрасположенность
осветлить: осветленного
умеренный: умеренная
происхождение: происхождения
задуматься: задуматься
необходимо: необходимо
уверенный: уверенные уверенных
готовый: готовы готовым
пройти: пройдите прошел
задний: задние
кобель: кобеля кобели кобелей
тщательно: тщательно
хороший: хорошему хорошая лучшими
запретить: запрещен запрещено
гладкий: гладкая
терпеть: терпеть
дрессировка: дрессировка дрессировке дрессировки
стандартный: стандартный
время: время времена времен времени
сука: суки сук
мочка: мочкой мочка
агрессивность: агрессивность агрессивности
варьироваться: варьироваться
возвышенность: возвышенности
суровый: суровый
деятельность: деятельности
пясть: пясти
кость: костей
другой: другие других другими
прижиматься: прижимающимися
приближение: приближении
мера: мере
толстый: толстые
комфортно: комфортно
кисломолочко: кисломолочке
например: например
несколько: несколько
охрана: охраны
враг: враг
проверять: проверяйте
рост: рост
голова: головы голова
тупой: тупой
газета: газеты
приспособить: приспособленных
схватка: схватку схватки
вне: вне
убедиться: убедится
функция: функции функцию
интервал: интервалом
кмч: кмч
расслабить: расслабит расслабленное
реклама: реклама
наклон: наклоном
получить: получите получить получили
шакал: шакалов
полотно: полотна
заправляться: заправляться
понять: поймет
биохимия: биохимию
слабовыраженный: слабовыраженного
полагаться: полагается
окд: окд
породный: породными породных
выразить: выражена
рекомендоваться: рекомендуется
обильный: обильным обильный
воспитание: воспитание
смочить: смочить
год: лет
атаковать: атаковать
здоровый: здорового
тюркский: тюркские
правильно: правильно
шоу-потенциал: шоу-потенциал
покатый: покатая
который: которыми которого которая которых которые которому
располагаться: располагается
черепной: черепной
гость: гость
появление: появлении
позволять: позволяет
полезно: полезно
водород: водорода
социализация: социализация социализации
дорогой: дорогое
вавилонский: вавилонского
чайный: чайной
этот: эта этих
сбрасывать: сбрасывать
морозов: морозов
что-то: что-то
карабаш: карабаш карабашей карабашами карабашом карабаша
подвести: подведет
форум: форум форуме
азия: азию азии
стоп: стопом стопа
вверить: вверенную
макроэлемент: макроэлемента макроэлементы
уникальность: уникальность
положение: положение положении
переборщить: переборщить
характерный: характерную характерное
мясо: мяса мясо мясе
резиновый: резиновую
племя: племена
описание: описание
небольшой: небольшом
начало: начало
вероятность: вероятности
витамин: витаминами
развитой: развит
лопатка: лопатки
свернуть: свернут
владение: владения
гречневый: гречневая
собачий: собачьих
оказаться: оказалась
однако: однако
первоклассный: первоклассным
поэтому: поэтому
угрожать: угрожающее
нежирный: нежирной
глубина: глубина
копирование: копирование
далёкий: подальше
передний: передний передние передних
активность: активность активности
грелочка: грелочку
пуходерк: пуходерку
дружелюбность: дружелюбность
равный: равна
совершение: совершения
доступ: доступ
гудение: гудением
острый: острого
плавно: плавно
подвижный: подвижные подвижнее
отзыв: отзывах отзывы
поинтересоваться: поинтересоваться
кошка: кошки кошек
годовалый: годовалого
выделение: выделения
окружение: окружению
лежанка: лежанки
шум: шум
широкий: широкий
висячий: висячие
особь: особи особям особей
соотносить: соотносить
внушительный: внушительных внушительная
баланс: баланс
мать: матери
планировать: планируете
сеть: сети
ставить: ставьте
мочь: могут можете
задача: задачи
потеря: потерю потери
лакомка: лакомка
угнетение: угнетения
выпуклый: выпуклыми выпуклой
видеть: видеть
ухо: ушей уха ушами уши
таджикистан: таджикистана
целое: целом
объявление: объявления
основной: основные
полова: половой
вывешиваться: вывешиваются
охранный: охранные охранной
интеллект: интеллект
покупать: покупайте
многие: многие
конечность: конечностей конечности
сдавать: сдают
вес: вес
уважение: уважение
спина: спину спина
выполнять: выполняют
сэкономить: сэкономит
скулить: скулят
поднять: поднят
конец: конец
светло: светло
питание: питания питание
чемпион: чемпионов
линять: линяют
нос: носа
круповой: круповой
сон: сна
именно: именно
плато: плато
доля: долей
рот: рта
локоть: локтями
правильный: правильнее
снижать: снижающих
популярный: популярна
продолжительность: продолжительность
разводить: разводят разводили
закруглить: закругленный
плавание: плавание
заниматься: занимающихся
осветляться: осветляется
обучать: обучали обучать
курс: курс
охранять: охраняющий охраняет
аппетит: аппетитом
привыкнуть: привыкнет
страна: страны странах страна
стать: стать
запястье: запястья
интересный: интересный
короче: короче
опустить: опущен
входить: входит
подъём: подъем
мышца: мышцами
устраивать: устраивайте
недоступный: недоступно
назвать: названа
отдых: отдыха
результат: результате
доминирование: доминированию
выгнутый: выгнутыми
клан: кланов клан
система: системе
никак: никак
бороться: бороться
принимать: принимать принимают
утром: утром
тот: те тому
ребятня: ребятни
фишка: фишка
обращаться: обращаться
фото: фото
показать: показать
маленький: маленького маленьких меньше
допускаться: допускается
наименее: наименее
вы: вами
два: две двух
яндекс: яндекс
умный: умны
количество: количество количестве
уголок: уголок
подготовить: подготовьте
участие: участие
страдать: страдает
ножницы: ножницы
свой: свой свое своей своих своя своему
линька: линьками линька
череп: черепа череп
неудобство: неудобства
выразительный: выразительным
техника: техника
одёжка: одежка
обязательный: обязательная обязательное обязательна
журнал: журнал
месяц: месяца
спутать: спутать
популярно: популярно
контактировать: контактируют
дополнять: дополняйте
нуждаться: нуждаются
гулять: гулять
постав: постав
относить: относите
формирование: формированию
первый: первое первую
хозяин: хозяину
обычный: обычной
порядок: порядка
покров: покров
болезнь: болезни
кормление: кормлением кормления кормление
заводчик: заводчиков заводчики
чрезмерно: чрезмерно
контролировать: контролировать
ребёнок: детей детях
пустить: пустив
зона: зоны зон зоной
либо: либо
требование: требование
стадо: стада стадо
белый: белого белая белый
тяжёлый: тяжелых
какой: какие
масса: массой
простой: проще простым
достигать: достигать
карман: карманов
обучаться: обучаться
усиленный: усиленная
увидеть: увидеть
перегружать: перегружать
топтаться: топтаться
близкий: ближайшими
подвес: подвеса
мускулистый: мускулистое мускулистые
туалетный: туалетных
пустынь: пустыням
допустимый: допустимы
перерыв: перерывах
перекус: перекус
вести: ведет
заметно: заметно
отличить: отличить
взросление: взросления
диморфизм: диморфизм
день: дня день дни
размести: размету
перейти: перейти
габаритный: габаритная
постный: постные
статус: статус
из-за: из-за
главное: главное
запрет: запретом
максимум: максимум
вступать: вступает
поведение: поведение
номер: номер
фурминатор: фурминатор
начинать: начинает
объяснение: объяснение
шайка: шайка
сведение: сведения
команда: командам команда
во-вторых: во-вторых
грудь: груди
зной: зной
родословный: родословные
успевать: успевает
костяк: костяк
отсутствие: отсутствие
ткань: тканью
слишком: слишком
одиночество: одиночеству
котофей: котофея
никто: никто
уделять: уделяющие
незначительный: незначительного
мордочка: мордочка
зарегистрировать: зарегистрированных
габарит: габаритов
гигиена: гигиена
кангала-медалист: кангале-медалисте
блуждать: блуждающие
ваш: ваш вашего вашем ваша
относиться: относятся
книзу: книзу
инструкция: инструкции
оценка: оценке
помогать: помогающая
анталкать: анталкая
назначение: назначения
посвящать: посвящать
охота: охоты
взять: возьмет
натурпитание: натурпитания
пелёнка: пеленку
вечером: вечером
стая: стаи
правило: правило правила
внимание: внимание
расправиться: расправиться
прикус: прикуса прикус
ушной: ушного ушную
любой: любые любой
попроситься: попроситься
волосопад: волосопад
трепетный: трепетными
часть: часть
иметь: имеет имеющих имеют
стоимость: стоимость
удлинённый: удлиненные
особенно: особенно
нападение: нападением
щётка: щетку
желательно: желательно
подавать: подавать
выводить: выводите
очертание: очертания
афганистан: афганистана
достаточно: достаточно
мягко: мягко
обязательно: обязательно
изолировать: изолированный
белка: белке
собственность: собственностью
контакт: контактов
потрепать: потрепать
когтереза: когтерез
травматичность: травматичность
возвышение: возвышения
кольцо: кольцо
неделя: неделю
переходить: переходят
чрезмерный: чрезмерной
двор: двора
щетина: щетины
пасти: пасет
охотно: охотно
белок: белков
опасность: опасности
костюм: костюма
неплохой: неплохой
водоём: водоемов
купить: купить купите
нагрузить: нагрузив
часто: часто
поставить: поставлены поставит
мечта: мечтой
процедура: процедура
предел: пределах
бессмысленно: бессмысленно
успокоить: успокоит
регистрация: регистрацию
вертикально: вертикально
запас: запас
грудной: грудной
что: чему
ответить: ответить
период: периоды период
разноглазие: разноглазие
случай: случаях случае
выбирать: выбирать
привлекать: привлекают
исключить: исключив
испытание: испытания
услышать: услышать
бэбиситтер: бэбиситтером
микро: микро
тёмно-коричневый: темно-коричневым
отар: отар отары
ромашка: ромашки
клетка: клетки
чистый: чистой
приподнять: приподнятое
шерстинка: шерстинки
пухлый: пухлым
крупа: круп
поза: позу
погулять: погулять
далеко: далеко
честь: честь
супергерой: супергероя
одноклассник: одноклассники
скорее: скорее
расчёска-гребень: расческу-гребень
путём: путем
попутно: попутно
ощущать: ощущает
послушание: послушания
монопородный: монопородных
овсяный: овсяная
укус: укусы
скорость: скорость
мнение: мнение
здоровье: здоровья здоровье
коробка: коробки
употреблять: употребляют
край: край
случайный: случайные
кроме: кроме
малыш: малыше малыши малыша
открыть: открыт
предкам-молосс: предкам-молоссам
отказывать: отказывают
суровость: суровость
переизбыток: переизбыток
сторожевой: сторожевую
забирать: забирать
частый: чаще
москва: москва
поиск: поиск
подтянутый: подтянутые
слышный: слышно
звезда: звезда
вообще: вообще
естественный: естественными
параллельный: параллельны
ложный: ложной
оспариваться: оспаривается
таковой: таковым
познакомить: познакомьте
характер: характер
потребоваться: потребуется
скуловой: скуловой
себя: собой
значение: значений
углевод: углеводов
обходить: обходить
защитник: защитниками
цепь: цепь
африканский: африканским
сажать: сажать
противопоказанный: противопоказано
гиперответственный: гиперответственный
плотный: плотным
шампунь: шампунем
болезненно: болезненно
подозрительность: подозрительность
отнимать: отнимает
короткий: короткая
лужица: лужицам
дисплазия: дисплазии
сбоку: сбоку
сделать: сделано сделает
дополнительно: дополнительно
игра: игры
родственник: родственниками
активизировать: активизировать
карапуз: карапуза
потребность: потребность
периодически: периодически
цвет: цвету
порок: пороки
единый: единую
предок: предков
способный: способна способны
недокус: недокус
жизнь: жизни жизнью
отмереть: отмершие
весить: весят
приставание: приставания
скакательный: скакательных
треугольный: треугольные
мешать: мешает мешают
померанский: померанский
опускать: опускать
плечо: плечи
группа: группы
минутный: минутных
поговорить: поговорите
брутальный: брутальным
вылазка: вылазках
пытаться: пытаетесь
изгиб: изгибом
снисходительный: снисходительны
тигровый: тигровые
желудок: желудка
сельскохозяйственный: сельскохозяйственных
относительно: относительно
нужно: нужно
надоедливый: надоедливые
мимимишность: мимимишности
также: также
ужин: ужина
расценивать: расценивайте расценивать
помочь: поможет помогли
момент: моменты
отдыхать: отдыхайте
рухнуть: рухнули
официальный: официальных
издёрганность: издерганности
корпус: корпус
продолжать: продолжает
стандарт: стандарт
сезон: сезонам
внешний: внешняя
сбивать: сбивает
покорять: покоряют
опасный: опасным
вязать: вяжут
карабаша: карабаши
изначально: изначально
выносить: выносите
сложно: сложно
крайне: крайне
область: области
стоить: стоит
это: это
добраться: добраться
жир: жиров
схема: схемы
схватывать: схватывать
вариация: вариации
разрядиться: разрядиться
выжидательный: выжидательную
плоский: плоские
гепард: гепардами
вполне: вполне
тепловой: теплового
телепередача: телепередачами
ньюфаундленд: ньюфаундленд
убрать: убрать
стараться: старайтесь
профиль: профиль
проблема: проблеме проблем
пыль: пыль
участок: участках
каша: каши
принять: примет
повседневный: повседневной
облегчить: облегченное
условие: условие
многий: многих
легко: легко
лента: ленту
заботливый: заботливыми
нервный: нервными
возникать: возникает
наклонный: наклонные
отличный: отличные
лай: лай
отвиснуть: отвисшие
бок: боками бокам
заварка: заваркой
во-первых: во-первых
вырисовываться: вырисовывающимися
медведь: медведями
ркф: ркф
овца: овцу
локтевой: локтевых
избегать: избегать
выход: выход
вакансия: вакансии
приучать: приучайте
специалист: специалисты
базовый: базовым
экстерьерный: экстерьерная
животновод: животноводам
продукт: продукты
незнакомец: незнакомцев
город: города
постоянно: постоянно
вроде: вроде
слой: слоя
достаточный: достаточным
чистокровный: чистокровных
сей: сей сих
ветеринар: ветеринара
общество: общество
выше: выше
стричься: стригутся
вместе: вместе
течение: течение
психика: психикой
распространение: распространение
продуктивность: продуктивности
покупка: покупка
большинство: большинство
однородный: однородный
практически: практически
ежемесячно: ежемесячно
рейтинг: рейтинг
дефект: дефекты
член: членами
недопустимый: недопустимы
важность: важность
лев: львами львов
подписываться: подписывайтесь
привести: приведет
присутствие: присутствие
акбаш: акбаши
перекись: перекисью
использовать: использовать
соблюдать: соблюдать
какой-то: какую-то
точность: точностью
очень: очень
обычно: обычно
внушить: внушить
всевозможный: всевозможные
состав: составом
стража: страже
умение: умение
наиболее: наиболее
мытьё: мытье
наоборот: наоборот
инстинкт: инстинкт
постепенно: постепенно
происходить: происходит
страшно: страшно
кличка: клички
черта: черта
вблизи: вблизи
последний: последнего
прежде: прежде
держать: держать
зарваться: зарвавшегося
музыка: музыкой
подкладывать: подкладывайте
пятнышко: пятнышка
приемлет: приемлет
касаться: касается
необходимый: необходимые
равнина: равнинам
взрослый: взрослых
экстремально: экстремально
сократить: сократить
проект: проекте
территориальный: территориальный
сразу: сразу
склонный: склонны
недопустимо: недопустимо
борьба: борьбе
зуб: зубов
воспитывать: воспитывали
пора: пор
кг: кг
темперамент: темперамента
царство: царства
среднее: среднего
план: планы
риск: риск
вытягиваться: вытягиваются
прямой: прямой
ход: ход
звук: звуками
сустав: суставов
использоваться: использовались
причём: причем
ситуация: ситуации
африка: африки
недостаток: недостаток недостатками
плюсна: плюсны
удар: удара
есть: едят
энергия: энергии
ширина: ширина
рассмотреть: рассмотреть
оба: оба
являться: является
постараться: постарайтесь
губа: губы
трусливость: трусливость
основный: основных
защищать: защищает
отталкивать: отталкивает
встречаться: встречаются
соседский: соседскому
овощ: овощах
обучить: обучите
шаг: шаг
кочевой: кочевые
благоразумие: благоразумием
