заметить: заметили
процесс: процессе
овощ: овощи
использовать: используя использовать
тело: тела теле тело
популярность: популярности популярность
смириться: смириться
филировать: филируют
расти: растет
следить: следить следите
участвовать: участвовать
улица: улицам улице
сколько: сколько
бриар: бриарах бриара бриаров бриарами бриар бриаром бриары
быть: будете
морской: морскую
осмотр: осмотра
душа: души душе
название: название названия названию
часть: частях
роль: роли роль
тон: тонах
собака: собаку собаками собакой собак собака собаке собаки
примерно: примерно
настоящий: настоящих настоящим настоящая
ложка: ложка
порок: пороков пороки
обусловить: обусловлены
лохматый: лохматыми лохматую лохматой лохматые лохматый лохматых
яркий: ярким
справляться: справляются справляться
соблазн: соблазну
обсуждение: обсуждения
отношение: отношениях отношение отношения
наследственность: наследственностью
настоять: настоять
понятливый: понятливые
цена: цена цен
рыба: рыбу
ущемление: ущемлением
материал: материалов
фермерский: фермерского
чужак: чужаками
казаться: кажется
пастушеский: пастушескому
обучать: обучающий обучающих
расчёска: расческой
форменный: форменным
необычайно: необычайно
поведение: поведения поведение
шуба: шубу шубе
качество: качествами качестве качеством качества
любовь: любовь
сторона: стороны стороной
дисквалифицировать: дисквалифицирующие
зубчик: зубчиками
сиба-ин: сиба-ину
семейство: семейства
побегать: побегать
зато: зато
россия: россия россии
вычёсывать: вычесывают
раковина: раковины
улучшить: улучшит
обратный: обратная
обаяние: обаяние
корпус: корпусе корпусу корпус
длительный: длительные
начинать: начинают начинать
радужка: радужки
мероприятие: мероприятия
представитель: представителей представители
компаньон: компаньонов
упражнение: упражнений
обход: обхода
команда: команду командам команда
ухудшить: ухудшить
шея: шея
овчарка: овчарки овчарках овчарок овчаркам овчарке овчарку овчарками овчарка
бриарский: бриарскими бриарские бриарских бриарским бриарская
городской: городская
шерсть: шерсть шерсти шерстью
котофей: котофей
больший: наибольшего большие
обстоять: обстоят
испортить: испортить
степенность: степенности
применять: применять
челюсть: челюсти
некупированный: некупированным
разрываться: разрываться
должный: должны должно должна
воспитание: воспитания воспитание воспитанием
частый: частыми частые чаще почаще
потомство: потомства потомство
гуртом: гуртом
тип: тип типа
взгляд: взгляд взгляды взглядами
исключение: исключение
комплекс: комплексах
священнослужитель: священнослужитель
малый: малейших
останавливать: останавливают
продолжить: продолжило
проход: проходе
чёрный: черные черного черным черными
пастуший: пастушья пастушью
месяц: месяц месяцы месяца месяцев
питомец: питомцами питомец питомца
собственный: собственный собственном собственным собственными собственной собственную
сломя: сломя
явный: явная
разработать: разработает
участок: участки
спустя: спустя
косметика: косметику
рост: росту рост
нога: ног ноги ногах
служить: служить
выраженный: выражен выраженными выраженно выраженным
опоздание: опозданием
гильотинный: гильотинного
важно: важно
держать: держите
превратиться: превратится превратилось
измениться: изменится
способность: способностях
юность: юность
неутомимый: неутомимых
упустить: упущен упущенное
история: история
угадываться: угадывался
щенок: щенка щенков щенки щенок щенками
завидеть: завидев
фонд: фонд
стильный: стильный стильную стильным стильной
настолько: настолько
прилегать: прилегающие
выстригать: выстригать
принять: примите принято
взрослый: взрослый взрослым
голова: голове голову голова
чувствовать: чувствуют
кисломолочный: кисломолочные
комплект: комплект
тесно: тесно
пастух: пастуха
характеристика: характеристика
этот: этими эта этих
выставка: выставках выставки выставке
такой: таком таких такое такие такую таким
руб: руб
биотином: биотином
причина: причинам
коричневый: коричневая
отметка: отметку
восстановить: восстановить
купание: купания
год: годы года лет году
война: войны
союз: союзе
клетка: клеткой
повод: поводу повода
редкий: редким реже
коготь: когти
специфический: специфическом специфический
крем: крем
значит: значит
двухмесячный: двухмесячного
любимый: любимый
утвердить: утвердили
возможный: возможных
палец: пальцы пальцами пальцев
быстро: быстро
развлечение: развлечениям
основное: основном
присутствие: присутствия присутствие
еда: еду еде
французский: французская французские французских французскому
видео: видео
записать: записать
пройдоха: пройдох
стресс: стрессу
коммерческий: коммерческого
разрешаться: разрешается
меню: меню
месячный: месячном
полностью: полностью
данность: данность
дворняжка: дворняжек
обаятельный: обаятельный
разбить: разбить
домашний: домашних домашними
разрекламировать: разрекламировали
каждый: каждой каждом каждая
богатство: богатством
владелец: владельца владельцев владельцы
отрастание: отрастания
привычка: привычка
пренебрегать: пренебрегайте
речь: речь
содержание: содержание содержания
стать: станут
учинять: учиняет
перерастать: перерастает
немного: немного
наполеон: наполеон
традиция: традиция
веселить: веселит
сдать: сдаст
занятие: занятиями
доставлять: доставляли
составить: составлено
численность: численность
осознать: осознает
принимать: принимало
окрас: окраса окрас окрасов
масло: масло
кстати: кстати
связь: связь
другой: другую другие другого других другими
сбиваться: сбивается
клуб: клуб
система: система системе
квалификация: квалификацию
основный: основному
внешность: внешность внешности
элитный: элитную
месье: месье
газета: газету
профессионал: профессионалу
диарея: диареи
пока: пока
тягловый: тягловой
полный: полная полный полное полном
породный: породном
состояние: состоянии
завиток: завитком
собачий: собачьего
растительный: растительное
структура: структуру структуре
способ: способами способ
бояться: бояться
позыв: позывы
частенько: частенько
напоминать: напоминающие напоминает
ситуация: ситуацию
мягкость: мягкость
пантомима: пантомима
церемониться: церемонятся
заниматься: заниматься
комплекция: комплекцию
внешний: внешнее внешнего внешний
выносить: выносит
приём: приемов
шоколадный: шоколадного
печально: печально
тримминговать: тримминговать
поле: поле поля
подозрительный: подозрительны
подмешать: подмешанными
смущать: смущает
смотреть: см
фотография: фотографии
провожать: провожая
невзирая: невзирая
сумма: суммы
уход: уходе уход
современный: современные
создание: создания
социализировать: социализировать
элементарный: элементарным
помнить: помните
изящный: изящнее
лохматик: лохматиком
результат: результат
дать: данной
высокий: высокая наивысшим
питомник: питомники
поладить: поладить
извлечение: извлечением
выбирать: выбирайте
глаз: глаза глазах
квадратный: квадратной
каприз: капризов
приняться: принялись
обманчивый: обманчивые
прийтись: придется
мягкий: мягкий мягкому
авторитарный: авторитарный
корм: корм
охарактеризовать: охарактеризовал
самостоятельный: самостоятельной
валенок: валенок
быт: быту
сказать: сказать
долгий: подольше
ус: усы
смысл: смысле
конечность: конечностях конечности
америка: америку
вести: вести ведут
упругий: упругими
желаемый: желаемое
поскольку: поскольку
обучение: обучения обучение
прочий: прочие
правило: правилам правило правила правил
ветерок: ветерком
краткий: краткая
открывание: открыванием
чистота: чистотой
обзавестись: обзавестись
свой: своими своем свой свое своего своей своих своему
всякий: всякого всякий
место: место местах места
однообразие: однообразии
отказаться: отказались
исключительно: исключительно
эксперт: экспертов
купать: купать
резвый: резвые
курс: курсах курс
выполнить: выполнил
пайка: паек
забывать: забываем
вконтакте: вконтакте
свет: свет
человек: людьми человека человек
пострадать: пострадала
ответственный: ответственного
создать: создать
прогрессировать: прогрессирующая
ярко: ярко
овечий: овечьих овечьим
хозяин: хозяин хозяину хозяевам хозяина хозяева хозяине
лишённый: лишенные
средство: средств
отличительный: отличительная
наверстать: наверстали
развитие: развитие
животное: животных животным животного животные животное
размер: размерах
один: одного одной
занимать: занимает
общий: общий общем
выяснять: выяснять
характер: характером характера характер
четвёртый: четвертых
волос: волос волосы волосу
купироваться: купировались
выбрать: выбрать
запоминаться: запоминающимся
облик: облик
особенный: особенный
оба: обеих
основать: основана основали
допустить: допустим
шёрстный: шерстного
сустав: сустава суставы
хотя: хотя
интеллектуальный: интеллектуальным
хитроумный: хитроумные
раз-два: раз-два
х: х
провоцировать: провоцируйте
браковать: бракованного
век: веке
унаследовать: унаследуют
самостоятельность: самостоятельность
отрыгивать: отрыгивают
выгуливать: выгуливать
носиться: носится
поручить: поручите
существенно: существенно
грация: грацию
бриару: бриару
положить: положенное
проживать: проживать проживающих
квартира: квартире квартирах
опыт: опыта опыты
срастись: сросшимися
аллергия: аллергию
информация: информация
расчёсывание: расчесывание расчесыванием расчесывания
складка: складками
наклонный: наклонным
ходьба: ходьбе
защитник: защитников
проходить: проходят
имидж: имиджем имидже
двухразовый: двухразовое
рак: рак
мимишность: мимишности
гребень: гребнем
узнать: узнали
нерв: нервы
сначала: сначала
острый: острый
авторитет: авторитет
остальной: остальных остальной
ветеринар: ветеринар
ниже: ниже
специалист: специалистов специалисты
выбор: выбор
стадо: стадом
родитель: родители
старость: старости
именоваться: именовались
распутывание: распутыванию
прореживать: прореживать прореживают
сухой: сухой сухая сухую
козий: козью
габарит: габариты
сравнительно: сравнительно
среди: среди
висячий: висячим
зарекомендовать: зарекомендовали
дом: дом доме
племенной: племенной племенных
нормальный: нормальное
рентгенолог: рентгенолога
лапа: лапах лапы лап
подушечка: подушечками
поколесить: поколесить
категорически: категорически
выпас: выпаса выпас
деться: делась
сваляться: свалявшаяся свалявшиеся
настигнуть: настигла
настроение: настроении настроение
сброс: сбросу
северный: северную
считаться: считается
мыть: мыть мойте
провести: провела
неконтролируемый: неконтролируемому
воспитанный: воспитанный
бежать: бегущая
колтунорез: колтунорезом
просто: просто
четверолапый: четверолапых
мало: мало
норматив: нормативы
весёлый: веселых
рекомендовать: рекомендованы
нормара: нормар
водить: водить
доверие: доверия
собираться: собираетесь
час: часа час
провинция: провинции
хипстер: хипстерами
заинтересоваться: заинтересовался
раздражение: раздражение
перетянуть: перетянуть
мировой: мировой
который: которое которой которого которая которых которым которые который
добавить: добавьте
прогулка: прогулки
мусор: мусор
умный: умен умная
пушистик: пушистика
умеренный: умеренная умеренными
происхождение: происхождения
трепать: трепать
тёмный: темные темным
необходимо: необходимо
готовый: готовы готов готова
первый: первые первое первыми первый первую
плащ: плаща
запутаться: запутавшийся
пища: пищи
скопление: скопления
частично: частично
удлинённый: удлиненная
какой-нибудь: какой-нибудь какому-нибудь
задний: задние задних
вид: вида вид
интеллектуал: интеллектуал
дрессировка: дрессировку дрессировка дрессировке дрессировки
стандартный: стандартный стандартной
время: время времена времени
сука: суки
мочка: мочкой мочка
плохой: хуже худшее плохом
агрессивность: агрессивность
ушной: ушной ушном ушным ушное
ударный: ударными
гуляние: гуляний
защищать: защищать
наказание: наказания
лоб: лбу лбом
приличный: приличный
возникать: возникать
грумерский: грумерские
настой: настой
толстой: толстого
подкормка: подкормки
витамин: витамином витаминами
исчезнуть: исчезли
мера: мере
обидчивый: обидчивы
комфортно: комфортно
например: например
небольшой: невелики
несколько: несколько нескольких
сетчатка: сетчатки
превосходно: превосходно
подопечный: подопечными подопечный подопечных подопечного
кондиционер: кондиционер
вальяжность: вальяжности
разброс: разброс
гипертрофировать: гипертрофировано
ежедневный: ежедневным
одиночка: одиночку
решение: решений
балл: баллов баллом
изменение: изменений
чёлка: челкой челку
сила: силы силу силами
жить: жить
лишиться: лишиться
ругать: ругать
реклама: реклама
глянец: глянец
симпатяга: симпатяга симпатяг
понять: поймет
обонять: обонять
линять: линяет
переселить: переселить
франция: франция
определённо: определенно
второй: второй второго
окд: окд
рекомендоваться: рекомендуется
качественный: качественную
привлекать: привлекали
получиться: получится
имущество: имущество имущества
западный: западной
работа: работы
малыш: малыш малыши малыша
правильно: правильно
насекомое: насекомых
евросоюз: евросоюза
примочка: примочки
сайт: сайту
непараллельный: непараллельный
особенность: особенностей особенность
округлый: округлым
вывозить: вывозили
дополнительный: дополнительных дополнительному
регион: регионе
занять: занять
живость: живость
ронья: ронье
прохождение: прохождения
понукать: понукать
сохранять: сохраняющая
недуг: недугов
что-то: что-то
мобильный: мобильный
набрать: набрать
долго: долго
форум: форум форуме
обрезка: обрезками
печень: печень
тренировочный: тренировочный тренировочную
отличаться: отличающихся отличаются отличался
заворот: завороту
стоп: стопом
предпочтение: предпочтение
конец: конце конец
протяжение: протяжении
чаять: чающий
нисколько: нисколько
требовать: требуют требующими
показываться: показываться
расширять: расширять
положение: положение
мальчик: мальчики
хозяйский: хозяйскую хозяйское
почтовый: почтового
помериться: помериться
сделать: сделавший сделано
темп: темпами
спокойный: спокойны
показушный: показушную
описание: описание описанию
начало: начало
многое: многое
трястись: трясутся
стандарт: стандартом стандарта стандарте стандарт
капризный: капризных
геркулесовый: геркулесовую
посадить: посаженные посадят
подчиняться: подчиняться
человеческий: человеческому
середина: середине
скиджоринг: скиджоринга
белый: белых белого
длинный: длинный длинную длинная длинной
однако: однако
внушительный: внушительные
обитать: обитает
дело: делу дело дела деле
становиться: становится
поэтому: поэтому
белоснежный: белоснежных
отводиться: отводится
подвиг: подвиг
попасть: попал
метионин: метионином
копирование: копирование
дружелюбный: дружелюбная
трудно: трудно
придумывать: придумывая
активность: активность
трактат: трактате
серый: серой
семечко: семечки
дружелюбность: дружелюбность
активный: активным
плавно: плавно
отзыв: отзывах отзывы
утяжелить: утяжеленную
кошка: кошки кошек кошками
следовать: следует
животный: животному
шум: шум
подавлять: подавлять подавляющее
собачник: собачников
довольствоваться: довольствоваться
управляемый: управляемая
процедура: процедуры
покупатель: покупателю
крайний: крайнем
резиночка: резиночкой
отличие: отличие
допустимый: допустимо
мать: матери
умелый: умелая
обходить: обходит
оттенок: оттенка
цвет: цвет цвета
интерес: интерес
многолетний: многолетней
пенсионный: пенсионного
ламинария: ламинария
порода: породы пород порода породой
формат: формата
лидерский: лидерскими
отец: отца
заполучить: заполучить
ножницы: ножницами ножницы
последствие: последствия
объявление: объявления
хвостик: хвостиком
основной: основные
полова: половой
интеллект: интеллект интеллекта
охранный: охранные
забыть: забудет
потрудиться: потрудился
ум: ум
сдавать: сдают
вес: вес
спина: спину спиной
комический: комического
небрежность: небрежность
помочь: помогут помочь
наматывать: наматывать
неизбежность: неизбежностью
француз: француз французы
никуда: никуда
тиреоидит: тиреоидит
вовсю: вовсю
беспорядок: беспорядка
по-настоящему: по-настоящему
рацион: рациону рацион
дополнение: дополнением
утверждать: утверждая
именно: именно
малознакомый: малознакомыми
будущий: будущие
перспективный: перспективным
конкурировать: конкурировать
попытка: попытках
холодное: холодное
продолжительность: продолжительность
стрижка: стрижки
международный: международная
переводить: переводят
огород: огорода
фермер: фермеры
гребешок: гребешком
отлично: отлично
страна: страны стране страну странах страна
комок: комки
пёс: пес
неизменно: неизменно
содержимое: содержимого
утренний: утреннюю
масляк: масляков
расположить: расположены расположить
бросаться: бросаться
два: двумя двух
шампунь: шампунь
полотно: полотно полотном
непослушный: непослушного
диагностировать: диагностируют
пастырь: пастырей
никак: никак
утром: утром
слегка: слегка
тот: те та тому
иметься: имеются
получать: получающая
кататься: кататься
двойной: двойные
фото: фото
экстерьерный: экстерьерных
питание: питание
прибылой: прибылых прибылые
розовый: розовая
заодно: заодно
сам: самого самом
крупный: крупного крупные
яндекс: яндекс
количество: количество
массажный: массажной
посильно: посильно
определённый: определенной
коллега: коллегами
выглядеть: выглядеть выглядит
закармливать: закармливая
пытаться: пытаться пытаются
хотеть: хотите
нестись: несется
вперёд: вперед
издевательство: издевательством
существующий: существующими
когтерезка: когтерезкой
хороший: лучшему хорошее
вентиляция: вентиляции
холка: холке
смочь: смогли сможет
угол: углами
указать: указали
сиюминутный: сиюминутных
журнал: журнал
воспитанник: воспитанников
зашкаливать: зашкаливающей
высота: высота
одышлив: одышливы
приготовиться: приготовьтесь
стиль: стиль
лень: лень
бриарам: бриарам
повзрослеть: повзрослев
ящик: ящика
морковь: морковь
зелень: зелень
ст: ст
нуждаться: нуждаются
след: следов
гулять: гулять
постав: постав
угс: угс
научить: научите
повышенный: повышенных
предназначить: предназначенный
болезнь: болезни болезнью болезнь
умение: умением умение
кормить: кормят кормить
ухо: ушами уши
заводчик: заводчиков заводчики
прорабатывать: прорабатывают
угодный: угодно
совершенно: совершенно
приобретать: приобретая
горбинка: горбинки
керри-блю-терьер: керри-блю-терьер
либо: либо
прокатывать: прокатывает
пятно: пятен
микроэлемент: микроэлементов
кошачий: кошачьи кошачью
указание: указаниям
образ: образом
первозданный: первозданный
европейский: европейских
неопытный: неопытных
снятие: снятия
снаряд: снаряды
великий: великий величайший
пусть: пусть
мимика: мимика
рассматривать: рассматривать
поддаваться: поддавайтесь поддающееся поддается
кобель: кобели кобелей кобелями
ужимка: ужимки
весь: всему всеми
скакательный: скакательные
неизвестный: неизвестным
условие: условиях
заметно: заметно
провал: провала
упрямство: упрямства
позиция: позиций
стальной: стальной
взросление: взросления
помета: помете
родить: рожден
форма: формой
пачкаться: пачкаются пачкается
минеральный: минеральные
развитой: развитой
перейти: перейти
ваш: вашей ваш вашем
реально: реально
сутки: сутки
статус: статус
физический: физические
разный: разные
из-за: из-за
регулярно: регулярно
главное: главное
проверить: проверьте
детство: детство
урезать: урезать
копировать: копируют
маленький: маленькие меньше
слово: слова
менее: менее
арсенал: арсенал
переслать: перешли
идти: идут
пти-брабансон: пти-брабансон
закутать: закутанный
новый: новыми новый
дефект: дефектов
драка: драке
малоподвижный: малоподвижным
давать: давайте
сложиться: сложилась
обученный: обученная
цель: целью
отсутствие: отсутствие
знаменитый: знаменитые знаменитый
слишком: слишком
одиночество: одиночеству
виллебранда-диана: виллебранда-диана
запустить: запустите
жилистый: жилистыми
требоваться: требуется
страдать: страдающие
беспричинный: беспричинные
макро: макро
обман: обманом
согласиться: согласится
шанс: шансы шансов
погонять: погонять
всевозможный: всевозможных
день: день
атрофия: атрофия
морда: морда
гигиена: гигиена
рвота: рвоте
аббат: аббатом
знание: знаниями
крепкий: крепкая крепких
здоровый: здоровая
вольер: вольере вольер
относиться: относятся
мускулистый: мускулистая мускулистые
необходимый: необходимую необходим
покров: покрова
оценка: оценке
хозяйка: хозяйка
деликатес: деликатесах
гречневый: гречневую
появиться: появились
выждать: выждите
мокрый: мокрый
выгонять: выгоняя
разведение: разведения
работоспособность: работоспособность
вечером: вечером
мелкий: мельче
памятливый: памятливые
подвергнуть: подвергнуть
внимание: внимание
блестящий: блестящей
прикус: прикуса
придирчивый: придирчивы
нижний: нижних
парикмахерский: парикмахерскими
дворовый: дворовом дворовая
короткий: короткие
жилище: жилище
иметь: имеет иметь имеющим имеющие имеют
стоимость: стоимость
подойти: подойдут
приобрести: приобрести
зазвонить: зазвонит
хрящ: хрящами
особенно: особенно
лёгкость: легкостью
удовольствие: удовольствие
воля: волю
строго: строго
спешить: спешите
длина: длина
позволять: позволяющих позволяйте
перестать: перестал перестали
крепыш: крепыши
достаточно: достаточно
каста: касту
доминировать: доминировать
карл: карл
разгребать: разгребать
накануне: накануне
ребёнок: ребенком
пара: пару
серьёзный: серьезной
изжить: изжило
особь: особям особей
любой: любых любой любом
возраст: возраста возрасте
чистопородный: чистопородной
кабачок: кабачок
доставать: доставать
неделя: неделю
правильный: правильные правильной
европа: европы
неопрятный: неопрятный
отдавать: отдает
любитель: любителей
понимать: понимать
стоячий: стоячее
купить: купить
часто: часто
оговорить: оговоренного
поставить: поставлены поставленные
склонность: склонность
кокетливый: кокетливые
красный: красного
желание: желание
вертикально: вертикально
стричь: стригут
грудной: грудной
издревле: издревле
что: чему
растрёпа: растрепа
разводить: разводили
период: периоды
предать: преданный
разноглазие: разноглазие
напролом: напролом
случай: случаях случае
аджилить: аджилити
пупочный: пупочной
демонстрировать: демонстрирует
ипо: ипо
вымещать: вымещать
сокращать: сокращая
крутой: крутым
испытание: испытания испытаниях
придавать: придают
глазной: глазных
прокатиться: прокатится
растянутый: растянутого
наличие: наличие
отар: отар
ромашка: ромашки
замашка: замашки
травмировать: травмировать
подшёрсток: подшерстка
заслуживать: заслуживают
дисплазия: дисплазию дисплазия
крестьянин: крестьянами
сельскохозяйственный: сельскохозяйственном
сердце: сердце
ухищрение: ухищрений
сомневаться: сомневайтесь
перечисление: перечислению
руководить: руководить
различный: различных
далеко: далеко
навсегда: навсегда
одноклассник: одноклассники
скорее: скорее
странно: странно
послушание: послушания
лосьон: лосьон
пожаловать: пожалован
мочь: можете могла
правда: правда
источник: источников
укус: укусы
генетический: генетическая
мода: мода
против: против
отдельный: отдельный
случайный: случайные
передний: передние
стягивать: стягивают
кроме: кроме
движение: движении
наблюдаться: наблюдается
мечта: мечты
сплошной: сплошной
котейка: котейке
испытывать: испытывают
фристайл: фристайла
сегодня: сегодня
воздушный: воздушной
три: трех
поиск: поиск
наклон: наклона
получить: получить
оптимальный: оптимальный
думать: думающая
тазобедренный: тазобедренного
зуб: зубы зубов
нагружать: нагружайте
волосок: волосков
таковой: таковым
климат: климату
второстепенный: второстепенную
образовать: образует
энергичный: энергичная
специализироваться: специализирующиеся
слепо: слепо
противопоказанный: противопоказано
заставить: заставить
явление: явление
приносить: приносить
ветаптека: ветаптеки
полезный: полезными
незначительный: незначительных
сторож: сторожа
служба: службу
общение: общении
вписаться: впишется
зрение: зрения
стратегия: стратегии
тыква: тыква
окоп: окопы
нос: нос
раненый: раненых
простейшее: простейшим
сильный: сильный сильные сильным
колтун: колтуны
потребность: потребность
периодически: периодически
уметь: умеет
забросить: заброшенный
недокус: недокус
репутация: репутацию
будка: будке
проверять: проверяющие
жизнь: жизни жизнь
заканчиваться: заканчивается заканчиваются
рука: руку
вооружаться: вооружайтесь
ждать: ждите
сильно: сильно
едва: едва
благодаря: благодаря
принятие: принятии
хитрый: хитрого
потенциальный: потенциальному
всё-таки: все-таки
облегчение: облегчения
подобно: подобно
предок: предками
плечо: плечи
видеть: видит
впервые: впервые
болонка-переросток: болонка-переросток
запах: запах
светлый: светлый светлого
отечественный: отечественные
премоляр: премоляров
ключик: ключик
воспитывать: воспитывать
учитывать: учитывать
выдающийся: выдающихся
зарубежный: зарубежными
вертикальный: вертикальное
желудок: желудка
хвастаться: хвастались
штурмовать: штурмовать
мимимишность: мимимишности
крестьянский: крестьянских
также: также
бри: бри
щёлкать: щелкают
параметр: параметры
правдивый: правдивое
эмигрировать: эмигрируя
норовить: норовит
момент: моменты момент
опрятный: опрятных
нежирный: нежирные
возможно: возможно
воспаление: воспалений
бородка: бородку
оставить: оставит
постоянный: постоянное
лаять: лаять
горожанин: горожан
хипстерский: хипстерской
собственнический: собственнические
высоко: высоко
мешковатость: мешковатостью
бегемотик: бегемотик
сложно: сложно
прислуживать: прислуживать
густота: густоте
собирать: собирая
стоить: стоит
это: это
придумать: придумать
овладевать: овладевать
массивный: массивные массивной
естественно: естественно
ласка: ласку
акцентировать: акцентируйте
укоротить: укоротить
любить: любит любить
отличный: отличным отличные
ворчать: ворчать
квартирный: квартирного
лайк: лайка
вполне: вполне
мешок: мешки
привести: приведете
излишний: излишней
стараться: стараться
усечь: усеченный
хитрость: хитрости
однажды: однажды
стремительный-элегантный: стремительно-элегантна
чистка: чистки
оглядка: оглядки
признак: признаков
каша: каши
разобрать: разобрать
легко: легко
советский: советском
превратить: превратить
привыкнуть: привыкли
доверить: доверьте
сохранить: сохранить сохраните
лента: ленту
западно-сибирский: западно-сибирская
громко: громко
здоровье: здоровье
скрывать: скрывающей
превосходный: превосходных
основательно: основательно
интенсивно: интенсивно
запас: запасе
слепота: слепота
исполнитель: исполнителя
доминантный: доминантным
главный: главную главная
расчёсывать: расчесывать
средний: средний
интуиция: интуицией
бонапарт: бонапарт
субпродукт: субпродуктами
якобы: якобы
удивляться: удивляйтесь
вакансия: вакансии
прямо: прямо
поводок: поводок
продукт: продукты
очарование: очарования
смекалистый: смекалист
уступать: уступающих
постоянно: постоянно
наш: нашу
достоинство: достоинства
простоватость: простоватость
выше: выше
потребоваться: потребуются
грыжа: грыжи
цениться: ценились ценится
палевый: палевый
ватный: ватные
вместе: вместе
чересчур: чересчур
столетие: столетия
простить: простит
аутоиммунный: аутоиммунный
конфликт: конфликту
дешёвый: дешевой
большинство: большинство большинства
спортсмен: спортсменов
практически: практически
рейтинг: рейтинг
ученик: ученики
купирование: купирование
действовать: действуют
смахивать: смахивают
производитель: производители
отдаваться: отдается
подписываться: подписывайтесь
последний: последнюю последнего
мопс: мопсу
шкафчик: шкафчиков
хвост: хвоста хвост
запретить: запрещено
брид-класс: брид-класса
очень: очень
сложный: сложная
площадка: площадку
обычно: обычно
куриный: куриная
походить: походят
жизнелюбие: жизнелюбием
харизматичный: харизматичных
манипулятор: манипулятор
задаться: задались
нагрузка: нагрузки
идеальный: идеальную
просить: просящие
отит: отитам
овчина: овчиной
разнообразный: разнообразных
избежать: избежать
круп: крупом
кличка: клички
частность: частности
готовиться: готовьтесь
лето: лето
скот: скот
дерево: дерева
касаться: касается
спортивный: спортивным
выставочный: выставочных
контактировать: контактировали
граница: границы
доброжелательный: доброжелательны
удалить: удалить
повторить: повторит
проходиться: проходятся
мясной: мясными
проект: проекте
сразу: сразу
александр: александр
отстёгивать: отстегивать
склонный: склонны
оживлённый: оживленным
кг: кг
тресковый: тресковых
среднее: среднего
линька: линька
затяжной: затяжной
сдержанный: сдержанны
рисовый: рисовую
туловище: туловище
целый: целый
низко: низко
вейтпуллинг: вейтпуллинга
грациозный: грациозны
прямой: прямой
ревнивый: ревнивы
погореть: погорело
играть: играет
довольный: довольный
мешать: мешая
кормление: кормления кормление
тренироваться: тренироваться
самокат: самокате
причём: причем
крайность: крайность
баловень: баловня
конус: конус
самый: самые
посиживать: посиживая
крючок: крючок
сваливаться: сваливающихся
раритет: раритетом
личный: личного
улитка: улитку
постараться: постарайтесь
загибаться: загибаясь
живой: живым
потрясать: потрясающим
комочек: комочков
неполный: неполный
максимальный: максимального
трансформироваться: трансформируется
бадов: бадов
некоторый: некоторым
сообразительность: сообразительности
дисциплина: дисциплинам
улучшение: улучшения
палочка: палочки
