туалет: туалет
иметь: имели имеете иметь имеющие
короткий: короткую короткая
заметить: заметили
товар: товар
суд: суд
колебаться: колеблется
кровь: крови
широко: широко
средний: средняя средние
козимый: козимо
ограничиваться: ограничивались
ныне: ныне
устать: устали уставших
движимый: движимого
четвероногий: четвероногих четвероногие четвероногий
активный: активные активное
ответственный: ответственные
сколько: сколько
отметина: отметинами
уэльс: уэльса
название: название названий названия
необузданный: необузданная
физический: физических физическую физические физической
ноздря: ноздри
обсуждение: обсуждения
рукавица: рукавицей
предпочтительный: предпочтительным
оно: оно
английский: английских английский
цена: цена
бульмастиф: бульмастиф
материал: материалов
природа: природы
удовольствие: удовольствием
упражнение: упражнениях упражнениям упражнения
артистический: артистические
принадлежать: принадлежат принадлежит
туманный: туманного
частый: частом чаще
признать: признал
владелец: владельцам владельца владельцев владельцы
поведение: поведения
натура: натуре
сторона: стороны
направлять: направляют
инстинкт: инстинкты
пятно: пятнами пятна пятен
пробежка: пробежки
город: городах городе
зато: зато
россия: россия
сбалансированный: сбалансированным
вред: вреда вред
обратный: обратная
богатый: богатых
длительный: длительные длительных
сотня: сотни
учёт: учетом
бьюик: бьюик
представитель: представителей представителям представителями представители
искать: искать
соответствовать: соответствует
появляться: появляются
шея: шея
сходить: сходил сходили
шерсть: шерсть
ласково: ласково
низкий: низкий низкая низких низком низкой
документ: документы документах документов
альтернатива: альтернативой
применять: применять
челюсть: челюсти
пятнистый: пятнистый пятнистые пятнистых пятнистой
неопытный: неопытным
самый: самая самый самое самые
воспитание: воспитания воспитание воспитании
далматин: далматинов далматина далматины далматин далматинам
должный: должны должно должных должна
сторожить: сторожили
сжечь: сожжет
янтарный: янтарный
взгляд: взгляд
препятствие: препятствий
класс: класса классу
энергия: энергию энергия энергии
чёрный: черные черная черного черным черными
человек: людям человеку человека человеком люди
питомец: питомцами питомец питомцы питомца
рождаться: рождаются
ушной: ушных
сформировать: сформированных
мы: нам
некоторый: некоторых некоторые
спустя: спустя
включая: включая
нога: ног ноги
важно: важно
сложено: сложено
бежать: бежать
итальянский: итальянскими
способность: способность
история: история историю истории
гипотиреоз: гипотиреоз
год: годами года лет год году
щенок: щенка щенков щенки щенком щенок щенку
полноценный: полноценную
парка: парке
владеть: владеет
бирмингем: бирмингеме
интересовать: интересующей
наш: наших
юный: юного
голова: голове голова
чувствовать: чувствуют чувствуя
семья: семьи семье семей
изобразить: изображены
братия: братии
характеристика: характеристика
выставка: выставках
помощь: помощью
физически: физически
соответствие: соответствии соответствия
коричневый: коричневая коричневым коричневыми коричневые
заводчик: заводчик заводчиков заводчики
около: около
зарождение: зарождения
яркий: яркой
индивидуальный: индивидуальных
коготь: когти когтей
погонщик: погонщики
тяга: тяга
подобный: подобной
значит: значит
выявить: выявить
появление: появление появления появлению
палец: пальцы
различный: различной различных
ольга: ольга
сужаться: сужается
основное: основном
видео: видео
обследование: обследования
незначительный: незначителен
ценный: ценного
антипин: антипина
стремиться: стремятся
полностью: полностью
очередь: очередь
никакой: никаких
улица: улицу
компания: компании
заключение: заключения
пёс: псы псов пес пса
домашний: домашних домашнего
тело: телу теле тело
каждый: каждой каждым каждый
расстаться: расстаться
свободолюбивый: свободолюбивый
незнакомец: незнакомцами
нехватка: нехватки
столетие: столетиям
нижний: нижнем нижние
флегматичный: флегматичной
перспектива: перспективой
собака: собаками собак собака собаках собаки
охотник: охотника охотникам
плечевой: плечевого
называть: называют называли
содержание: содержание содержания
девочка: девочка
нужный: нужны
представить: представлены
путешествие: путешествиях
немного: немного
сформулировать: сформулирован
хвост: хвосте хвост
архив: архивах
носить: носят
новгород: новгороде
составлять: составляет
жить: живет жить
узнавать: узнаваемым узнаваемая
реагировать: реагировать реагирует
эпоха: эпох эпоху
путь: путь пути
плам-пудинг: плам-пудинга
окрас: окраса окрас окрасом окрасу окрасов
световой: световых
достоверный: достоверные
ветеринар: ветеринару ветеринара
открыть: открыты
городской: городских городской
подчиняться: подчиняется
связь: связь
сваливаться: сваливается
беда: беда
приближаться: приближаются
переносить: переносит
точно: точно
клуб: клуб клубы
кондиция: кондиции
глазной: глазному
жизнерадостный: жизнерадостный
разрушительный: разрушительные
внешность: внешность внешности
какой: какому каких
далмации: далмации
длина: длине длиной
лошадь: лошадьми лошадей
изучение: изучение
условие: условием условиях условия
частный: частном частных частный
пока: пока
фон: фоне
стать: стали стать станет
новосибирск: новосибирске
маленький: маленький маленькими меньше
состояние: состоянии состоянием
официальный: официальный
гулять: гуляем гулять гуляет
экспонат: экспонатами
член: член членом
программа: программа
издали: издали
выставочный: выставочной
раз: разу
ветеринарный: ветеринарные ветеринарной
хорватия: хорватии хорватия
задать: заданный задаст
мир: мир миром
основный: основного основным
исторический: исторической
сменить: сменили
плотно: плотно
тёмный: темными
постоянный: постоянным постоянном
качество: качестве качество качества
смотреть: см смотрите
фотография: фотографии
помогать: помогает помогали
агрессивный: агрессивная агрессивны
расти: растут
уход: уходе ухода уход
знать: знать знают
чёткий: четкими
помнить: помните помнить
результат: результатов
яблоко: яблоку
уравновесить: уравновешенное
высокий: высокая высокого высокими
сирена: сирен
питомник: питомники питомниках питомников
лёгкий: легкими
выстраивание: выстраивание
глаз: глаза глаз
решать: решать
ранний: ранние ранняя
корм: корм корма кормов
часть: части частью
сиюминутный: сиюминутная
сказать: сказать сказали
век: века
экипаж: экипажам
существовать: существуют
затевать: затевают
брид: бридов брида
поскольку: поскольку
краткий: краткая
велосипедный: велосипедной
общий: общую общей
компаньон: компаньона
свой: своими свой своего своих своему
сильный: сильная сильной сильные
карапуз: карапузу
отношение: отношение отношений отношению
заболевание: заболеваниям заболевания
плотный: плотная
бабушка: бабушек
малыш: малышей малыш малышами
надёжно: надежно
край: края
заострог: заостроге
эксперт: экспертов
спрос: спрос
умный: умный умная
полоса: полосе
екатеринбург: екатеринбурге
затылочный: затылочной
вконтакте: вконтакте
свет: свет
версия: версии
любимец: любимцев любимца
тазобедренный: тазобедренных
обращение: обращения
хозяин: хозяин хозяина
проявлять: проявлять
мес: мес
животное: животных животным животного животные животное
один: одного одной одному
раковина: раковин
существование: существования существовании
одинаково: одинаково
пропорциональный: пропорциональна
сша: сша
привязываться: привязываются
чреватый: чревато
адекватно: адекватно
характер: характером характера характер
выбрать: выбрать
концентрация: концентрация
монопородный: монопородные
мнение: мнения
пс: пс
основать: основана
сустав: сустава суставов
расцветка: расцветке
хотя: хотя
х: х
серьёзный: серьезные
усилие: усилиями усилий
способствовать: способствуют
предоставлять: предоставляют
брать: брали
конюшня: конюшней
больший: большая наибольшая большие
существенно: существенно
подстраиваться: подстраиваются
утомительный: утомительного
проблема: проблемы проблема проблемой
свободно: свободно
сложный: сложного
приключение: приключений
берег: берегах
паралич: паралич
далматинец: далматинцы далматинца далматинец далматинцев
размер: размеры размера
официально: официально
информация: информация информацию
друг: друг друга
внедрение: внедрения
новелла: новелла
авторитет: авторитет
выбор: выбор
ниже: ниже
интеллект: интеллекте интеллект
площадка: площадках площадки
циркач: циркачи
ладить: ладят
заметный: заметные
созвучие: созвучие
польза: пользу пользы
ошибочный: ошибочного
хотеться: хотелось
дедушка: дедушек
старший: постарше
дом: дом дома доме
значительный: значительные
это: этим это
веко: веки
свиток: свитков
колено: колени
обильно: обильно
адриатический: адриатического
разведение: разведении разведение разведения
развитой: развитые
психологически: психологически
сайт: сайтах сайту
создать: создан
групповой: групповых
просто: просто
забывать: забывать
аллергия: аллергия аллергиям
предоставить: предоставили
мало: мало
карета: кареты
поездка: поездках поездки
ожирение: ожирением
тысяча: тысяч
принять: принято принятой
мучиться: мучаемся
угроза: угрозы
получить: получил
территория: территории
приводить: приводят
температура: температур
контакт: контакт
добавить: добавьте
хороший: лучший хороший
прогулка: прогулки прогулок
британец: британцы
я: мной
происхождение: происхождения
пожелать: пожелали
начаться: началось
необходимо: необходимо
поклон: поклонов
готовый: готовы готовых
первый: первые первых
выходец: выходцы
удлинённый: удлиненная
задний: задние
звоночек: звоночки
удовлетворять: удовлетворяя
редкий: реже
свидетельство: свидетельства
организация: организация
тщательно: тщательно
бульдог: бульдога
гладкий: гладкая
непонимание: непонимание
написать: написал
дрессировка: дрессировка
время: время времен временем
кисть: кисти
отряд: отряды
сука: суки
плохой: хуже
агрессивность: агрессивность
санта-мария: санта-мария
суровый: суровый
метаболизм: метаболизма
выносливый: выносливые
чистить: чистите
день: дней дня день
сохраниться: сохранившихся
необычный: необычные
другой: другие других другими
сводчатый: сводчатые сводчатыми
просмотр: просмотров просмотра
взрослый: взрослого
слух: слуха слухом
сопровождать: сопровождать сопровождали
светский: светских
приближение: приближении
пеннант: пеннант
например: например
несколько: несколько
своеобразный: своеобразным
личность: личность
рост: рост росте
ответ: ответа ответ
ежедневный: ежедневным
терьер: терьера терьеров
тушение: тушения
венецианский: венецианских
обладатель: обладатель
функция: функции
напоминать: напоминают
тёмно-коричневый: темно-коричневый
резко: резко
к: ко
реклама: реклама
соответственно: соответственно
найти: найдут найдено
просить: просят
церковь: церкви
линять: линяет линяют
необходимый: необходима необходимые
родственный: родственную
врождённый: врожденный
наклон: наклон
второй: второй
выраженный: выраженным
утро: утра
оказаться: оказавшись оказавшихся
рекомендоваться: рекомендуется
механизм: механизмов
важный: важнее важна важны
работа: работы
холодный: холодных
дружелюбный: дружелюбны дружелюбная
римско-католический: римско-католическая
правильно: правильно
харизматичный: харизматичные
незаметно: незаметно
добиться: добиться
процедура: процедур
свободный: свободного
родословная: родословной
особенность: особенностей особенности
остров: острове
лошинь: лошинь
мощный: мощная
понять: понять
назвать: назвал
число: числу
социальный: социального
социализация: социализация
паста: пастой
быть: будут
сгорание: сгорания
лишь: лишь
прилагать: прилагать
опытный: опытные
выводить: выводить
репутация: репутацией
пожарный: пожарных пожарные
треугольный: треугольной
потребность: потребностями потребности потребность
форум: форум форуме
внутренний: внутреннего
стоп: стопом
приглянуться: приглянувшимся
остеомиелит: остеомиелит
требовать: требуют
сила: сил силу
закруглить: закруглены
такой: такие такая такого
переставать: перестает
десяток: десятка
любитель: любители
пигментировать: пигментирована пигментированы
нулевой: нулевую
мужской: мужской
лично: лично
живой: живыми живой
небольшой: небольшом небольшими небольшим
объявление: объявлений объявления
описание: описание описаний
начало: начало
вакцина: вакцин
ящик: ящик
порывистый: порывистые
округлый: округлые
белый: белых белая белом
собачий: собачьих
длинный: длинный длинная
однако: однако
психика: психики
становиться: становится
поэтому: поэтому
случай: случаев случае
копирование: копирование
добрый: добрый
прекрасно: прекрасно
активность: активность активностью
удивительный: удивительную
талисман: талисманами
основание: основания основании
дружелюбность: дружелюбность
равный: равна
бридер: бридера
отзыв: отзывах отзывы
лошадиный: лошадиных
иммунитет: иммунитета
кошка: кошки
следовать: следует следовали
резкий: резкие
метрика: метрику
шум: шум
древнеегипетский: древнеегипетских
курортный: курортном
стандартный: стандартных стандартные
особь: особи
включить: включил
беспокоить: беспокоят
верхний: верхние
санкт-петербург: санкт-петербурге
подсказать: подскажите
книга: книгу
защищаться: защищаются
час: час
назад: назад
исследователь: исследователь исследователи
медийность: медийность
пожалуйста: пожалуйста
запрет: запреты
цвет: цвет цвета
мочь: могут
локоть: локти
минимум: минимум
уступать: уступая
порода: породы пород породу порода
профессиональный: профессионального
последствие: последствия
медленно: медленно
сделать: сделать сделали сделано
шалость: шалости
основной: основные
решение: решение
диснеевский: диснеевского
родитель: родителями родителя родителей
охранный: охранные
многие: многие
флоренция: флоренции
вес: вес
кечкемета: кечкеметы
выполнять: выполняют
конец: конец
петар: петара
недовольство: недовольство
широкий: широкая
медичи: медичи
сдерживание: сдерживания
голос: голос
ясный: ясный
жилища: жилищу
откладывать: откладывать
возможность: возможностью
сформироваться: сформировалась
планироваться: планируется
регистрироваться: регистрируются
именно: именно
отсутствовать: отсутствуют
обоснованный: обоснованно
фреска: фреске фресках
продолжительность: продолжительность
международный: международная
взаимодействие: взаимодействию
короче: короче
инстинктивно: инстинктивно
драка: драк
расположить: расположены
два: двумя
говорить: говорят говорит
конный: конным
следить: следите
остеохондроз: остеохондроз
озорной: озорной
улыбка: улыбку
зависимость: зависимости
непоседливый: непоседливую
принимать: принимать
здравствуйте: здравствуйте
уникальный: уникален
наследственный: наследственный
опасный: опасных опасным
исчерпывающий: исчерпывающую
фото: фото
питание: питание питании
десятилетие: десятилетий
ключ: ключ
вопрос: вопросов
крупный: крупного крупную крупные
яндекс: яндекс
стабильный: стабилен
взвесить: взвешенный
спокойный: спокойное
обожать: обожают
лениться: ленящихся
здоровый: здоров здоровым здоровые здоровой
участие: участие участию
подоплёка: подоплеки
известный: известной
победа: побед
быстроногий: быстроногих
барьер: барьеров
конкретный: конкретный
непростой: непростым
глухой: глухими
символ: символом
лапа: лапы лапу
ухо: ушах ушами уши
оценить: оценить
холка: холке
обязательный: обязательных обязательным
журнал: журнал
неделя: недели недель неделю
высота: высота высоту
выразить: выражено
создание: созданию создании
государство: государств
нуждаться: нуждаются нуждается
особый: особую
массовый: массового
определить: определить
внешний: внешним внешний
формирование: формированию формирования
уживаться: уживаются
покров: покров
вариант: вариантом варианты
болезнь: болезни
охранник: охранниками
вызвать: вызвать
экспресс: экспресс
ребро: ребрами
благородный: благородных
начинать: начинать начиная
правильный: правильная правильное
естественный: естественные естественной
кошачий: кошачьи
который: котором которая которых которым которые
овальный: овальной
простой: проще
прогуливаться: прогуливающихся
тяжесть: тяжести
увидеть: увидеть увидели
керн-терьер: керн-терьер
парадное: парадных
обнаружить: обнаружены
очевидный: очевидное
исследование: исследования
проявить: проявить
предать: преданного преданный
кобель: кобели
глухота: глухота
сдержать: сдержаны
движение: движения
появиться: появится появились
дело: дело
сбивать: сбивают
труд: труда
темп: темпе темп
являться: являются является
перейти: перейти
ваш: вашей вашего вашем
возникнуть: возникли
дворянин: дворян
сохранить: сохранила
из-за: из-за
регулярно: регулярно
продумать: продуманный
далмация: далмация
линька: линьку линька
менее: менее
игнорировать: игнорирует
папирусный: папирусных
религиозный: религиозных
наносить: нанося
причинить: причинить
тот: тех
особенный: особенным
тест: тестов теста
команда: командам команд команды команда
соизмерять: соизмеряйте соизмеряют
вместо: вместо
неподчинение: неподчинение
англичанин: англичане
слишком: слишком
невероятно: невероятно
вести: ведут
одиночество: одиночеству
томас: томас
музейный: музейными
альбион: альбиона
автомобильный: автомобильных
сзади: сзади
поесть: поел
стартовать: стартовать
морда: морда
статус: статуса
ксения: ксения
участник: участников
относиться: относятся
грудь: грудью
вольер: вольере
гетерохромия: гетерохромией
кучер: кучером
оценка: оценке
нагрузка: нагрузок нагрузками
зарегистрировать: зарегистрировала
рубль: рублей
пообщаться: пообщаться
айткеновый: айткенова
художник: художников
обученный: обученные
словесный: словесных
мочка: мочка
пойнтер: пойнтеров
внимание: внимание
шерстяной: шерстяной
варьироваться: варьируется
неуправляемый: неуправляемых неуправляемого неуправляемым
предполагать: предполагают
деструктивный: деструктивных деструктивного
столица: столице
аутоиммунный: аутоиммунные
прообраз: прообразом
стоимость: стоимость
поддерживать: поддерживать
особенно: особенно
остаться: останетесь
использовать: использовали
жёсткий: жесткая
гарантировать: гарантировать
предугадать: предугадать
строго: строго
последний: последние
хватить: хватило
быстрый: быстром
печень: печени
дать: дам дай
симметрично: симметрично
поклонник: поклонником
проблемный: проблемным
достаточно: достаточно
обязательно: обязательно
давний: давняя
понимать: понимает понимать
прилегать: прилегают
произведение: произведениях
обязать: обязан
ребёнок: ребенком детьми
москва: москве
перекрывать: перекрывают
мультфильм: мультфильма
возвращение: возвращении
обрести: обрели
популярность: популярность
пять: пять
управление: управления
поводок: поводке
форма: формы
содержаться: содержатся
несмотря: несмотря
насыщенность: насыщенность
купить: купить купили
часто: часто
помочь: помогите
поставить: поставлены
прямой: прямые прямой
компактный: компактные
допускаться: допускаются
джяково-осиековский: джяково-осиековская
минимальный: минимальным
добровольный: добровольные
спина: спина
упоминание: упоминание
просторный: просторный
прекрасный: прекрасного
кончик: кончики кончику
признак: признаком
крепкий: крепкой
искусство: искусства
корпус: корпусу корпус
обнаружиться: обнаружится
некстати: некстати
достаточный: достаточных достаточным достаточное
ссср: ссср
душа: душу
этот: этих
мирный: мирного
усвоить: усвоить
гипоаллергенный: гипоаллергенный
домочадец: домочадцев
пламя: пламени
непрерывно: непрерывно
крупа: круп
безупречный: безупречной
весь: всем
петровочкин: петровочкина
далеко: далеко
архиепархия: архиепархия
одноклассник: одноклассники
энергичный: энергичный энергичном энергичного
породистый: породистый породистую
гортань: гортани
доза: дозы
стаффордширский: стаффордширского
узнать: узнать
заставлять: заставляли
кристина: кристина
здоровье: здоровья здоровье
пройти: прошло пройти
скупой: скупых
продвигаться: продвигалось
защищать: защищают защищает
случайный: случайные
передний: передние
климатический: климатических
чётко: четко
кроме: кроме
удачный: удачному
неспецифический: неспецифические
среднее: среднем среднего
сегодня: сегодня
толща: толще
регентство: регентства
неизрасходованный: неизрасходованную
поиск: поиск
епископ: епископа
делать: делают делали
отдавать: отдают
плоский: плоская
привести: привело
зуб: зубы
вообще: вообще
занятие: занятиях
белые: белые
цепь: цепь
промах: промахи
помета: помета
тонкость: тонкости
андреас: андреаса
дичь: дичь
электродиагностический: электродиагностического
последовательный: последовательных
щётка: щеткой
дисплазия: дисплазии
мочевой: мочевом
попросту: попросту
корвуд: корвуд
монастырь: монастыре
нос: нос
стандарт: стандарту стандарт
кожный: кожным
вовсе: вовсе
элегантный: элегантные
доказательство: доказательства
жизнь: жизни жизнь
современный: современных
остальной: остальном
абсолютно: абсолютно
овчарка: овчарка
они: ними
общество: обществе общество
весить: весят
сильно: сильно
право: право
благодаря: благодаря
сигнализация: сигнализаций
море: моря
святой: святой
плечо: плечи
видеть: видит
впервые: впервые
влиять: влияющих
домосед: домоседов
обучение: обучение
супер-премиум: супер-премиум
нужно: нужно
мимимишность: мимимишности
также: также
корень: корни
дойти: дошедших
настроение: настроение
контур: контурами
мама: мама
идеальный: идеальным
момент: моменты
принести: принесли
белок: белок
граница: границе границы
францисканец: францисканцев
оборудовать: оборудованной
продолжать: продолжает
отсюда: отсюда
поясница: поясница
американский: американского
каретный: каретных
кинологический: кинологическая
кожа: кожи
ровный: ровная
дозволить: дозволенного
умеренно: умеренно
стоить: стоить стоит
тосканский: тосканских
изначально: изначально
служить: служили
ранее: ранее
агрессия: агрессию
подходить: подходят
сложно: сложно
складка: складки
гарантия: гарантий
шубка: шубка
область: области
тёплый: теплых
разный: разных
мелкий: мелкую
вельможа: вельможи
эпилепсия: эпилепсия
заря: заре
приобретение: приобретению
ножницеобразный: ножницеобразный
больной: больные
бакич: бакича
квартира: квартиры
исходить: исходя
расчистить: расчистить
допустить: допустил
участок: участком участке
смочь: сможет
любить: любят
невозможно: невозможно
имущество: имущества
вымереть: вымерли
портрет: портретах
ген: генах
тренировка: тренировка
кавалер-кинг-чарльз-спаниель: кавалер-кинг-чарльз-спаниель
бостон-терьер: бостон-терьера
полный: полное
легко: легко
многий: многих
уточнить: уточнить
диванный: диванной
свежеть: свежей
лента: ленту
выгул: выгула
рисунок: рисунок
утвердить: утвердил
премиум: премиум
детство: детстве
сочетание: сочетании
глубокий: глубокой
кардиомиопатия: кардиомиопатия
интенсивно: интенсивно
новый: новый
укус: укусами
кроха: крохам
британия: британии
половина: половине
положить: положенные
амплуа: амплуа
месяц: месяцев
атлетичный: атлетичные
расчёсывать: расчесывать
ркф: ркф
переедание: переедание
вакансия: вакансии
камень: камни
тридцать: тридцать
сигнал: сигналов
прикус: прикус
знакомство: знакомство
теоретический: теоретические
встречаться: встречается встречаются
глупый: глуп
постоянно: постоянно
понятие: понятия
вроде: вроде
выше: выше
определение: определение
долгий: долгий
реальный: реальных
обойтись: обойтись
регион: регионах
большинство: большинстве
вместе: вместе
течение: течение
патология: патологий
громкий: громких
публика: публики
успевать: успевают
оповещение: оповещением
главный: главная
практически: практически
сознательно: сознательно
рейтинг: рейтинг
натуралист: натуралист
скорость: скорости
треть: трети
судить: судить
синопсис: синопсис
подписываться: подписывайтесь
незамеченный: незамеченными
океан: океаном
кинолог: кинологом
прижать: прижаты
специфичный: специфичных
расстояние: расстояния
запретить: запрещено
очень: очень
немало: немало
бок: бокам
эффективный: эффективное
борец: борцов
твёрдый: твердый
умение: умение
двигатель: двигателей
огородить: огороженном огороженным
пузырь: пузыре
визит: визиты
паспорт: паспорта
мытьё: мытье
огонь: огнем
глянцевый: глянцевая
швейцарский: швейцарская
происходить: происходит
специальный: специальной
кличка: клички
правило: правила
довольно: довольно
частность: частности
алтарь: алтаря
касаться: касается
закрепиться: закрепилось
предок: предком
ошибка: ошибок
проект: проекте
сразу: сразу
склонный: склонны
недопустимо: недопустимо
медицинский: медицинские
приложить: приложили
пора: пор
кг: кг
полгода: полгода
бультерьер: бультерьера
вычсывание: вычсывание
стрижка: стрижке
идти: идти
двигаться: двигаясь
действительно: действительно
страна: страна
иной: иных
играть: играет
причём: причем
мария: марии
обычный: обычное
ситуация: ситуации
подходящий: подходящим
дилатационный: дилатационная
недостаток: недостаток
конечность: конечности
превращаться: превращаются
телохранитель: телохранителями
переворот: переворотов
оба: оба
всего-навсего: всего-навсего
хроника: хроники
губа: губы
сезон: сезонов
сон: сне
подросток: подростками
жюри: жюри
влиятельный: влиятельные
мускулистый: мускулистые
способный: способны
роспись: росписи
наказание: наказанием
