овощ: овощи
сделать: сделан сделать сделавшей сделано
использовать: используя использует использовать
необычайный: необычайным
тело: тела тело
колебаться: колеблется
американский: американских американский американского
мраморность: мраморность
популярность: популярности популярность
средний: средняя среднее средней средним
фу: фу
задом: задом
агрессия: агрессия агрессии агрессию агрессией
активный: активные активная активными активное
следить: следить следите
указание: указаний
красный: красный красных
использоваться: используются
сколько: сколько
отметина: отметинами
уходить: уходит
уметь: умеют
колтун: колтунов
центр: центра центры
название: название названия
собака: собаку собаками собакой собак собака собакам собаке собаки
вывести: вывести выведена вывели
состоять: состоит
расположить: расположена расположены
заранее: заранее
физический: физических физической
прикус: прикусе прикус
обсуждение: обсуждения
оставаться: оставаться остаются
мраморно-голубой: мраморно-голубой мраморно-голубых мраморно-голубого
цена: цена цене
рыба: рыбу рыба
зачастую: зачастую
кадр: кадры
мальчик: мальчик
пятый: пятые
содержаться: содержится
подушечка: подушечки подушечками
материал: материалов
вкрапление: вкрапления вкраплениями
природа: природы
удовольствие: удовольствием
зритель: зрителей
быть: будучи е буду будут будь
желание: желанию желание
казаться: кажется
слух: слух слуха
спиртной: спиртные
упражнение: упражнениях
обратить: обратите
насчитывать: насчитывает
поведение: поведения поведением
сислер: сислером
резец: резцов
передний: передняя передние передних
натура: натуре
пастуший: пастушьих пастушья пастушьими пастушью
овальный: овальную овальные
качество: качествами качеств качестве качества
стоять: стоят
сторона: стороны стороне
щтка: щткой
дисквалифицировать: дисквалифицирующие дисквалифицирующими дисквалифицирующим
положительный: положительных
пробежка: пробежки
россия: россия россии
живот: живот
протирание: протирание протирания
обладатель: обладателям
обратный: обратная
занятие: занятиям занятий
америка: америки америка
лгкость: лгкостью
начало: началом начало
размер: размеров размерах размеры
радужка: радужки
вышеописанный: вышеописанного
представитель: представителей представители
соответствовать: соответствует соответствующая
шея: шея
немногий: немногих
овчарка: овчарки овчарок овчарке овчарку овчарками овчарка
интенсивный: интенсивное
закругление: закруглением
короткий: короткого коротким короткий короткие короткой
разучивание: разучивании
дальнейший: дальнейшее
компаньон: компаньоны компаньоном
шерсть: шерсть шерсти шерстью
поверхность: поверхности поверхностях
проекция: проекции
доминантный: доминантный
выразить: выражены
закапать: закапать
один: одним одного одна одними одной одном
челюсть: челюсти
сын: сыновьями
значимый: значимым
небольшой: небольшого небольших небольшой
зарегистрировать: зарегистрирован зарегистрированным зарегистрировано
должный: должны должен должно должна должном
основополагающий: основополагающим
австралия: австралию австралии австралия
говядина: говядина
янтарный: янтарный
взгляд: взгляд взгляде
препятствие: препятствий
говорящий: говорящее
относиться: относится относятся
месяц: месяц месяца месяцев
ушной: ушных ушные
темнеть: темнеет
мы: нам
участок: участки участков участке
некоторый: некоторых некоторая
равно: равно
отличаться: отличается отличаются
местный: местных
выраженный: выражен выраженным
путм: путм
важно: важно
упругий: упругие упругими
различный: различный различными различных
рис: рис
лихва: лихвой
способность: способность способностями
центральный: центральной
травма: травмы
история: история
симпатичный: симпатичного симпатичным
хороший: хорошего хорошим хорошие лучший хорошем хорошее
выполнение: выполнение выполнения
щенок: щенка щенков щенки щенок щенку
растительный: растительными
пространство: пространстве
белок: белка
момент: моменту моменты момент
миловидный: миловидной
выпячивания: выпячиваний
поощрительно-мотивационный: поощрительно-мотивационный
землть: землй
пастух: пастухи пастуха пастух
особый: особое
создиться: создатся
семья: семьи
дожидаться: дожидаясь
робость: робостью робости
братия: братии
шерстяной: шерстяного шерстяной
ширина: ширине
характеристика: характеристика
стоп: стоп
выставка: выставках выставки
чрный: чрный чрных чрного
пообщаться: пообщайтесь
уинтон: уинтон
около: около
гармоничный: гармоничное
следующий: следующие следующего
определиться: определившись определиться
навык: навыков
лгкий: лгкой
публика: публику
скалера: скалер
неправильный: неправильном неправильный
коготь: когти
образоваться: образующейся
порода: породе породам породы пород породу порода
фурацилин: фурацилина
значит: значит
отнюдь: отнюдь
орган: органами органов
развитой: развито развиты развитую
спина: спине спины спина
появление: появление появления
палец: пальцы пальцами
популяризация: популяризации
быстро: быстро
вклад: вклад
первый: первой первые первым первая первых
сужаться: сужается
отдел: отделы
территория: территория территорию территории
еда: еду еде
незнакомец: незнакомца
раз: раза
видео: видео
помимо: помимо
обследование: обследования
хуанит: хуанита хуаниты
лакомка: лакомки
обязать: обязаны
течка: течка
съмкаха: съмках
веселиться: веселиться
полностью: полностью
единый: единому
кошка: кошка кошкой кошки кошек
условие: условии условий условиях условия
недружелюбный: недружелюбного
компания: компании компания
скотовод: скотоводов
домашний: домашних домашний домашними домашнему
способный: способно способна
панда: панда
распространнный: распространнным распространнных
площадь: площадь
такой: таких такая такого таким
участвовать: участвовали
лохматик: лохматик
мышечный: мышечной
локтевой: локтевого локтевой локтевых
перпендикуляр: перпендикуляр
робкий: робкое робкой
вечер: вечер
косточка: косточками косточек
коленный: коленные
называть: называют называемые
содержание: содержание содержании содержания
девочка: девочка
присутствовать: присутствовать
сера: серы
представить: представлены
немного: немного
допускать: допускать допускает
попытка: попытки
регистрация: регистрация
вероятность: вероятностью
приспособление: приспособлений
родоначальница: родоначальницы
составлять: составляет
рекомендовать: рекомендуют
холка: холки холке холкой
пиренейский: пиренейской
окрас: окраса окрас окрасы
контакт: контактам
отклонение: отклонениям отклонения
кстати: кстати
связь: связь
национальный: национальной
приподниматься: приподнимаются
соревнование: соревнованиях
уделять: уделять
сислера: сислеру сислер сислера
приближаться: приближаются
покрыть: покрыты
тайгера: тайгерами тайгеры
превышать: превышать превышает
угол: углом угол
бедренный: бедренной
возвращать: возвращать
скотогонный: скотогонную
убедиться: убедиться убедитесь
внешность: внешность внешности
добавить: добавить добавьте
посадить: посажена посажены
настороженность: настороженность настороженности
правильный: правильную правильного правильном
владелец: владельцев владельцу
длина: длине длины длиной длина длину
предрасположенный: предрасположены
недостаток: недостатком недостаткам недостатками
отвар: отвары отвара
частный: частном
пока: пока
стать: стали стать станет
оба: обе
полный: полная полной полным
полвека: полувека
воздух: воздух
восток: востоке
меринос: мериносов
яйцо: яйца
самочувствие: самочувствия
утрата: утрата
треугольный: треугольную
защита: защите
год: годах года лет год году
дважды: дважды
давать: давать
двигательный: двигательная
потрясти: потрясти
мир: мир
восхищение: восхищение
изогнутый: изогнуты изогнутыми изогнутые
основный: основного
обувь: обувь
протирать: протирать
завезти: завезли
подрезать: подрезают
кинолог: кинолога
заниматься: заниматься занимаясь
искусственный: искусственных
старший: старше
мебель: мебель
изучение: изучения изучению
запрещаться: запрещается
приземистый: приземистой
питомец: питомцу питомцам питомца питомцем
бывать: бывают
смотреть: см смотрите смотреть смотрит
клещеобразный: клещеобразный
друг: друзья друг другом друга другу
пример: примере
фотография: фотографии
инструмент: инструмент
мерль: мерль
препарат: препаратов
работать: работать
собирать: собирать
уход: уходе уход
олергик: олергиком
смотреться: смотрятся
хотеть: хотим хочу
голубой: голубой голубыми
чтко: чтко
корма: корме
овцеводство: овцеводство
изящный: изящнее
оститься: остатся
опорно-двигательный: опорно-двигательного
срединный: срединное
климат: климат климата
высокий: высокая высокое
питомник: питомники питомников питомнике
верхний: верхней
пара: пары
находиться: находиться находится находятся
прародитель: прародители
взрослый: взрослой взрослого
глаз: глаза глаз глазами
самый: самый самых
закрепление: закрепления
поведенческий: поведенческим поведенческие
наказывать: наказывать
приобрести: приобретя приобрести приобрели
корм: корм кормами
имя: именем
самостоятельный: самостоятельной самостоятельные
часть: части часть
неприхотливый: неприхотливы
профилактика: профилактики
поинта: поинты
век: века
форма: форме форму
малыш: малышу малыша
существовать: существуют существовал
остальной: остальными остальные
буквально: буквально
прогулка: прогулка прогулки прогулках прогулок
обожать: обожает
фильм: фильмов
сменяться: сменяется
поскольку: поскольку
прочий: прочие
закон: законами
покупать: покупать
формула: формула
увеличение: увеличения увеличением
краткий: краткая
весьма: весьма
велосипедный: велосипедной
привозить: привозили
язык: язык
долгий: долгое
свой: своими своим свой своего своей свои
упор: упор
сухой: сухом сухой
отношение: отношение отношению
место: место месту
прохладный: прохладное прохладным прохладнее
неповторимость: неповторимостью
масса: массы
весь: весь всей
сородич: сородичей сородичами
яичко: яички
эксперт: экспертов эксперты
купать: купать
кефир: кефиром
умный: умный умная
полоса: полосе
затылочный: затылочной
стремиться: стремясь стремиться
вконтакте: вконтакте
просмотр: просмотр просмотров
рядом: рядом
впечатление: впечатление
наклонить: наклонены
версия: версии версия
двигаться: двигаются движется
далее: далее
сочетание: сочетание сочетания
дать: дать дайте дал
тазобедренный: тазобедренных тазобедренного
разведение: разведением разведения
лас-рокос: лас-рокоса
проявлять: проявлять проявляемые
хозяин: хозяин хозяином хозяевами хозяину хозяина
средство: средств
кожа: коже кожей
развитие: развитие развития
животное: животных животным животного животными животные животное
сырой: сырую сырые
раковина: раковин
мяч: мячом
испытывать: испытывая
занимать: занимает
получить: получен получить
пропорциональный: пропорциональна
выставочный: выставочная
сша: сша
общий: общий общие общей
договориться: договориться
земля: земле
выбрать: выбрать
обладательница: обладательница
облик: облик
городской: городскому городской
недокуса: недокуса
основать: основана основало
допустить: допустим
чёрный: черного черными
сустав: сустава суставы сустав суставами суставов
хотя: хотя
нижний: нижняя нижней
густой: густым
мраморный: мраморного мраморный
стачиваться: стачиваются
население: населения
обучать: обучаемая обучаемы
келпи: келпи
менять: менять
свый: свом
хвост: хвостом хвоста хвост
жареный: жареную
нанять: нанят
обрамление: обрамлении
искать: искали ищу
описать: описать
проблема: проблемы проблемам проблема
плотность: плотности плотность
квартира: квартире квартиры
официально: официально
известный: известны известной известным
влажный: влажным
информация: информация
обладать: обладает обладало обладающие обладающей
сообразительный: сообразительная
подходить: подходит
рабочий: рабочими
элементарный: элементарные элементарных
зуб: зуба зубьями зубы зубов
любой: любую любые любом
проводить: проводить
клуб: клуба
негативно: негативно
выбор: выбор выбору
стадо: стадом
участник: участником
родитель: родители
красавец: красавца
крепкий: крепкие крепкий крепкая
джей: джей джеем джея
вплоть: вплоть
зенненхунд: зенненхунда
неполный: неполная
шортить: шорти
кончик: кончик кончиками
сравнительно: сравнительно
голубоватый: голубоватого
среди: среди
число: число
объяснить: объяснить
наказываться: наказываться
лапа: лапах лапы лап
старый: старыми
признание: признанием
категорически: категорически
линия: линию линиям линия линией
это: этим это
вскоре: вскоре
настроение: настроении настроения настроение
новый: новых новому
считаться: считается считаются
длинный: длинные длинный длинной
загривок: загривке
мраморно-красный: мраморно-красный мраморно-красных
подвижный: подвижных подвижная
просто: просто
забывать: забывать
аллергия: аллергия
пройтись: пройтись
австралийский: австралийских австралийскую австралийский австралийского австралийская австралийской австралийские
размашистость: размашистость
натуральный: натуральным натуральной
призвать: призваны
верх: верха
расположение: расположением расположение
одиночество: одиночестве одиночеству
сомнение: сомнениям
частый: частые чаще
ваш: вашим
повторение: повторений
собираться: собираетесь
соболиный: соболиный
хартнэглый: хартнэглы
тысяча: тысяч
разучивать: разучивая
тонкокостность: тонкокостность
дискомфорт: дискомфорта
удаляться: удаляются
вперд: вперд
фрукт: фрукты
устраиваться: устраивались
зрительный: зрительного
провести: проведены
западный: западных
темперамент: темпераменту
лекарственный: лекарственных
который: которое которыми которой котором которая которых которые который
вскармливание: вскармливании
лающий: лающей
мотивация: мотивация
определнный: определнная
поход: походах
умеренный: умеренная умеренной
происхождение: происхождения
заболевание: заболевания заболеваний
точка: точка
различие: различиями
начаться: началось начаться
необходимо: необходимо
песенка: песенки
мм: мм
малый: меньшее
задний: задние задних задней
переносица: переносице
кобель: кобеля кобели кобелей кобелями
разрез: разрез
дрессировка: дрессировка дрессировке дрессировки
предплечье: предплечья
время: время времени
развлекать: развлекал
ватный: ватными ватные
знаменитый: знаменитой знаменитых
сука: суки сук
толстый: толстыми
прямой: прямым прямую прямой
агрессивность: агрессивность
варьироваться: варьироваться
таков: таковы
смена: сменой
слово: слову слова
полость: полость
день: дней днями день
оборудовать: оборудовав
противный: противном
пясть: пясти
скрещивание: скрещивание скрещивания
другой: другие другими
параллельно: параллельно
вылиться: выльется
сопровождать: сопровождать
отработать: отработано
речной: речную
кэмпбелл-тауна: кэмпбелл-тауна
мера: мере
несколько: несколько нескольких
сетчатка: сетчатки
родина: родиной
рост: рост
хуанита: хуанитой
касательно: касательно
сведт: сведт
рождаться: рождается
высококачественный: высококачественной
согласно: согласно
гриб: грибы
грациозный: грациознее
выходка: выходками
боковой: боковых боковое
напоминать: напоминают
процедура: процедурой процедуры
поилка: поилку
к: ко
реклама: реклама
плоский: плоский плоские
заводчик: заводчиком заводчиков заводчики
австралиец: австралиец австралийцев
привезнный: привезнных
подшрстка: подшрстка
партия: партией
использование: использованием
выступать: выступая
волосяной: волосяной
улыбаться: улыбаться
необходимый: необходима
высыпание: высыпания
семейство: семейство
талантливый: талантливая
незначительный: незначительным
приобретнный: приобретнные приобретнных приобретнная
зоошампунь: зоошампуни
выносливость: выносливостью
рекомендоваться: рекомендуется
мочка: мочки мочка
спокойно: спокойно
воспитание: воспитание воспитании
черта: черту
юниорский: юниорская
диск: дисками диски
поддаваться: поддающаяся
достигать: достигает
компенсировать: компенсируют
грубость: грубость
работа: работы
повредить: повредить
курица: курица
последовать: последовавший
дружелюбный: дружелюбны дружелюбные дружелюбная
связать: связана связано
признаваться: признаются
влиять: влияют
шесть: шести
правильно: правильно
зеленоватый: зеленоватый
стабби: стабби
красота: красотой
экстренный: экстренной
поддержание: поддержания
сайт: сайту
решение: решения решение
присматривать: присматривать
черепной: черепной
стоматологический: стоматологический
волнистый: волнистой
конусовидный: конусовидная
нежели: нежели
вычсывания: вычсывании
позволять: позволяет
занять: занять
конечность: конечностями конечностей конечности
пища: пищей пищу
крупный: крупная крупными
чайный: чайной
отпор: отпор
этот: эта этому этих
состязание: состязаний
лишь: лишь
вариант: вариант варианта
напролт: напролт
долго: долго
недавно: недавно
рбра: рбра
форум: форум форуме
заметить: заметить
соколов: соколов
газировать: газированные
ускорять: ускоряет
конец: конце конец
голова: головой голова
протяжение: протяжении
гладкий: гладкой
плечевой: плечевая
атрофия: атрофии
раствор: раствор раствора растворов раствором
купироваться: купируются
положение: положение
член: членам
кость: кость кости костью
пигментировать: пигментирована
выразительный: выразительный
ровный: ровные
описание: описание
игра: игр игры
лай: лая
оценивать: оценивать
грунт: грунту
миттельшнауцер: миттельшнауцер
геном: геном
стандарт: стандартом стандарта стандарт
гибкий: гибкого
скрестить: скрестили
изгиб: изгиба изгиб
параллельный: параллельна параллельны
шотландия: шотландии
налта: налта
ланцов: ланцова
лопатка: лопатки лопатке
здоровье: здоровьем здоровье
мускулатура: мускулатура мускулатуру
белый: белых
найти: найти
стоячий: стоячие
глубоко: глубоко
однако: однако
искренне: искренне
германия: германии
играть: играть играют
перенести: перенести
поэтому: поэтому
приступать: приступайте
коричневый: коричневый коричневого
копирование: копирование
добрый: добрый
прекрасно: прекрасно
активность: активность активности
подверженный: подвержены
основание: основания основанием
дружелюбность: дружелюбность
расцветка: расцветками
равный: равна
попасть: попали
направление: направление
отзыв: отзывах отзывы
поколение: поколениями
переходить: переходить переходя переходят
смышлный: смышлным смышлного
ротовой: ротовую
следовать: следует
очаровательный: очаровательный
комплект: комплектом
отсутствие: отсутствии отсутствие
оценка: оценки оценке
шум: шум
окантовка: окантовка
висячий: висячие
пабтс: пабтс
поймать: поймала
особь: особи особей
пульпа: пульпу
переломить: переломлен
уровень: уровня
сквозняк: сквозняков
перекус: перекуса перекус
чистый: чистая
показать: покажет
одарнный: одарнные
подсказать: подскажите
погрызать: погрызанные
допустимый: допустимо
придться: придтся
гулять: гуляют гуляет
настоятельно: настоятельно
наслаждаться: наслаждаются
назад: назад
лето: летом
гиперответственный: гиперответственны
цвет: цвет цвета цветом цветов
фермер: фермеров фермеры
решить: решили
сеттер: сеттер
дом: дома доме
мочь: могут
посетить: посетите посетить
форлонг: форлонгами форлонг
округлый: округлый
пасть: пал
заполучить: заполучить
хватать: хватает
любитель: любителя
творог: творог
объявление: объявления
отдельный: отдельное
угроза: угрозе
хвостик: хвостиком
основной: основные основной
вода: вода
молоко: молоке
интеллект: интеллект интеллекта
охранный: охранные
многие: многие
парод: парода
вес: вес
баджер: баджер
вуд: вуд
джа: джею
овсянка: овсянка
поразить: поразившую
перо: перья
суммарный: суммарная
широкий: широкая
быстрота: быстротой
чемпион: чемпионов
тиреоидит: тиреоидит
ежедневно: ежедневно
понадобиться: понадобится
нос: носа нос
тридцатый: тридцатых
подтвержднный: подтвержднная
бег: бега
немецкий: немецкими
причина: причине причины
йод: йодом
именно: именно
обрасти: обрастет
миндалевидный: миндалевидный
энергия: энергия
улица: улице
отсутствовать: отсутствуют
сутки: сутками суток
добродушный: добродушный
продолжительность: продолжительность
диван: диване
курс: курс
дружелюбие: дружелюбием
полустоячий: полустоячие
жизнерадостный: жизнерадостная
совет: советам
страна: страны страна
ранка: ранку
прибор: приборов
овал: овал
короче: короче
окончательный: окончательное
варный: варные
два: двумя двух
графитовый: графитовый
гендерный: гендерными
зависимость: зависимости
прирожднный: прирожднными прирожднные
результат: результате
подход: подход
разделять: разделяющий
вокруг: вокруг
дерматит: дерматита
перепелиный: перепелиных перепелиные
никак: никак
принимать: принимать
помощь: помощи помощь
слегка: слегка
огромный: огромный
здравствуйте: здравствуйте
вывозить: вывозила
ожидание: ожидания
артист: артистов
южный: южном
фото: фото
предпринимать: предпринимали
фактически: фактически
выделяться: выделяются
игрушка: игрушек игрушку
готовый: готов
яндекс: яндекс
сдавать: сдавать
ротвейлер: ротвейлер
количество: количество количеств
целый: целыми
цитрусовый: цитрусовые
трана: трану
участие: участие участия
усталость: усталости
оптимизм: оптимизм
мэйвуд: мэйвуд
череп: черепа череп
ухо: уха уши
помнить: помнить
сравнение: сравнении
нетипичный: нетипичный
пригласить: пригласила
неиссякаемый: неиссякаемый
официальный: официальной официальных официальным
премиум-класс: премиум-класса
журнал: журнал
четыре: четыре
тщательный: тщательном
семьть: семьй
высота: высота
отвечать: отвечающим
приготовиться: приготовьтесь
безопасность: безопасность
кличка: кличке клички
нынешний: нынешний
ось: оси осью
грива: грива
вилять: вилять
морковь: морковь
градус: градусов
нуждаться: нуждаются нуждается
возлежать: возлежать
подвергаться: подвергалась
обработать: обработать
тот: та тех тому
образование: образование
обычный: обычной
покров: покров
вакцинация: вакцинацию
дистрофия: дистрофия
агрессивный: агрессивное
болезнь: болезни болезнь
золотистый: золотистый
охранник: охранниками
избыточно: избыточно
косо: косо
сэкономить: сэкономить
думать: думать
пугливый: пугливой
четвероногий: четвероногим четвероногого
ребёнок: детей
модный: модный
фактор: факторах
грыжевый: грыжевых
начинать: начинать
штат: штатах
напиток: напитки
неопустить: неопущенные
какой: какие
нерв: нерв нерва
манера: манеру манера
свежий: свежим
тяжесть: тяжести
излишество: излишеств
бордер-колли: бордер-колли
внимательно: внимательно
норма: норме
олергенный: олергенна
рельеф: рельефом
перпендикулярный: перпендикулярны
наклонный: наклонный
селекция: селекции
овца: овец
сам: сама
шоколад: шоколад
рассматривать: рассматривать
спб: спб
остаться: осталось
присущий: присуща присущих
короткость: короткости
кофе: кофе
корпус: корпуса корпусу корпус
заключение: заключение
трава: трав траве
перерыв: перерывах
движение: движения
камень: камней
общество: обществом
заядлый: заядлым заядлого
взросление: взросления
снижение: снижением
плюшевый: плюшевую
регистратура: регистратуры
жирный: жирное
хомяк: хомяком хомяк
перейти: перейти
трудоголик: трудоголик
посвятить: посвятили
побегать: побегает
из-за: из-за
быстрый: быстрее
загородный: загородного
тасмания: тасмании
график: графику
больший: большей
когтерез: когтерезом
пах: паху
собранный: собранными
прохожий: прохожих
достигнуть: достигло
скакательный: скакательными скакательных
менее: менее
вопрос: вопросе
бешенство: бешенство
подходящий: подходящего
грудь: груди грудь
цель: целью
круг: круг
цепь: цепи
корень: корнями
слишком: слишком
медицинский: медицинских
будущее: будущего
флинтридж: флинтридж
никто: никто
аусся: аусси
мордочка: мордочка
рекомендация: рекомендациям
сзади: сзади
компактный: компактны
мелкий: мелкие
умалять: умаляет
морда: морда
отвлекать: отвлекало отвлекающих
выпукло: выпукло
метод: методом
спинка: спинке
производство: производства
вольер: вольере
мускулистый: мускулистая
зимний: зимнее
проветриваться: проветриваться
важный: важных важный
состояться: состоялась
рубль: рублей
хозяйка: хозяйка
разный: разным
обводка: обводку
несение: несения
шпатель: шпатель
обогатить: обогатить
команда: команд команды команда
значительный: значительную значительной
неплохо: неплохо
инструктор-кинолог: инструктора-кинолога
перпендикулярно: перпендикулярно
мутация: мутацию
правило: правило правила
полудлинный: полудлинной
внимание: внимание внимании
наличие: наличии наличие
наджный: наджные
мягкий: мягкого мягкому
риск: риска риску
глубокий: глубокая
иметь: имеет иметь имеют
аутоиммунный: аутоиммунные
стоимость: стоимость
осмотреть: осмотрите
иначе: иначе
особенно: особенно
ген: гена
желательно: желательно
стойка: стойке
замкнутый: замкнутом
анастасия: анастасия
час: часов
произойдт: произойдт
нравиться: нравится
металлический: металлической
достаточно: достаточно
ответ: ответов ответ
лайм: лайма
рыжий: рыжими
подшрсток: подшрстком
андреев: андреев
ферма: ферму
редко: редко
мошонка: мошонку
зрение: зрение зрения
достойный: достойный
неделя: неделю
индейка: индейка
специальный: специальные специальных специальным
чрезмерный: чрезмерной
сопровождаться: сопровождается
обстановка: обстановку
пять: пять
список: списке
пасти: пасет
признать: признаны
несмотря: несмотря
купить: купить купленных купите
часто: часто
лакомствапоощрение: лакомствапоощрения
помощник: помощника
предел: пределах
компактно: компактно
завести: завести
вытянуто: вытянуто
поставить: поставьте
период: периоды период
бульдог: бульдог
случай: случаях случае
юношеский: юношеской
выбирать: выбирать
паразит: паразитов
поощрять: поощряйте
яблоко: яблоки
лоб: лоб
здоровый: здоровый
превзойти: превзошедшей
поощрение: поощрение
закруглнный: закруглнными
ромашка: ромашки
гречка: гречка
нежелательно: нежелательно
тест: тест
толстой: толстой
редкий: редкими
бугор: бугра
крупа: круп
вызывать: вызывавшие вызывают
понять: поняла
ребнкома: ребнком
патология: патологии
далеко: далеко
трусость: трусость
стопа: стопы
холод: холода
современный: современную
ум: ума
одноклассник: одноклассники
элиза: элизы
славиться: славится
вс: вс
прислать: пришли
узнать: узнать узнайте
прибыть: прибыл
дисплазия: дисплазия дисплазии
близкие: близким
случайный: случайные
упомянуть: упомянутых
ведт: ведт
наблюдаться: наблюдается
мясо: мясо
осознавать: осознавать
простой: простые
позволить: позволит
трубчатый: трубчатые
любопытство: любопытство
невыносимый: невыносимо
чувство: чувство
продукция: продукцию
воротник: воротник
пользоваться: пользуясь
предать: преданные
поиск: поиск
наклон: наклона
онкологический: онкологические
идеальный: идеальный идеального
парка: парку
хандра: хандры
питание: питании
понравиться: понравилась
характер: характер
неудачный: неудачные
себя: собой
образовать: образует
белые: белые
специализироваться: специализирующиеся
появиться: появилась
купировать: купированный
окончательно: окончательно
слушать: слушаем
свобода: свободой
написать: написаны
плотоядный: плотоядных
общение: общении
орех: орехи
тигровый: тигровый
разнообразный: разнообразными
потребность: потребность
периодически: периодически
смотритель: смотрителем
порок: пороки пороками
плечо: плечах
недокус: недокус
остевой: остевой
задираться: задирается
линька: линьки линька
три: тремя
жизнь: жизни
нежирный: нежирная
они: ними
развлечение: развлечения
смешанный: смешанный
едва: едва
сосуд: сосуды
способствовать: способствовало
неутомимый: неутомимым
дело: дела
постоянный: постоянном постоянное
вид: виде вид
главенствовать: главенствующее
длительный: длительных
впервые: впервые
туристический: туристических
группа: группы
находить: находят
минутный: минутных
адаптироваться: адаптироваться
хартнэгла: хартнэглами
шоу: шоу
нужно: нужно
мимимишность: мимимишности
слепота: слепоты
кули: кули
также: также
обзаведтесь: обзаведтесь
обосноваться: обосновалась
кусаться: кусается
достаточный: достаточной
помочь: поможет
косолапость: косолапости
эли: эли
возможно: возможно
генетический: генетического
конфета: конфеты
родео: родео
двадцать: двадцати
окраска: окраске
сбалансированный: сбалансированными
считать: считать
лежанка: лежанкой
вволю: вволю
неопытный: неопытный
гудеть: гуди
похожий: похож похожий
исключительный: исключительными
умеренно: умеренно
каша: каша
скот: скоту
отар: отарами
муж: мужем
впоследствии: впоследствии
крипторхизм: крипторхизм
ужиться: ужиться
область: области
пуходрка: пуходркой
стоить: стоит
завоевать: завоевали
естественно: естественно
естественный: естественной естественным
эпилепсия: эпилепсия
падать: падать
прибылой: прибылые
ножницеобразный: ножницеобразный
право: правах
рецессивный: рецессивным
собака-пастух: собаки-пастуха
разводить: разводить
обеспечить: обеспечат
кормить: кормить
заканчиваться: заканчиваются
походка: походку
стараться: стараться старайтесь
смочь: сможет
палка: палкой
прийтись: пришлась
любить: любят
подобрать: подобран
вытьё: вытья
своевременно: своевременно
умение: умения умение
стол: стола
поднять: поднимут
сечение: сечения
учитываться: учитывается
сила: силой
служба: службы
принять: примет приняли
представлять: представляет
континент: континенте
свод: свода
легко: легко
племянник: племянниками
линять: линять
рынок: рынка
лента: ленту
запереть: запереть
отопление: отопления
бернский: бернского
щткать: щтки
жир: жирами
поводырь: поводырей
продезинфицировать: продезинфицировать
ассоциироваться: ассоциируется
вверх: вверх
многократный: многократного
тип: типа
исключение: исключением
выглядеть: выглядит
помещение: помещение
устраивать: устраивает
полусотня: полусотни
купирование: купировании
половина: половине
сбалансировать: сбалансирован
репа: репу
подавить: подавить
покупка: покупке
жсткай: жсткая
порезвиться: порезвиться
возможный: возможна возможны
проплешина: проплешин
тыква: тыкву
вакансия: вакансии
йозеф: йозеф
вычсывать: вычсывать
вовремя: вовремя
продукт: продукты
гусь: гусь
город: города
намка: намка
встречаться: встречается встречаются
постоянно: постоянно
аккуратный: аккуратной
выделить: выделить
пластиковый: пластиковыми
утро: утро
фурминатор: фурминатором
тренировка: тренировок
голень: голени
несмыкание: несмыкание
выше: выше
расцениваться: расценивается
серьзный: серьзным
вместе: вместе
непереносимость: непереносимость
корова: корова
чума: чума
ягодица: ягодицах
столетие: столетия
жара: жару
выгуливать: выгуливая
ещ: ещ
главный: главная
практически: практически
излишний: излишнюю
рейтинг: рейтинг
организовать: организованы
дефект: дефекты дефектами
мужчина: мужчина
проход: проход
мнение: мнению
аппарат: аппарата
отбиться: отбившихся
подписываться: подписывайтесь
забавный: забавными
номер: номерами
запустить: запущенных
обидчик: обидчику
сильный: сильные
самостоятельно: самостоятельно
кабачок: кабачки
создание: создании
ранчо: ранчо
катаракта: катаракты
запретить: запрещено
очень: очень
обычно: обычно
закрепить: закрепить
куинни: куинни
розовый: розового
рада: рада
выполнять: выполнять
наиболее: наиболее
ирландский: ирландский
зубной: зубная
наоборот: наоборот
отмечаться: отмечается
слуховой: слуховой
происходить: происходит
избежать: избежать
теория: теории
довольно: довольно
прежде: прежде
держать: держать
прививка: прививок
обойдться: обойдтся
удивительный: удивительной
густота: густота
глухота: глухоты
удаление: удаления
касаться: касается
заварка: заварки
предок: предком
перекись: перекиси
недшевый: недшево
айдахо: айдахо
сократить: сократить
ласковый: ласковая
проект: проекте
канада: канаде
александр: александр
отстать: отстал
найдт: найдт
дрессура: дрессуре
пора: пор
знать: знала
колли: колли
кг: кг
необходимость: необходимости
чувствовать: чувствует
нерастраченный: нерастраченная
сидеть: сидеть
сей: сих
среднее: среднего
рацион: рацион
кожный: кожных
антисептик: антисептика
соблюдение: соблюдении
развить: развитая
ситуация: ситуации
лаять: лает
плюсна: плюсны
есть: едят
захотеть: захотели
бросаться: бросается
прогуляться: прогуляться
проворство: проворством
являться: является
пушистый: пушистых
суд: судами
стремительно: стремительно
оканчиваться: оканчиваются
паста: пасты
недалеко: недалеко
таз: таза
демодекоза: демодекоз
эмигрировать: эмигрировала
тормашки: тормашками
уделить: уделить
шаг: шаг
палочка: палочки
