ясно: ясно
травма: травм
пятка: пятки
процесс: процессе процесс
ожирение: ожирения
событие: событий
отдавать: отдавайте
тело: тела теле
стоять: стоять
средний: средняя среднее средних средний
удивительно: удивительно
популярность: популярности популярность
необходимость: необходимость
матрац: матрац
дрессироваться: дрессируются
добрый: доброго добрый
следить: следить следите
участвовать: участвовать участвуют
чёрный: черный черного
сколько: сколько
трехцветный: трехцветный
елена: елена
уходить: уходит
уметь: умеют
повизгивание: повизгивания
уэльс: уэльса уэльсе
предоставить: предоставить
немаловажный: немаловажным
название: название названий названия названии
кинологический: кинологический
хулиганистый: хулиганистее
положить: положены
трактовать: трактуют
домой: домой
собака: собаку собаками собакой собак собака собакам собаке собаки
документ: документами документов
округлый: округлой округлые округлая
гряда: грядой
горный: горной горных
табун: табунами
отвечать: отвечаете
заранее: заранее
физический: физических физические
склонность: склонности
обсуждение: обсуждения
состояться: состоялся
другой: другое другие другого другим
мошонка: мошонке мошонку
ваш: вашему ваши вашей ваш вашего ваших
подход: подхода
цена: цена цене
прежний: прежнем
производить: производя
род: родом рода
подушечка: подушечки
любой: любая любые любой любом любым
материал: материалов
природа: природы природа
подшёрсток: подшерстком подшерсток
провести: проведенные проведенная
организация: организации
казаться: кажется казалось
оставить: оставить
полуторамесячный: полуторамесячного
обратить: обратите
артистический: артистические
туманный: туманного
признать: признал признанным
владелец: владельцам владельцев владельцы
размер: размерам размеры размерами размер размера размере
принять: примут принято принять
любовь: любовь любовью любви
движение: движениям
пемброк: пемброкам пемброк пемброков пемброки пемброка
инстинкт: инстинкты
больший: большим большая большего
город: город города
волков: волков
шлейка: шлейку
уэльский: уэльского уэльских
остановить: остановить остановили
обделить: обделила
побегать: побегать
россия: россия
вред: вреда
раковина: раковины
морда: морде морда
карьера: карьеру карьере
обратный: обратная
глубокий: глубокую
продавать: продающий
получаться: получается
великобритания: великобритании великобритания
бесстрашный: бесстрашным
смочь: сможете сможет
ненужный: ненужная
ради: ради
поведение: поведении
перевести: перевести
контроль: контролем
команда: команду команде командой команды команда
соответствовать: соответствует соответствовал
обитатель: обитателями
овчарка: овчарки овчарок овчарка
стричь: стричь
петербургский: петербургская
положительный: положительные
гарантировать: гарантирует гарантирована
шерсть: шерсть шерсти шерстью
вводить: вводить
выразить: выражены
по-разному: по-разному
одиночество: одиночества одиночеству
кинолог: кинологи
вразвалку: вразвалку
зверь: зверь
применять: применять применяйте
привыкать: привыкают
челюсть: челюсти
заводчик: заводчиками заводчик заводчику заводчика заводчики
должный: должны должен должно должна
небольшой: небольшого небольшая небольшую небольшой небольшими небольшим
несложно: несложно
скелет: скелета
сие: сего
выработать: выработала
выкармливание: выкармливание
взгляд: взгляд
король: король короля
переедание: перееданию переедание
возникнуть: возникнет возникло
становиться: становиться становится
проход: проходе
умный: умным умный умна умен умны умной умная
сегодняшний: сегодняшних
вельша-корги: вельш-корги
звук: звуков
человек: людям людей человеку человека человек человеком
пастуший: пастушья пастушьими
относиться: относится
дождливый: дождливую
королевский: королевской королевского
домик: домик
большой: большой
необходимый: необходимы
улыбчивый: улыбчивая
слабый: слабых
общение: общения общение
столь: столь
высокоразвитый: высокоразвитым
равно: равно
называть: называя
рост: росту рост
нога: ног ноги
выраженный: выражен выраженным
важно: важно
главный: главный главных главные главная
помнить: помня помнить
подушка: подушка
многий: многим многих
история: история историю
сообразительный: сообразительны
редкий: редкое реже
возможный: возможными возможной возможны
выполнение: выполнение
щенок: щенка щенков щенки щенком щенок щенку
откликаться: откликаться
зайчик: зайчик
проявляться: проявляется проявляются
нормально: нормально
спас: спасу
покупать: покупая покупать покупайте покупают
никакой: никакой никаких
настолько: настолько
выстригать: выстригать
питомец: питомцев питомцу питомец питомца
голова: голове голова
интересный: интересного интересная
семья: семьи семье
насыщенный: насыщенные
времяпрепровождение: времяпрепровождению
характеристика: характеристика характеристику
происходить: происходящих происходит
специалист: специалистами
выставка: выставках
рабочий: рабочая
решение: решении решение
занятие: занятии занятия
выставочный: выставочные выставочной выставочную
помощь: помощью
чрный: чрный
предать: преданным преданный
успех: успеха
нос: носу носа носом нос
эмоция: эмоции
около: около
восстановить: восстановить
зарождение: зарождения
купание: купания купание
пол: пола
пятно: пятна
красивый: красив
подстилка: подстилка
вглубь: вглубь
походка: походки
индивидуальный: индивидуальных
коготь: когти
порода: породе породы пород порода
мальчик: мальчика
посреди: посреди
значит: значит
стать: стала стали стал станет
весёлый: веселым
считать: считает считают
быстро: быстро
входить: входят входить
основное: основном
представитель: представителям представителя представителем представители
раз: раза
видео: видео
манипуляция: манипуляций
находка: находок
подойти: подойдет
удивлять: удивляет
семенник: семенника
голос: голосу голос
характер: характере характера характеру характер
стремиться: стремятся
внимание: внимания внимание
полностью: полностью
вода: воды
смысл: смысл
быть: будьте будут будь
зоомагазин: зоомагазине
пёс: псы псов псам пес пса
каждый: каждой каждая
предплечье: предплечьям
вакцинация: вакцинация вакцинации
светлый: светлыми
вечер: вечер
своенравный: своенравных
привычка: привычка привычки
покусывать: покусывать
рацион: рациона рационом рацион
шведский: шведским
речь: речь
хороший: хорошим хорошие лучшего хороший хорош лучшее
раздумье: раздумий
содержание: содержание содержания
лундехунд: лундехунды
значение: значении значения
окраска: окраску
девочка: девочка девочку
мордочка: мордочки
датироваться: датируется
работа: работе работы работа работу
корма: кормах
водоотталкивающий: водоотталкивающие
слово: слово слов
находиться: находились находиться находится находятся
составлять: составляет
рекомендовать: рекомендуют
зона: зона
физиологический: физиологические
доставлять: доставляли доставляет
сомнение: сомнения сомнений
холка: холки холке
утверждать: утверждают
окрас: окраса окрас окрасом
орхидея: орхидея
допускать: допускает
собираться: собираются
милый: милые
связь: связь
уделять: уделять
выразительно: выразительно
клуб: клуб
гибель: гибель
интонационный: интонационную
угол: углом углы
тип: типов
жизнерадостный: жизнерадостный
прыгать: прыгать
внешность: внешность внешности
подурачиться: подурачиться
мягкий: мягкой
найти: нашел найдете найти
похожий: похожие
лоб: лба
характерный: характерного характерный характерная
протяжно: протяжно
радужный: радужной
блоха: блох
ортопедический: ортопедический
ребёнок: ребенку детям детей
пока: пока
особый: особых особом
чувство: чувства
создаваться: создается
странный: странной
ошейник: ошейнику ошейник
элитный: элитный элитная
официальный: официальный официальных
чрезмерный: чрезмерную
почувствовать: почувствовать
компенсация: компенсации
яйцо: яйца
роять: роял
вязка: вязки
подъезд: подъезде
давать: давать давал
загородный: загородный загородном загородное
забота: забот
обувь: обувь
жара: жары
завезти: завезли
немецкий: немецкой
дочь: дочерям
свойство: свойства
мебель: мебель
плотно: плотно
район: районах районе
доброжелательность: доброжелательность
есть: ела
узко: узко
качество: качестве качества
птица: птиц птицу птицы
плоский: плоскую плоский
подобрать: подобрать
истеричный: истеричный
пакет: пакета
смотреть: см смотрите
георг: георг
способность: способности
плюс: плюс
фотография: фотографии
широкий: широкие широкий
понимание: пониманием
работать: работать работая работали
агрессивный: агрессивная
выражать: выражают
рекомендация: рекомендация
уход: уходе уход уходу
собирать: собирать собирает
знать: знать знают
удивительный: удивительные удивительное удивительная
столько: столько
страдать: страдают страдающей
высокий: высокая высшей высокого высокий высокое
питомник: питомники питомник
поесть: поесть
пара: пары пару
карлик: карлик
наполнить: наполненные
глаз: глаза глазами
определённый: определенная определенное определенной определенных
задор: задора
грязь: грязь
телефонный: телефонные
прийтись: придется пришлось
закрепиться: закрепились
навязчивый: навязчивым
организовать: организованной организованы
перекусить: перекусив
корм: корм
имя: именем имени
самый: самым самых
сопровождение: сопровождении
снискать: снискать
волк: волками
вниз: вниз
часть: части
незначительно: незначительно
количество: количеством количество
гарцевание: гарцевание
убийство: убийство
восточно-сибирский: восточно-сибирская
форма: форме форму формы
право: праву право
альбина: альбина
моющий: моющих
год: года лет год годом году
предмет: предмет
получать: получает
постоянный: постоянными постоянном
поскольку: поскольку
величество: величества величество
правило: правилам правила правил
сука: сукам суки сук
состояние: состоянием
существо: существо существа
краткий: краткая
чистота: чистотой чистоты
интересовать: интересовать
весьма: весьма
летокрас: летокрас
свой: своими своем своим свой своих свои
отношение: отношение отношению отношения
овощ: овощей
место: место месте места
исключительно: исключительно
сородич: сородичей
выдвинуть: выдвинуты
первый: первом первое
эксперт: экспертов
купать: купать
ранний: раннего
остаток: остатки
факт: факт
психологический: психологические
любимец: любимцем любимцу любимцами любимца любимец
вконтакте: вконтакте
просмотр: просмотр просмотров просмотра
подпадать: подпадает
отказаться: откажется
свет: свет
рядом: рядом
впечатление: впечатление
далее: далее
переход: переход
тазобедренный: тазобедренных
разновидность: разновидности
разведение: разведением разведении разведения
обращение: обращения
роль: роль
хозяин: хозяин хозяином хозяев хозяина хозяева
мес: мес
средство: средств
туловище: туловища
поинтересоваться: поинтересуйтесь поинтересоваться
животное: животных животным животного животные животное
существование: существования
разбойник: разбойников
пропорциональный: пропорциональна
защищать: защищали защищает
версия: версий
рука: руке рукой
вельша: вельша вельш
малый: малейшего меньший
волос: волос
длина: длины длина
тон: тон
любимый: любимое любимая
выбрать: выбрать
разрабатывать: разрабатывали
докучать: докучать
городской: городские городской
бабочка: бабочками
основать: основана
знаток: знатоком
хотя: хотя
кесарев: кесарево
симкина: симкина
серьёзный: серьезные
привить: привит
определиться: определитесь
век: веке век веков
маркировка: маркировки маркировками
дитя: дитя
менять: менять
внешний: внешних
который: которую которое которыми которая которым которые который
проблема: проблемы проблема проблем
нестись: нестись
фора: фору
любитель: любителем
квартира: квартире квартира квартиры
дать: даст данному
подталкивать: подталкивать
талант: талантами
информация: информация
дебют: дебют
друг: друг другом друга
литература: литературе
масса: масса
максимально: максимально
сустав: суставы суставов
палец: пальцами
третий: третьи
опаска: опаски
подзывать: подзывайте
негативно: негативно
выбор: выбор выбора
кошка: кошкой кошки
родитель: родители родителей
такой: такое такие такая такого такую
сложный: сложных
крепкий: крепкие крепкая крепкого
воспринимать: воспринимать воспринимает
окружающий: окружающие
природный: природной
хотеться: хотелось
кончик: кончик кончиками
среди: среди
дом: дом дома доме
племенной: племенной
лапа: лапах лапой лапы лап
планировать: планируя
линия: линию линия линии
считаться: считается
подцепить: подцепил
звено: звеньев
без: безо
загрязнение: загрязнения
просто: просто
забывать: забывать забывайте
бедро: бедру
вырасти: вырастет
натуральный: натуральным
верх: верха
подождать: подождать
недоступный: недоступные
гном: гном
априори: априори
подпалина: подпалинами
соболиный: соболиный
трудный: трудна
тысяча: тысяч
прочий: прочих
рыжий: рыжий рыжими
учитывать: учитывая
равнодушный: равнодушным
угроза: угрозы
домашний: домашней
яичко: яичка
темперамент: темпераменту темперамент
территория: территории
сердце: сердцем
осваивать: осваивают
плохой: плохое плохой
выражение: выражение
добавить: добавьте
помеха: помеха
животный: животном животному
прогулка: прогулки
черта: чертах черты черт
происхождение: происхождения
дружный: дружной
готовый: готовы
пища: пищи
частично: частично
щенячий: щенячью
задний: задние
шанс: шансами
вид: вида виду
кобель: кобеля кобелей
тщательно: тщательно
систематический: систематический
приобрести: приобретите приобрести приобрели
предосторожность: предосторожности
лакомство: лакомство
дрессировка: дрессировка дрессировке дрессировки
время: время времена времени временем
истинно: истинно
сказаться: скажется
приблизительно: приблизительно
подряд: подряд
прямой: прямым прямая прямые прямой
агрессивность: агрессивность агрессивности
остров: острова
ушной: ушной
требовать: требует требуют требовала
чистить: чистите
день: дней день
погода: погоду
схожий: схожие
достижение: достижениями
деятельность: деятельности
показывать: показывает
пясть: пясти
засыпать: засыпает
отважный: отважная отважен отважным
взрослый: взрослого
знакомство: знакомстве
мера: мере меры
потребовать: потребовать потребуют
несколько: несколько нескольку
закон: закона законов
кряхтение: кряхтения
ответ: ответа ответов ответ
предполагать: предполагает
согласно: согласно
схватка: схватку
сила: силы сил силу
рубеж: рубеже
интервал: интервалом
чечевица: чечевица
присущий: присущие
резко: резко
к: ко
реклама: реклама
южный: южного
соответственно: соответственно
понять: поймет
планироваться: планируются
достигнуть: достигнет
немалый: немалые
линять: линяет
бой: бой
приседание: приседанием
общий: общих общего
рекомендоваться: рекомендуется
напоминать: напоминает напоминать
гармонировать: гармонирующий
мочка: мочки
пигментация: пигментация
воспитание: воспитание воспитании воспитанию
диск: дисками
препятствовать: препятствует
комната: комнаты
здоровый: здорового здоровая
малыш: малыш малыша
наследственный: наследственных
правильно: правильно
кардиган: кардиган
сам: самой
поискать: поискать
добиться: добиться
сайт: сайту
процедура: процедур
достаться: достался
слышать: слышать
бывать: бывает
лапка: лапках
особенность: особенностей особенности особенность
волнистый: волнистой
нервный: нервный
полный: полного полный полном
следствие: следствие
лишний: лишними лишнего
настороженность: настороженности
этот: эта этому этих
соотношение: соотношении
что-то: что-то
вариант: вариант вариантах варианты
долго: долго
нота: нотах
выносливость: выносливости
недавно: недавно
опытный: опытные опытных
компактный: компактная
разговаривать: разговаривайте
форум: форум форуме
позвоночник: позвоночника позвоночнике
оберегать: оберегать
предпочтение: предпочтение
некрупный: некрупном
паспорт: паспорт
хотеть: хотят хотите
посоветовать: посоветуете
ость: ость
положение: положение положениям
шампунь: шампуни
скоро: скоро
слагаемое: слагаемые
резкий: резких
чёткий: четкую
присматривать: присматривали
близко: близко
помощник: помощникам помощника
значительно: значительно
шоу-класс: шоу-класса
обеспечить: обеспечен обеспечить
земля: земли землю
признак: признак признаков
маленький: поменьше маленького маленьком маленьких меньше маленькая
один: одна одной одну
описание: описание
светло-рыжий: светло-рыжий
начало: начало
еда: еде
взаимовыгодный: взаимовыгодный
лай: лая лаем
градация: градация
специализировать: специализированные
здоровье: здоровьем здоровью здоровья здоровье
забытость: забытости
герцог: герцог
верхом: верхом
отметка: отметками отметки
однако: однако
огромный: огромные
искренне: искренне
обработка: обработка
соотноситься: соотносится
поэтому: поэтому
удачный: удачная
являться: являлись являются
коричневый: коричневый
коротколапый: коротколапая
предлагать: предлагают
случай: случаев случае
копирование: копирование
дружелюбный: дружелюбная
короткий: короткий короткие
трудно: трудно
методика: методики
лисий: лисьим лисью
прекрасно: прекрасно
активность: активность активности
существовать: существует существовавшего
интуиция: интуиции
основание: основания
дружелюбность: дружелюбность
елизавета: елизаветы елизавета
надеть: надеть
подвижный: подвижные
отзыв: отзывах отзывы
бормотание: бормотания
независимый: независимыми
крупный: крупных крупной
нужный: нужном нужными
заключаться: заключается
следовать: следует следуйте
центр: центр
письменный: письменные
отсутствие: отсутствии отсутствия
шум: шум
поселение: поселения
глубь: глубь
указание: указанием
актуальный: актуальный
наблюдать: наблюдать
особо: особо
более-менее: более-менее
соответствующий: соответствующих
посоветоваться: посоветоваться
подсказать: подскажите
помещаться: помещается
местность: местность
мать: матери
чутко: чутко
назад: назад
пожалуйста: пожалуйста
лето: летом
поначалу: поначалу
цвет: цвет цвета
преодолевать: преодолевая
решить: решили
кость: кости
помогать: помогать
дворец: дворца
мочь: могут можете
локоть: локти
опасаться: опасаясь
утка: уток
запретить: запрещенное запрещено
творог: творог
ухо: ушей уха ушами уши
подходящий: подходящую подходящая
сопровождать: сопровождали
намекать: намекая
суживаться: суживается
объявление: объявления
сделать: сделать сделано сделайте
вступить: вступить
наполовину: наполовину
шалость: шалости
белый: белым
сомнительный: сомнительная
основной: основные основной
интеллект: интеллект интеллектом интеллекта
охранный: охранные
многие: многие
обязать: обязанными
конечность: конечностей конечности
проявление: проявления
неправильный: неправильный
вес: вес
спина: спину спина
степень: степени
показаться: показаться
противник: противником
игривый: игрив
камбрийский: камбрийской
конец: конец
питание: питания питание
тёмный: темного
ежедневно: ежедневно
приучить: приучить
сон: сна
чей: чью
именно: именно
отклонение: отклонения отклонений
встреча: встреча
свод: своде
улица: улице
какой-либо: каких-либо
восприниматься: воспринимается
продолжительность: продолжительность
переводить: переводят
острый: острые
сечение: сечение
вряд: вряд
трезво: трезво
бобовый: бобовые
пересечь: пересечь
пемброкшир: пемброкшир
говорить: говорят
определяться: определяются
родовспоможение: родовспоможения
залаять: залаять
начаться: начался
мясной: мясные
основный: основным основная
зависимость: зависимости
результат: результате
доминирование: доминированию
опустить: опущенные
преданность: преданности
вокруг: вокруг
череп: черепу череп
слегка: слегка
тот: те тех тому той
купировать: купирован купированный купировать
кравченко: кравченко
фото: фото
замечательный: замечательной замечательном замечательные замечательную
затея: затея
пожалеть: пожалеете
провальный: провальное
край: краях
покатость: покатость
игрушка: игрушек игрушку
коржик: коржик
яндекс: яндекс
закидываться: закидываться
осенний: осеннюю
быть-то: будь-то
гармонично: гармонично
строение: строение
кто: кого
вперёд: вперед
нервировать: нервировали
потянуть: потянет
различный: различного
пугливость: пугливость
рад: рад
обязательный: обязательная
кардиффский: кардиффского
оценить: оценить
бросить: бросьте
служебный: служебных
относить: относят
подобный: подобному подобные
отпустить: отпустите
премиум-класс: премиум-класса
журнал: журнал
отличный: отличный отличные
высота: высота высоты
двигаться: двигались
бегать: бегает
месяц: месяца месяцев
привязь: привязи
выносливый: выносливая
дружба: дружбу
популярный: популярной
заниматься: занимались занимается
нуждаться: нуждаются нуждается
постав: постав
расположить: расположен
запланировать: запланированной
стихия: стихия
хивэла: хивэла
принести: принеси принесете
болезнь: болезни
шпиц: шпицев
хитроватый: хитроватым
сумма: сумма сумму
поступать: поступать
помесь: помесь
контролировать: контролировать контролируйте
всякий: всяких всякой
обмануть: обмануть
либо: либо
легенда: легендой
начинать: начинать начиная
комбинезон: комбинезоны
активно: активно
стадо: стада стадо
обнаружить: обнаружили
профилактический: профилактические
кастрировать: кастрировать
заболевание: заболевание заболеваниями
образ: образом
рулада: рулады
зарекомендовать: зарекомендовавшей
умеренный: умеренной
овальный: овальной
простой: проще прост просты
кличка: кличка клички кличку
детский: детского
ущерб: ущерба
отделить: отделена
норма: норме
хандра: хандра
радоваться: радоваться
условие: условиям условиях
дешёвый: дешевле
овца: овец
объём: объеме
проявить: проявить проявит
вальхунд: вальхундом
низкий: низких низкое
пони: пони
солидарность: солидарность
смывать: смывать
юрисдикция: юрисдикцию
плохо: плохо
скакательный: скакательные
терпение: терпение
вести: ведет
жизнерадостность: жизнерадостность жизнерадостности
королева: королева королевы
отличить: отличить
затрата: затраты
проволокообразный: проволокообразной
помета: помете
центральный: центральных
хвост: хвосты хвоста хвост
дело: дело
практика: практика
курс: курсе курсы
родиться: род
стоически: стоически
рынок: рынки рынке
перейти: перейти
скрещивание: скрещивания
держать: держа держать
постараться: постарается постарайтесь
разный: разные разных
из-за: из-за
регулярно: регулярно
главное: главное
первоначально: первоначально
зад: зада
линька: линьку линьки линька
иметься: иметься
броситься: бросится
пятнышко: пятнышки
оболочка: оболочки
прыжок: прыжков прыжки
уровень: уровне уровню
ветеринарный: ветеринарный
жить: живете
глядеть: глядя
иной: иной
откуда: откуда
грудь: груди грудь
разрешаться: разрешаться
клетка: клетка клетки
ирина: ирина
приобретать: приобретать
попадание: попаданию
слишком: слишком
невероятно: невероятно
корги: корги
никто: никто никого
последний: последний
требоваться: требуется
категоричность: категоричность
дружелюбие: дружелюбие
зимой: зимой
альбион: альбиона
потерпеть: потерпеть
отучить: отучить
бесстрашие: бесстрашие
стандарт: стандарта стандарту стандарт стандартам
кой: коем
переполнять: переполняют
связать: связано
приём: приемах
новиков: новикова
сзади: сзади
освободиться: освободится
собачий: собачье
отнести: отнести
стартовать: стартовать
птичий: птичьи птичьем
произноситься: произносится
йоркский: йоркский
трогать: трогать
удаться: удастся
жильё: жилье
позволить: позволить позволили
закруглить: закругленными
собственный: собственную
густой: густой
оценка: оценке
томиться: томиться
кусочек: кусочка
нагрузка: нагрузок нагрузки
появиться: появился
рубль: рублей
коленный: коленных
назначение: назначения
пообщаться: пообщаться
излишний: излишне
упоминание: упоминания
яйцевидный: яйцевидной
вычёсывание: вычесывание
топ: топ
длинный: длинная
обособленный: обособленного
наличие: наличии
спрятать: спрятать
интернет: интернет
идти: идет
риск: риска
скромный: скромный
выбирать: выбирая
сужение: сужений
иметь: имеет иметь имел
обратиться: обратиться
стоимость: стоимость стоимости стоимостью
особенно: особенно
удовольствие: удовольствие удовольствия
подавать: подавать
стареть: стареет
несложный: несложен
принцип: принцип
предельно: предельно
отличие: отличия
достаточно: достаточно
доставляться: доставляется
обязательно: обязательно
певец: певцы
собственность: собственностью
расположение: расположение расположении
возраст: возраста возрасте
кардиганшир: кардиганшир
член: члены
прикус: прикусом
неделя: неделю
специальный: специальные специальной специальный
число: числа
заложить: заложено
сопровождаться: сопровождается
англия: англии
содержаться: содержатся
несмотря: несмотря
купить: купить купите
часто: часто
плотный: плотные плотным
подопечный: подопечных
приземистый: приземистая
гусь: гусей
потеря: потерей потерь
страна: странах страна
неплохой: неплохие
некоторый: некоторое некоторой
коротенький: коротенькие
грудной: грудной грудная
располагать: располагающую
блестящий: блестящую
период: периоды
дёшево: дешево
ценовый: ценовая
поскуливание: поскуливанием
предок: предки предков
задача: задача
заметить: заметила
слушаться: слушаться
сухой: сухих
некстати: некстати
недостаток: недостаткам
кто-то: кто-то
рассчитывать: рассчитывать
пасти: пасущей пасли
очаровательный: очаровательная
подать: подайте
разграничение: разграничения
похрюкивание: похрюкивания
чистый: чистой
правильный: правильным правильное
электропровод: электропровода
требование: требований
смущать: смущать
холод: холода
одноклассник: одноклассники
перспективность: перспективности
активный: активной активны
скорее: скорее
породистый: породистый
дисплазия: дисплазия
правда: правда
тормошили-целовали-тискать: тормошили-целовали-тискали
интонация: интонацию
сходство: сходство
случайный: случайные
кроме: кроме
компенсироваться: компенсируются
разница: разницы
лужица: лужицу
перловый: перловую
наволочка: наволочку
корг: коргу
водный: водных
периодичность: периодичностью
частый: чаще
поиск: поиск
делать: делают делали
участие: участия
бочкообразный: бочкообразную
зуб: зубы
вообще: вообще
ждать: ждал
лестница: лестницам
нечастый: нечастое
потребоваться: потребуется
влага: влаги
белые: белые
запастись: запаситесь
выхаживание: выхаживание
раскопка: раскопки
лаять: лают
направление: направлении
пройти: пройдет пройти
щётка: щеткой
игра: игры игра
потребность: потребность
горох: горох
восторг: восторга
повод: повод
будка: будке
жизнь: жизни
два: двух
современный: современных
абсолютно: абсолютно
общество: обществе
сильно: сильно
мир: мире мира
мешать: мешает
благодаря: благодаря
груминг: груминг
всё-таки: все-таки
оцениваться: оценивались
малыш-пемброк: малыша-пемброка
плечо: плечи
впервые: впервые
кучка: кучку
запах: запаха
впадина: впадиной
намёк: намека
вертикальный: вертикальное
оттенок: оттенком
оптимизм: оптимизма
вокальный: вокальными
посещать: посещать
нужно: нужно
мимимишность: мимимишности
живой: живые
настойчивость: настойчивость
также: также
настроение: настроение
песок: песка
поставить: поставленные
любопытный: любопытным
цель: цели
момент: моменты момент
уберечь: уберечь
тыс: тыс
возможно: возможно
человеческий: человеческого человеческом
свернуть: сверните
ножка: ножки
превосходящий: превосходящим
крупяной: крупяные
осложнение: осложнений
корпус: корпус
подручный: подручных
нарколепсия: нарколепсией
отсюда: отсюда
собачка: собачку
бум: бум
круп: крупу
ровный: ровная
упустить: упустить
умеренно: умеренно
стоить: стоить стоит
вол: вола
оставаться: остается
похлопывание: похлопыванием
агрессия: агрессию
разговорчивый: разговорчивы
впоследствии: впоследствии
великолепно: великолепно
сложно: сложно
дорогой: дорогая
ощутимый: ощутимой
семенить: семенящий
это: это
хвостик: хвостик
собака-чемпион: собак-чемпионов
естественный: естественной естественный
интересно: интересно
любить: любит любят
зарычать: зарычать
привлекательный: привлекательной
отар: отарах
вопрос: вопрос
редкость: редкости
лайк: лайка
приобретение: приобретение
разводить: разводить
спокойный: спокоен
целое: целого
близкородственный: близкородственного
вытерпеть: вытерпит
убрать: убрать уберите
сыскать: сыскать
стараться: старайтесь
своевременно: своевременно
умение: умения
ехать: ехать
однажды: однажды
домочадец: домочадцы
аккуратно: аккуратно
виновник: виновника
межпозвоночный: межпозвоночными
пачкаться: пачкался
кавалер-кинг-чарльз-спаниель: кавалер-кинг-чарльз-спаниель
каша: каши
злой: злая
легко: легко
общительность: общительности
передвижение: передвижения
идеально: идеально
профессионал: профессионал
лента: ленту
известный: известному
следующий: следующее
громко: громко
вспыльчивый: вспыльчивый
шея: шее
столетие: столетий
показать: покажите
детство: детстве
исключение: исключением
врач: врачу
вычёс: вычесе
устраивать: устраивает
внимательный: внимательного
уверить: уверены
командно-игривый: командно-игривым
многочисленный: многочисленными
обмен: обмен
английский: английского
расчёсывать: расчесывать
плинтус: плинтусы
во-первых: во-первых
последовательность: последовательность
порезвиться: порезвиться
упаковать: упаковать
избегать: избегать
садиться: садится
выход: выход
вакансия: вакансии
приучать: приучайте
прямо: прямо
продукт: продукты продуктам
университет: университета
передний: передних
знак: знаки
приходиться: приходится
сбалансированный: сбалансированное
букингемский: букингемского
далёкий: далеком
выделить: выделить
обрабатывать: обрабатывать
генетически: генетически
своеобразный: своеобразные
ножницеобразный: ножницеобразным
достаточный: достаточным достаточное
обустроить: обустроить
ветеринар: ветеринара
выше: выше
улечься: улегшись
вместе: вместе
озорной: озорным
чересчур: чересчур
кабель: кабели
громкий: громких
практически: практически
цениться: ценится
рейтинг: рейтинг
весь: всеми
ряд: ряд
подписываться: подписывайтесь
гигиенический: гигиенических
портрет: портреты
сильный: сильные сильными
самостоятельно: самостоятельно
социальный: социальное
передаваться: передается
использовать: использовать
бесстрашно: бесстрашно
подарить: подарил
расстояние: расстояния
изгрызть: изгрызть
брид-класс: брид-класса
очень: очень
бок: бокам
оформление: оформление
выполнять: выполнять
визит: визиты
нежирный: нежирный
наоборот: наоборот
избежать: избежать
довольно: довольно
прежде: прежде
скот: скот
касаться: касается
остаться: осталась
весело: весело
молодой: молодых
терпеть: терпят
комнатный: комнатная
чрезвычайный: чрезвычайную
функция: функцией
проект: проекте
сразу: сразу
отдать: отдать
склонный: склонны
недопустимо: недопустимо
наследство: наследству
пора: пор
кобелёк: кобельков
кг: кг
насколько: насколько
блюдо: блюда
условный: условная
чувствовать: чувствует
свободный: свободной
среднее: среднего
минимальный: минимальная
вакцинировать: вакцинировать
канин: канин
действительно: действительно
графство: графства
низко: низко
продолжаться: продолжаться
викинг: викинги
диалог: диалог
ковёр: ковры
кормление: кормления
причём: причем
глазок: глазки
бояться: боялись
плюсна: плюсны
развитой: развитых
изнеженный: изнеженной
карточка: карточку
короб: короба
схожесть: схожесть
оба: оба
четырёхмесячный: четырехмесячного
учёный: ученые
встречаться: встречаются
хвалить: хвалите
сообразительность: сообразительности
бег: бег
пет-класс: пет-класса
шаг: шаг
баран: барана
какой: каких
