радость: радостью
избавить: избавить
существование: существование существования существовании
империя: империю империи
лечение: лечением
противник: противника противнику
тело: тела тело
недопустимый: недопустим
колебаться: колеблется
кровь: крови кровей
стоять: стоять
широко: широко
популярность: популярности популярность
своевременный: своевременный своевременной своевременное своевременная своевременных
защита: защиту
скот: скота
прославиться: прославилась
смириться: смириться
напоминать: напоминали
пища: пища пищи
четвероногий: четвероногих четвероногие четвероногого
следить: следить
сколько: сколько
душа: души душе
название: название названия
след: следа
порыв: порыве
сухой: сухого сухой сухие сухая
готовность: готовность
заслуга: заслуга
воин: воины воинов
ноздря: ноздри
справляться: справляются справлялись
зоосредство: зоосредство
физический: физических физические
обсуждение: обсуждения
другой: другое другую другие других другими
жаркий: жаркую
английский: английских английским английская английскому английский английское английские английского
цена: цена цену ценой
отчаяние: отчаянии
уклониться: уклониться
бульмастиф: бульмастиф
каштанк: каштанка
вмешательство: вмешательство
мастиф: мастифы мастифа мастифах мастифам мастифами мастифу мастиф мастифом мастифов
забывать: забывая забывать забывайте
материал: материалов материал
раскрытый: раскрытые
организация: организации
казаться: кажется
предотвратить: предотвратить
дыхание: дыхание дыханием
тигр: тигров
укоротить: укороченную
обратить: обратите обратить
туманный: туманного
поспешить: поспешит
возвышаться: возвышается
любовь: любовь любовью
простой: простого
заинтересовать: заинтересовать
щтка: щткой
обучаться: обучаются
осведомить: осведомлены
легион: легионы
непатриотичный: непатриотичным
дикий: дикими диких
выраженный: выраженный выражен выраженная
россия: россия
тотализатор: тотализатора
спортсмен: спортсмены
морда: морде морду морды морда
миска: миска
забыть: забудьте забыть
обратный: обратная обратный
начало: началом начала начало
размер: размеров размерами
радужка: радужки радужка
скрасить: скрасит
представитель: представителей представителя представитель представители
грань: грани
команда: команду командами команд команды команда
появляться: появляются
корыстный: корыстные
преобладать: преобладать
шея: шея шеи
храпеть: храпят
исполнять: исполнять
шанс: шанс
фокстерьер: фокстерьер
шерсть: шерсть шерсти шерстью
компаньон: компаньоны компаньона
сделать: сделают сделано сделала сделайте
блеск: блеск
доминантный: доминантный доминантным
документ: документы
увеличение: увеличении увеличения
непоколебимость: непоколебимости
изучать: изучайте
провести: провести
выразить: выражены выражена
пресекать: пресекайте пресекать
крупа: крупа круп
кинолог: кинологи кинологам
гость: гостя гостям
один: одним одна одной
челюсть: челюсти челюстям
должный: должны должен должно должна
небольшой: небольшого небольшое небольшие небольшой
тип: тип типов типа
случайно: случайно
значительный: значительном
покорить: покорили
идт: идт
взгляд: взгляд взгляды взгляда
исключение: исключение
ленивый: ленивы
обеспечивать: обеспечивали обеспечивают
подоспеть: подоспело
сохранение: сохранения
человек: людям людей человеком
свирепый: свирепым свирепые
относиться: относится относятся
питомец: питомцами питомец питомца питомцем
большой: большой
великобритания: великобритания
столь: столь
часами: часами
назвать: назвать
погоня: погоне
сложнный: сложнным
очаг: очага
судьба: судьбу судьбе судьба
кроха: крохи
отличаться: отличается отличалась отличаются отличались
темп: темпа
формат: формат
обильный: обильные обильным
покладистый: покладистого покладистыми
близкородственный: близкородственной
важно: важно
главный: главный главные главная
склонный: склонные
популярный: популярны популярных
центральный: центральной
история: история
щенок: щенка щенков щенки щенок
парка: парке парку
дождливый: дождливой
проверять: проверять
государство: государства государств
успешно: успешно
поощрять: поощрять поощряла
тигровый: тигровым
опрятный: опрятным
попросить: попросите
новый: новые новая новым нового
настолько: настолько
выжить: выжить выживших
приоритет: приоритет
дополнительный: дополнительной
вывести: вывело
чувствовать: чувствуют
отвиснуть: отвисших
семья: семьи семью семьям семей
выступ: выступ
вероятный: вероятнее
упрямиться: упрямятся
выпуклый: выпуклые выпуклую выпуклыми
определнный: определнные определнных определнного
характеристика: характеристика
немецкий: немецкий
быть: е будьте будут
эффективный: эффективной
стоп: стоп
помощь: помощью
нэ: нэ
чрный: чрный
ведущий: ведущим
специальный: специальное специальные
кратное: кратное
около: около
сгладить: сглаженный сглажен
неравномерный: неравномерный
пол: пола полу
пятно: пятна
война: войны войнах
захват: захвата
залог: залог
наступить: наступили
подразумевать: подразумевает
нездоровый: нездорового
кормление: кормлении кормление
находиться: находилась находится
лакомый: лакомый
заворот: заворот
купец: купцами
разгар: разгар
порода: породе породам породы пород породу порода
отнюдь: отнюдь
стать: стала станут стали станете стало стал
маска: маска маску маски
палец: пальцы палец
возможный: возможных возможные
чужак: чужакам чужака
неповоротливый: неповоротливы неповоротливыми
яичко: яичек
первый: первой первым первое первого первый первая первую
сужаться: сужается
вылепить: вылепить
удаться: удалось удастся
огромный: огромных огромными огромные огромным огромной
состояться: состоялось
раз: раза
помимо: помимо
открытие: открытия
видео: видео
приобретение: приобретении приобретения
гетерохромия: гетерохромия
полноценный: полноценного
зрелищность: зрелищностью
золотой: золотую
характер: характере характера характер
полнота: полноты
меню: меню
полностью: полностью
условие: условии условия
компания: компании компания компанией
пёс: псы пса
шахматный: шахматном
брылей: брылей
робкий: робкий робкое
владелец: владельца владельцев владельцы
позаботиться: позаботьтесь позаботился
последний: последняя последних последнему последнего последней
флаг: флаг
древний: древних древнейших
косточка: косточками
ваш: вашу ваше вашей ваш вашего вашем ваша
рацион: рациона рационе
опустить: опущена
собака: собаками собакой собак собака собаке собаки
образ: образ образом
список: списком списке
распространиться: распространились
соревноваться: соревноваться
содержание: содержание содержанием содержания
щека: щекам
работа: работе работы работу
немного: немного
попытка: попытки
пропорционально: пропорционально
плодотворный: плодотворном плодотворной
город: городу
сон: сон
составлять: составляет
рекомендовать: рекомендуют
холка: холки холке
положительный: положительном
численность: численность численности
путь: путь
охранник: охранники
запомнить: запомните
ветеринар: ветеринару
морщинка: морщинках морщинки
покупка: покупкой
намерение: намерения
прокормить: прокормить
занимать: занимают занимать
сладость: сладостей
канада: канаду
территория: территорию территории
он: нему
связь: связь
сосуществовать: сосуществуют
наджность: наджность
эстет: эстетам
клуб: клуб клуба клубом
покрыть: покрыты
сердечный: сердечных
картина: картины
внешность: внешность
частичка: частички
гриб: грибов
изрядный: изрядным
лоб: лба лоб
изучение: изучение изучении
надобность: надобности
тмный: тмный
частный: частном частные
пока: пока
семейный: семейного
тягловый: тягловой
сводистый: сводистые
рабочий: рабочий
травма: травму
состояние: состоянии состояния
мастифообразный: мастифообразные мастифообразных
психологический: психологическим психологического
официальный: официальный официальное
вязка: вязки
лежать: лежала
нижний: нижние
кислота: кислоты
вековой: вековую
юлий: юлий
выдающийся: выдающийся выдающиеся
остеоартроз: остеоартроз
наполнить: наполнена
завезти: завезли
люд: люда
ситуация: ситуацию
подтверждать: подтверждают подтверждает
массивный: массивных массивные
заниматься: заниматься занимались
лидерство: лидерство
уплощнный: уплощнную
микроэлемент: микроэлементы
старший: старше
пудель: пудель
плотно: плотно
сменить: сменили
обременительный: обременительными обременительным
дойдт: дойдт
вынуждать: вынуждайте вынуждая
пришться: пришлся
качество: качестве качества
смотреть: см
друг: друзья друг друга другу
племенной: племенную племенной племенным
фотография: фотографии
травля: травля травли
воссоздание: воссоздании
выражать: выражают
окружность: окружность окружности
молосса: молосса молоссы
стычка: стычка
уход: уходе уход уходом
современный: современные современным
преуменьшение: преуменьшением
вырастить: вырастил
знать: знать знает знати
общественный: общественный
обученный: обученными
столько: столько
титул: титулом
помнить: помните
щки: щки
темя: темени
результат: результат
страдать: страдают
питомник: питомники питомника питомник
понянчить: понянчить
достоверный: достоверной
глаз: глаза глаз
квадратный: квадратной квадратный
дружелюбный: дружелюбное дружелюбные дружелюбная дружелюбного
грязь: грязь
бордоский: бордоский
питаться: питаются
непоколебимый: непоколебимы непоколебимой
незнакомый: незнакомым
позиция: позицию
недостаток: недостатков
корм: корм
слабый: слабую слабое слабый
порок: порокам пороки
самый: самым самое самых
повышенный: повышенного
запомниться: запомнился
самостоятельный: самостоятельной самостоятельным
базовый: базовыми
принц: принц
часть: части частям
количество: количеством количества
мочь: можем могут можете
сказать: сказать
век: века веке
смысл: смысле
собачий: собачьей собачьих
год: года лет гг году
подсушивать: подсушивающего
малоактивный: малоактивных
проявлять: проявляют проявлять
пользоваться: пользуются пользоваться
покупать: покупать
краткий: краткая
весьма: весьма
свой: своими своим своего своей своих свои
натуральный: натуральная
отношение: отношение отношению
плотный: плотная
место: место места
волонтр: волонтров
масса: массы массу
малыш: малышей малышам малыш малыша
случиться: случилось
исключительно: исключительно
сородич: сородичам
норвежский: норвежский
весь: весь
своеволие: своеволие
эксперт: экспертов
купать: купать
справка: справку
сражение: сражения
варна: варной
вконтакте: вконтакте
постоянный: постоянной
кишечный: кишечную
впечатление: впечатление
создать: создать создали
шрстный: шрстный
сочетать: сочетает
сочетание: сочетание
тренировка: тренировках
тазобедренный: тазобедренных
разведение: разведением разведению
ожидать: ожидают
раненый: раненого
ярко: ярко
поврнуть: поврнуто
роль: роль
далкий: далких
животное: животных животным животного животными животные животное
одинаково: одинаково
лукавить: лукавить
сша: сша
объединить: объединив
появление: появления
рука: руке
чреватый: чревато
свинин: свинины
длина: длины длина
тон: тон тона
охотничий: охотничьих
выбрать: выбрать выберут
долгожданный: долгожданный
скула: скулы
пс: пс
мясистый: мясистые
прим: примов прим
основать: основана
впечатлять: впечатляют
напиток: напитков
хотя: хотя
продукт: продуктов
густой: густым густой
бинт: бинтом
стачиваться: стачиваются
расстояние: расстоянии
замша: замша
плоскость: плоскости
видный: видны
крах: краха
ренессанс: ренессанса
установить: установить
тампон: тампоном
взглянуть: взглянули
форма: форму формы
витамин: витаминов
одержать: одержал
пасть: пасть
проблема: проблемы проблему проблем
гай: гай
познакомиться: познакомиться
собаководство: собаководства
середина: середины середину середине
квартира: квартире
старый: старейших старой
глазной: глазным
звание: звание
малый: малейшие малейшей меньшую меньшем
асимметричный: асимметричная
тяжла: тяжлой
англичанин: англичанин англичан англичане англичанина
заметный: заметен
тврда: тврдой
пытливый: пытливый
информация: информация
британия: британию британии
влажный: влажным влажного
подходить: подходит подходят
телосложение: телосложение
жалостливый: жалостливые
долгий: долгой
послушный: послушного
убеждение: убеждении
жир: жир
сво: сво
любой: любую любых любой любом
сустав: суставы суставов
проводить: проводить
накапливаться: накапливаются
кровавый: кровавые кровавой
авторитет: авторитет
выбор: выбор выбора
ниже: ниже
приложить: приложить
мириться: мириться
окрас: окрас
существующий: существующая
славиться: славилась славится
крепкий: крепкие крепким крепкой крепкого
прямой: прямом прямая прямой
польза: пользу
протереть: протереть
габарит: габариты габаритов
ощупь: ощупь
среди: среди
сохраниться: сохранились
число: число
дуга: дуги
категорически: категорически
успех: успехе
это: этим это
веко: веки
высокий: высшей высоким высокую
колено: колени
корень: корню
зуб: зубах зубами зубы
вскоре: вскоре
любимица: любимицы
гармоничный: гармоничного
длинный: длинные длинную длинная
герой: герой
молосский: молосских молосской молосские
равняться: равняться
инфекционный: инфекционных
тонкий: тонкие
тревожный: тревожный
макушка: макушке
исчисляться: исчисляется
уступить: уступит
прямоугольный: прямоугольной прямоугольный
титулованность: титулованности
греция: греции
тысяча: тысяч
частый: частых частым чаще
природный: природное
учитывать: учитывая
час: часа
миг: миг
режим: режима
дискомфорт: дискомфорта
вперд: вперд
охранять: охраняла
массово: массово
раздражение: раздражение
мировой: мировой
низкий: низкая
нежный: нежными
важный: важным важны
женский: женского
сердце: сердцем
усилие: усилия
контакт: контакт
локоть: локтей
добавить: добавьте
прогулка: прогулки прогулкой прогулках прогулок
обязанность: обязанностями
культура: культур
человеческий: человеческие человеческого
черта: чертах черты
умеренный: умеренная умеренное
дворянин: дворянину
происхождение: происхождения происхождение
заболевание: заболевания заболеваний заболеваниями
резкий: резкий
резец: резцы
консультироваться: консультируйтесь
необходимо: необходимо
задуматься: задуматься
выдержка: выдержку
готовый: готовы готового готовые
передвигаться: передвигается
лундехунд: лундехунд
наглый: наглым
частично: частично
цезарь: цезарь цезаря
соотношение: соотношение соотношении
охотный: охотнее
задний: задние задними
бдра: бдра
найти: нашла найти
потреблять: потребляет
свидетельство: свидетельства
кобель: кобеля кобели кобелей
вакцинация: вакцинации
предплечье: предплечья
дрессировка: дрессировка дрессировке дрессировки
стандартный: стандартный
симптом: симптомов
время: время времена времени временем
сука: суки сук сука
британский: британским британские
быстрый: быстрые
агрессивность: агрессивность
великолепный: великолепные
полость: полость
желтовато-коричневый: желтовато-коричневым
погода: погоду погоды
начать: начали
пясть: пясти
скрещивание: скрещивание
кость: костей кости
держать: держит
хозяин: хозяином хозяину хозяина
ротовой: ротовая
взрослый: взрослого взрослым
использовать: используйте использовали использовать
задолго: задолго
серповидный: серповидную
яростно: яростно
избежание: избежание
благоприятный: благоприятные
мера: мере
толстый: толстые
комфортно: комфортно
несколько: несколько нескольких
плавный: плавные
следующий: следующим
отличный: отличная отличные
рост: рост
голова: головы голова
потомство: потомство
обладатель: обладатель обладателей
включать: включавшей
домосед: домоседами домоседы
сила: силы
убедиться: убедится
скучно: скучно
повторять: повторять
гвардия: гвардиях
реклама: реклама
соответственно: соответственно
мясо: мясом
наклон: наклоном
лгкий: лгкое лгких лгкие
подшрстка: подшрстка
угодить: угодить
выделять: выделяют
вдалеке: вдалеке
абрикосовый: абрикосовым
проживать: проживают
силовой: силовых
премиум-корма: премиум-корма
силиконовый: силиконовыми
шалость: шалостей
мускулатура: мускулатурой мускулатура мускулатуру
насадка: насадкой
второй: второй вторая втором
отправной: отправной
соответствие: соответствия
пигментация: пигментация
ножницевидный: ножницевидный
выходец: выходцев
губа: губ губы
характерный: характерны характерен
воспитание: воспитание воспитании
достигать: достигает
здоровый: здорового здоровый
ласковый: ласков
шесть: шести
правильно: правильно
вид: виду виде
воспитанный: воспитанные
оба: обоих
поддержание: поддержания
персия: персию персии
боковой: боковым
марионетка: марионетки
сайт: сайту
вымирание: вымирания
свободный: свободного свободные свободное
родословная: родословной
особенность: особенностей
отправиться: отправилась отправились
железный: железный
угодье: угодьях
обняться: обняться
активный: активный активное
шаловливый: шаловливые
получаться: получаются
птица: птицам
жестокий: жестокие жестокого
противовес: противовес
дорогой: дорогое
социализация: социализация социализации
недуг: недугов
кожа: кожа кожи
этот: эта этих
лишь: лишь
вариант: вариант варианту вариантами
таураса: таурас
долго: долго
домашний: домашними домашнего
обосноваться: обосновавшись
форум: форум форуме
заметить: заметить
ринуться: ринуться ринется
подкрепление: подкрепление
предпочтение: предпочтение
дог: доги
апартамент: апартаментах апартаментам
чемпион: чемпионом
незначительный: незначительной
хотеть: хотят
жестокость: жестокости
компактный: компактной
воплощение: воплощение
образовать: образуя образует образуют образована
меланхоличный: меланхоличное
раствор: раствор
капля: капли
прочность: прочность
сформироваться: сформировались
член: членам членов
гигант: гиганта гигантами
такой: такие такого таким
чистота: чистоте чистоты
советовать: советуют
многократно: многократно
шампунь: шампуни шампуня
пигментировать: пигментирована
идеальный: идеальных идеального
фриз: фризе
эпоха: эпоху
поставить: поставлен поставлены поставленные
близко: близко
подобать: подобает
метеоризм: метеоризмом
признак: признак
описание: описание
будни: будни
спокойный: спокойные спокойное
стандарт: стандартом стандарту стандарт
выдаваться: выдаются
посадить: посаженные посажены
обзавться: обзавлся
здоровье: здоровьем здоровья здоровье
оказаться: оказалась оказались
жестковатый: жестковатая
увлажннный: увлажннным
удивительный: удивительное удивительную
раскачивание: раскачивание
речной: речной
внушительный: внушительные внушительных внушительному внушительным
иноходь: иноходь
играть: играть
преданность: преданность
который: которой которая которых которым которые который
устраивать: устраивать
щекастость: щекастость
поэтому: поэтому
прилегать: прилегающих прилегает прилегают
копирование: копирование
солдат: солдатами солдаты
постоянство: постоянство
превышать: превышала
победа: победу
передний: передний передние
прекрасно: прекрасно
активность: активность
вооружиться: вооружившись
существовать: существует существовали
основание: основания
осматривать: осматривайте
русский: русская
дружелюбность: дружелюбность
вкусный: вкусный
попасть: попали
иить: иили
вернться: вернтся
проведение: проведение
иммунитет: иммунитет
подвижный: подвижные
отзыв: отзывах отзывы
увлекательный: увлекательной
десятка: десяток
крупный: крупных крупную крупные крупным
принадлежать: принадлежавшей
кошка: кошки кошками
однообразный: однообразные
ореховый: орехового
выделение: выделения
толкнуть: толкнуть
изучить: изученного
бедняк: бедняков
отсутствие: отсутствии отсутствия отсутствие
виднеться: виднеющийся виднеется
шум: шум
достаться: достались
висячий: висячие
ярость: ярости ярость
постав: поставом постав
особь: особи особям особей
спускать: спуская
процедура: процедуры процедурах
крайний: крайнем
уровень: уровня уровне
ввиду: ввиду
пах: паха
нетерпимость: нетерпимость
плечелопаточный: плечелопаточные
щткать: щтку
королевский: королевских королевская
пятнадцать: пятнадцати
придться: придтся
вершина: вершинами
болезненный: болезненных
доброта: доброту
цвет: цвет цвета
клиника: клинику
непроходимость: непроходимость
несварение: несварению
ужин: ужин
болезнь: болезней болезни болезнь
настоящий: настоящий
изящный: изящные
скитание: скитания
спокойствие: спокойствию
точка: точкой
н: н
выдвинуть: выдвинут
возраст: возрастом возрасте
произойти: произошла произошли
средний: средней средний
принятие: принятия
привязанность: привязанность привязанностью
хватать: хватает
всячески: всячески
скосить: скошен
тысячелетие: тысячелетием
римлянин: римлян
баранина: баранины
объявление: объявления
неаккуратно: неаккуратно
основной: основные основной
секатор: секатором
опыт: опытом
воспроизводить: воспроизводить
мочекаменный: мочекаменную
партнр: партнра
родитель: родителями родителей
интеллект: интеллект интеллекта
охранный: охранные охранный
настороженно: настороженно
принимать: принимал принимать
средне: средне
ум: ум
вес: вес весом
спина: спину спины спина
боевой: боевых боевой боевого
степень: степени
нежность: нежность
помочь: помогут поможет
конец: конец
светлый: светлую светлый
повторный: повторное
широкий: широкая
растяжение: растяжение
единственный: единственным единственная единственное
ежедневно: ежедневно
позволять: позволяют
нос: носа нос
бег: бега
банный: банный
простудный: простудными
причина: причине причины
слово: слов словам
именно: именно
отягощать: отягощающей
сохранность: сохранностью
серебристый: серебристым
расчсывать: расчсывать
измениться: изменилось
продолжительность: продолжительность
несоответствие: несоответствие
отзывчивость: отзывчивость
диван: диване
безосновательно: безосновательно
линия: линия линии
окантовка: окантовки
затылочный: затылочный
горло: горле
гладиатор: гладиаторов
дисквалифицировать: дисквалифицируют дисквалифицирующий
борный: борной
доходить: доходит
зубной: зубную
оттенок: оттенок
расположить: расположены
говорить: говорят говорит
сезонный: сезонной
маленький: маленькими маленького меньше
развитие: развития
стальной: стальную
напомнить: напомнит
череп: черепу черепа череп
бороться: бороться
слегка: слегка
тот: те тех тому
скрутить: скрученный
сэр: сэру сэр
способный: способная
посторонний: посторонним
фото: фото
питание: питание
бобовый: бобовых
уменьшиться: уменьшилось
вы: вами
кровожадность: кровожадность
хороший: хорошими лучшее
предъявить: предъявить
разболтать: разболтанными
прирожднный: прирожднного
яндекс: яндекс
обращение: обращение
считаться: считаются считалось
обед: обед
дело: делом дело деле
выбраковать: выбракованный
собственный: собственной
участие: участие участия
выглядеть: выглядеть выглядели выглядят выглядит
кофеиновый: кофеиновых
стенка: стенок
сравнение: сравнении
атака: атаку
лапа: лапы
делать: делая делать
затратный: затратно
собрать: собраны
фрисби: фрисби
нетипичный: нетипичный
журнал: журнал
воспитанник: воспитанников
умный: умного
куполообразный: куполообразная
неделя: недели
высота: высота
невыразительный: невыразительный
кличка: кличке клички
равнодушный: равнодушны
ветреный: ветреную
съедать: съедали
версия: версией версия
нуждаться: нуждаются нуждается
ванна: ванны
э: э
слюноотделение: слюноотделением
мощный: мощного мощных мощные
больший: большие большей
еженедельно: еженедельно
настроение: настроения
покров: покров
агрессивный: агрессивное
вавилонский: вавилонских
изредка: изредка
кроткий: кроткого
косо: косо
взрослеть: взрослеют
содержать: содержал
традиционный: традиционного
римский: римскую римских
скачка: скачками
чрезмерно: чрезмерно
арен: аренах
начинать: начинать
ценный: ценные
активно: активно
бульдог: бульдоги бульдогами
белый: белого белый
переносица: переносицы
упрямство: упрямство
вытеснить: вытеснили
висок: висков
эффект: эффекта
декоративный: декоративным
настороженный: насторожен
благородство: благородством
вода: водой
грубоватый: грубоватое
угроза: угрозой
внимательно: внимательно
признание: признание
спортивный: спортивном
кровопролитие: кровопролитиям
взять: взяв
полтора: полутора
мощь: мощь
утратить: утратили
проявить: проявить
пусть: пусть
сам: сама
охрана: охраной
остаться: осталось
сквозняк: сквозняке
дать: данные
поддаваться: поддавайтесь
корпус: корпуса корпусу корпус
запереть: запертым
доминировать: доминирующий
движение: движения движении
ущерб: ущерб
потенциальный: потенциального потенциальных
заметно: заметно
королева: королева
отказываться: отказывались
дальнейший: дальнейшей дальнейшем
день: дня день
труд: труда
гендерный: гендерный гендерного
противопоказанный: противопоказаны
македонский: македонского
перейти: перейти
обнаружение: обнаружении
постараться: постарается
ткань: ткани ткань
из-за: из-за
главное: главное
регулярно: регулярно
четырх: четырх
поведение: поведение
закончиться: закончиться
менее: менее
определять: определяет
тплый: тплыми
составить: составить составит
заядлый: заядлыми
успешный: успешной
бова: бов
тщательный: тщательную
дефект: дефектов
добродушный: добродушным
отдата: отдат
комплимент: комплименты
скуластость: скуластость
грудь: груди грудь
воспаление: воспаление
клетка: клетка клетки клетках
цель: целью
любимец: любимцу любимца
приобретать: приобретать
одиночество: одиночеству одиночество
обзавестись: обзавелись
комок: комок
альбион: альбиона
частичный: частичное частичная
женщина: женщина
запрет: запрет
загнать: загонит
кой: коем
мордочка: мордочка
пик: пик
контролировать: контролировал
веслой: веслой
неться: нестся
запрыгнуть: запрыгнут
схватка: схватки
бездельничать: бездельничать
придерживаться: придерживаться
удлиннный: удлиннные удлиннного удлиннную
вспоминаться: вспоминаются
плохой: худшее
защитник: защитник
оценка: оценке
рубль: рублей
невольно: невольно
родина: родине
коленный: коленных
появиться: появились
охота: охоты
развлечь: развлечь
процветание: процветания
мочка: мочка
акцент: акцент
мирный: мирных мирное
неплохо: неплохо
половина: половину половине
трх: трх
правило: правило правила правил
колея: колеи
внимание: внимание
брахицефальный: брахицефальный
блестящий: блестящей
выпадение: выпадение
прикус: прикуса прикус
аристократ: аристократам аристократов аристократа
визит: визит
храбрый: храбрым
терпимость: терпимость
короткий: короткие короткой
катаракт: катаракту
глубокий: глубокая
отдых: отдыхом
призыв: призывом
тычковый: тычков
мисс: мисс
трепетный: трепетными
иметь: имеет имеют
выставка: выставке
стоимость: стоимость
приобрести: приобрести приобрела
осмотреть: осмотрите осмотреть
особенно: особенно
растянуться: растянуться
желательно: желательно
вынужденно: вынужденно
бишон: бишон
очертание: очертания
сосредоточить: сосредоточен
заблуждение: заблуждение
нравиться: нравится
достаточно: достаточно
трубчатый: трубчатых
подтянутый: подтянуты
международный: международной
чистюля: чистюлям
распространяться: распространяется
фактор: факторов
подшрсток: подшрстком
круглый: круглые круглую
кабанов: кабанов
местоположение: местоположения
редко: редко
мошонка: мошонку
отметить: отметив
холный: холным
кольцо: кольцо
нагрузка: нагрузках нагрузки
зоомагазин: зоомагазина
правильный: правильные правильное
переходить: переходят переходит
европа: европы
рыба: рыбы
азенкур: азенкуром
любитель: любителей
англия: англии
опасность: опасности
несмотря: несмотря
купить: купить
голодный: голодные
признать: признали
часто: часто
подпал: подпалом
склонность: склонность
олений: оленьим
выступать: выступают
елизавета: елизавета
пир: пира пиру
наказание: наказание
завести: завести
грудной: грудной грудная
жирность: жирности
разводить: разводили
загнутый: загнутый
случай: случаях случае
соперничать: соперничая
задача: задача
аджилить: аджилити
ухо: уши
слыть: слывут
диккен: диккен
завоевать: завоевал
нрав: нравом
галоп: галоп
выносливый: выносливых
выворот: выворот
благодатный: благодатной
разгульный: разгульный
безлюдный: безлюдном
наличие: наличие
закруглнный: закруглнными
ромашка: ромашки
необычный: необычном
выгнутый: выгнутой
прослеживаться: прослеживаются
усвоить: усвоить
дисплазия: дисплазию
интересный: интересной
поднимать: поднимать
усугубить: усугубил
треугольник: треугольники
бить: бейте
неоднозначный: неоднозначную
одноклассник: одноклассники
избыточный: избыточную
скорее: скорее
вс: вс
захотеть: захотят
бой: бои
правда: правда
дрессировщик: дрессировщиком
возможность: возможности
уверенность: уверенностью
грозный: грозному
против: против
чистить: чистить
почва: почвой
сильный: сильной
случайный: случайные
ограничиваться: ограничиваются
порядок: порядке
спонсор: спонсоров
два-три: две-три
среднее: среднем среднего
испытывать: испытывают
водный: водных
углубление: углубление
регулярный: регулярные
держаться: держится
предать: преданные
профессиональный: профессиональным
поиск: поиск поисках
рбрами: рбрами
слышный: слышно
нежиться: нежиться
весить: весить
благодарность: благодарность
опускаться: опускается
выполнить: выполнит
волосок: волосков
параллельный: параллельны
потребоваться: потребуется
удалить: удалены
величие: величие
смыкать: смыкает
себя: собой
чадо: чада
основный: основная
некоторый: некоторые
углевод: углеводов
отбор: отбора
период: период
наводить: наводили
дичь: дичь
очко: очков
длительный: длительной длительных
закрепление: закреплении
представить: представлен
теория: теорий
вписаться: впишется
общение: общении
стратегия: стратегии
отвар: отвара
игра: игры
встретить: встретив
лакомство: лакомством лакомств
ранний: раньше
потребность: потребность
периодически: периодически
щетинный: щетинную
кровопролитный: кровопролитных
средство: средство
предок: предков
пуходрка: пуходрки
вовсе: вовсе
линька: линьки линька
нападать: нападают
жизнь: жизни жизнь
два: двух
абсолютно: абсолютно
они: ними
развлечение: развлечения
сильно: сильно
едва: едва
скакательный: скакательных
отказаться: отказаться
ребёнок: детьми
благодаря: благодаря
гласить: гласит
нанести: нанести
ветеринарный: ветеринарную
плечо: плечи
оттого: оттого
группа: группы
доброжелательно: доброжелательно
многогранный: многогранна
молоссова: молоссов
волнистый: волнистая волнистую
сторожевой: сторожевыми
копчность: копчностей
желудок: желудка
соперник: соперником
нужно: нужно
мимимишность: мимимишности
исконно: исконно
азия: азии
вызывать: вызывают
также: также
параметр: параметры
эрдельтерьер: эрдельтерьер
флегматик: флегматиком
ждать: ждать
армия: армии армию
момент: моменты
мягкий: мягким
арена: арены
главенство: главенство
симметричный: симметричные
секрет: секрет
прошлое: прошлого
бегать: бегать
желание: желания
побег: побегам
кончик: кончику
оставить: оставит
опасаться: опасаться
жстковать: жсткую
клык: клыки
щк: щк
брылястость: брылястость
живот: живота
поясница: поясница
устойчивый: устойчивым
волноваться: волноваться
манипулировать: манипулировать
растянутый: растянутый
наследство: наследство
продолжать: продолжали
рим: рима
поступок: поступке
нора: нора
каша: каша
всемогущий: всемогущей
кариес: кариес
кропотливый: кропотливую
ежедневный: ежедневных
высоко: высоко
агрессия: агрессию
критерий: критерий
зал: зале
великолепно: великолепно
ягода: ягод
сложно: сложно
складка: складки
крипторхизм: крипторхизм
новичок: новичкам
отмереть: отмерших
нанесть: нанест
крайне: крайне
область: области
стоить: стоит
очищать: очищайте
раскрыть: раскрыть
кроун: кроун
мелкий: мелкую
ласка: ласку
достойный: достойные
зависеть: зависит
порка: порок
кормить: кормить
царь: царь
эмаль: эмали
смочь: сможет
кусочек: кусочек
тибетский: тибетский
любить: любят
имущество: имущества
зрелищный: зрелищную
отвесный: отвесные отвесным
страх: страх
хитрость: хитрости
стол: стола
профиль: профиль
джентльмен: джентльмена
лоскут: лоскута
усыплять: усыпляли
молоко: молоком молока
нелишний: нелишним
отдельный: отдельных
эмигрант: эмигрант
безобидный: безобидными
полный: полное
давать: давало
злой: злой
легко: легко
многий: многих
объятие: объятия объятиями
спорт: спортом
манера: манера
сохранить: сохранить
свежеть: свежей
бык: быками
лента: ленту
громко: громко
обстановка: обстановка
селекция: селекцию
воспитать: воспитать
шрстка: шрстка
известно: известно
шип: шипами
хватка: хваткой
яблоко: яблокам
слаженный: слаженной
ватный: ватным
лошадь: лошадей
амплуа: амплуа
многое: многом
продолжительный: продолжительного
месяц: месяцев
график: график
полководец: полководец полководца
гладкошрстный: гладкошрстный
участвовать: участвовал
медведь: медведями
косолапость: косолапость
великан: великана великанах
упорство: упорством
вакансия: вакансии
прямо: прямо
немногочисленный: немногочисленным
возвращение: возвращения
покой: покоя
окружающий: окружающая
знакомство: знакомство
начинаться: начинается
увесистый: увесистыми
постоянно: постоянно
план: плане
специя: специй
по-другому: по-другому
сей: сей
голень: голени
выше: выше
вводить: вводят
нервозный: нервозное
заводчик: заводчика
окрасить: окрашены окрашена
сказка: сказок
цениться: ценились
обойтись: обойтись
вместе: вместе
столетие: столетия
ям: ямах
призрачный: призрачный
кишечник: кишечника
уничтожить: уничтожили
верный: верна
ещ: ещ
любимый: любимые любимым
строптивый: строптивого
щенячий: щенячьих
изгиб: изгиб
пот: пот
сосед: соседям
вздутие: вздутие
практически: практически
рейтинг: рейтинг
похвастать: похвастать
генетический: генетических
скорость: скорости
александр: александра
хищник: хищников
претендент: претендентов
непрошеный: непрошеного
избавиться: избавиться
возникнуть: возник
независимо: независимо
подписываться: подписывайтесь
ген: генами
мудрость: мудрость
импозантный: импозантных
налта: налт
самостоятельно: самостоятельно
травмоопасный: травмоопасную
тепло: тепле
сырой: сырой
запретить: запрещено
очень: очень
поучиться: поучиться
бутилировать: бутилированную
селекционер: селекционеры
особый: особой
подпольный: подпольного
показаться: покажется
поводок: поводка
вина: виной
выполнять: выполнять
некипячный: некипячной
второе: второе
покраснение: покраснение
грызун: грызунам
кошачий: кошачьей
инстинкт: инстинкт
постепенно: постепенно
наравне: наравне
довольно: довольно
частность: частности
представление: представление
высадиться: высадились
надбровный: надбровные
египет: египта
экземпляр: экземпляр
удаление: удаления
касаться: касается
необходимый: необходимые
возрождение: возрождение
гладиаторский: гладиаторских
приплюснуть: приплюснута
променад: променада
лидер: лидера
трюк: трюкам трюк
проект: проекте
гибель: гибелью
закоренелый: закоренелые закоренелым
недопустимо: недопустимо
угол: угол
найдт: найдт
выбить: выбить
спаниель: спаниель
пора: пор
завтрак: завтрак
очертить: очерчены
кг: кг
насколько: насколько
необходимость: необходимости
молоссоидный: молоссоидного
пристальный: пристального
паровоз: паровоза
перчатка: перчатки
горизонтальный: горизонтальной
коготь: когтях
страна: страна
низко: низко
повлечь: повлечь
понежиться: понежиться
инбридинг: инбридинга
встречаться: встречались
звук: звуками
пройти: пройденный
противоположный: противоположного
распространнный: распространнных
стая: стае
довольный: довольный
военачальник: военачальник
использоваться: использовались
исторический: исторические
звериный: звериных
глазок: глазки
холодный: холодным
плюсна: плюсны
событие: события
вавилон: вавилона
глубина: глубине
ширина: ширина
разработка: разработку
бугор: бугор
конечность: конечности
закрепить: закреплено
ясный: ясными
затруднять: затрудняет
расставить: расставлены
хвост: хвост
формула: формулу
чай: чая
рысью: рысью
дом: доме
узурпировать: узурпирует
драться: драться
мускулистый: мускулистые
г: г
простолюдин: простолюдины
могучий: могучий
лев: львов
неопущение: неопущение
финикийский: финикийскими
вызов: вызов
линейно: линейно
какой: каких
