иметь: имели имейте имеет иметь имеющих
психически: психически
процесс: процессе
овощ: овощи
котейка: котейка
брутальный: брутальную
противник: противника
тело: тела тело
американский: американских американскому американский американским американские американского
кровь: крови кровей
средний: средняя среднюю
внеплановый: внеплановых
посторонний: посторонних
чёрный: черный
сколько: сколько
название: название названия
собака: собаку собакой собак собака собакам собаке собаки
вывести: вывести выведенный
переезд: переезда
открытый: открытом
заранее: заранее
обсуждение: обсуждения
специализация: специализации
зависимость: зависимость зависимости
рукавица: рукавицей
цена: цена
доставка: доставку
любой: любая любое любой
генетический: генетические
мастиф: мастифы мастифа мастифами мастиф мастифов
материал: материалов
племенной: племенные племенного
перевод: переводе
владелец: владельцам владельцев владельцу владельцами владелец
коррекция: коррекция
поведение: поведения
мелькать: мелькают
силиконовый: силиконовой
морской: морская
потенциально: потенциально
семейство: семейства
русский: русский
россия: россия
протирание: протирание
рекомендовать: рекомендовано рекомендуют
забыть: забудьте
итог: итоге
обратный: обратная
жкт: жкт
учёт: учетом учета
представитель: представителей представитель представителями представители
искать: искать
шанс: шанс шанса
особенность: особенностью
способный: способные способна
шерсть: шерсть шерсти шерстью
атаковать: атаковавшие
по-разному: по-разному
запретить: запрещена запрещен запрещено
кинолог: кинологи кинологом
рыба: рыба
держать: держат держать
общеизвестный: общеизвестных
должный: должны должен
случайно: случайно
тип: тип типа
главный: главной главная
нарушение: нарушения нарушении нарушение
заблуждение: заблуждений
предупреждение: предупреждения
песочно-серый: песочно-серый
сегодняшний: сегодняшних сегодняшний
клан: клану
человек: людям людей человеку
лидервожак: лидервожак
питомец: питомцами питомцев питомец питомца питомцем
поселить: поселить
бурбуля: бурбулей бурбуля
тонкий: тонкий
отступление: отступления
участвовать: участвует
гуманный: гуманный
включая: включая
заставить: заставьте
обязательный: обязателен обязательные
важно: важно
дополнительный: дополнительный
американец: американца американцев американец
история: история историю
свирепость: свирепость
промышленный: промышленные
анализ: анализов
кинологический: кинологических
месяц: месяцы месяца
щенок: щенка щенков щенки щенок
выгул: выгул выгулами выгуле
скупиться: скупитесь
нерафинированный: нерафинированное
негативный: негативная
усвоить: усвоены
приносить: приносящее
каждый: каждого
гарантировать: гарантирована
чувство: чувством
попасть: попасть попавшие
неконтролируемый: неконтролируемое
характеристика: характеристика характеристики
грубый: грубого
помощь: помощью
физически: физически
окрик: окрики
заворот: заворот
швейцария: швейцарию
индивидуальный: индивидуальных
бойцовский: бойцовским
джо: джо
избыток: избытком
кардинально: кардинально
незнакомец: незнакомца
видео: видео
помимо: помимо
физический: физическую физическое физические
признать: признана
полностью: полностью
вода: воды воду
никакой: никаких
расти: росли
смысл: смысл
условие: условии условия
зоомагазин: зоомагазине
домашний: домашних домашними
необычный: необычных
среднестатистический: среднестатистических среднестатистический
использоваться: использовался используется
интернет-сервис: интернет-сервисах
такой: таких такого
локтевой: локтевого
организаторский: организаторские
солидный: солидную
содержание: содержание содержания
стать: станут стать
заниматься: занимавшимся заниматься занимающихся
собственный: собственного собственное
сера: серы
потомок: потомком потомок потомки
намордник: намордника намордником намордник
нагружать: нагружать
аналог: аналог
составлять: составляет
подбор: подбор подбора
ринг: ринге
натуральный: натуральном натуральных
табличка: табличкой
окрас: окраса окрас
чёткий: четкого
пищевой: пищевое
ветеринар: ветеринару
комплекс: комплексе комплекс
масло: масло
изменение: изменение
территория: территорию территории
связь: связь
точно: точно
сформировать: сформировать сформируйте
заводить: заводя
превратить: превратив
правильный: правильную правильный
минимум: минимуму
частный: частном
пока: пока
система: систему
итальянский: итальянских
внешний: внешние
вязка: вязки вязок
предупреждать: предупреждающий предупреждающей
растительный: растительное
год: годах лет
возраст: возрасту возрастом возраст
перейти: перешедшие перейти
типичный: типичный типичные
расслабиться: расслабиться
сильный: сильных сильного
методика: методику
явление: явления явление
страшноватый: страшновато
признак: признаки
стаффорд: стаффорды
качество: качестве качества
брутала: бруталам
поле: поле полям
смотреть: см
еда: едой
способность: способности
плюс: плюс
фотография: фотографии
уход: уходе уход
рваный: рваных
запрыгивать: запрыгивать
создание: создания
осмотр: осмотрами
помнить: помните
изящный: изящнее
законодательно: законодательно
результат: результат
дать: данной
ряд: ряде ряд
высокий: высокая высокие
смелый: смелого
питомник: питомники питомников
неаполитанский: неаполитанские неаполитанского
противостояние: противостоянию
глаз: глаза глаз глазах
район: районе
самый: самый
обзаводиться: обзаводиться
серьёзный: серьезным серьезная серьезные
прийтись: придется
следствие: следствием
занятость: занятость
закормить: закормленными
рейтинг: рейтинги рейтинг
специфика: специфика
витаминно-минеральный: витаминно-минеральный
дог: дога догов
век: века век
наследовать: наследует
существовать: существуют существует
слюноотделение: слюноотделение
грань: гранью
реакция: реакция
поскольку: поскольку
краткий: краткая
весьма: весьма
обзавестись: обзавестись
преследовать: преследует
врождённый: врожденная врожденную
отношение: отношение отношении отношения
заболевание: заболеваниям заболевания
место: место местах
компания: компанию
исключительно: исключительно
применять: применяли
превосходство: превосходство
эксперт: экспертов
разводиться: разводится
удаление: удаление
вконтакте: вконтакте
создать: создать
прогрессировать: прогрессирующая
авить: авито
разведение: разведением разведении разведение разведения разведению
хозяин: хозяин хозяина
лишённый: лишенные
обойтись: обойдутся обойдется
отличительный: отличительная отличительными
молодой: молодая моложе
запоминать: запоминать
фрисби-диск: фрисби-диском
ценник: ценник
животное: животных животным животные животное
один: одного
одинаково: одинаково
сша: сша
договориться: договориться
общий: общий общие общем
появление: появления
слабохарактерный: слабохарактерного
лидер: лидер лидера
популярный: популярный
характер: характером характера характер
выбрать: выбрать
подсолнечный: подсолнечное
углевод: углеводы
облик: облик
оценить: оцените
птица: птица
взрывной: взрывным
рабочий: рабочим рабочей
основать: основана
хотя: хотя
присмотр: присмотра
поджарый: поджарые
х: х
бандог: бандогу бандоги бандога бандогом бандогам бандогов бандог
фил: фила
прочный: прочный
больший: большая
который: которую которое которой которая которых которым которые который
пасть: пасть
породный: породный породному
негде: негде
амстафф: амстаффов амстаффа
лесной: лесным
официально: официально
информация: информация
обладать: обладает
подходить: подходит
телосложение: телосложение
проходить: проходят
максимально: максимально
большой: большое
полноценный: полноценные полноценными
мочь: могли могут можете
воспитанный: воспитанных
авторитет: авторитет авторитета
остальной: остальных
улица: улицы
сообразительность: сообразительность
подхватывание: подхватывание
пожилой: пожилая
ладить: ладят ладит
исторический: исторических
подобрать: подберет подберите
габарит: габариты габаритами
перебарщивать: перебарщивать
добыча: добыча
последовать: последовать
крупа: крупы
истолковать: истолкует
профилактический: профилактическим
это: этим это
программа: программы
считаться: считается считаются
норма: нормы
формально: формально
загрязнение: загрязнения загрязнений
просто: просто
популяризация: популяризацией
заяц: зайцы
желать: желающих
одиночество: одиночестве одиночеству
некомфортно: некомфортно
рыжий: рыжий
гулять: гуляя гулять
структура: структура
согревать: согревающей
угроза: угрозы
массово: массово
утяжелитель: утяжелителями
низкий: низкая
заняться: занявшихся заняться
тон: тона
соцсеть: соцсетях
безукоризненно: безукоризненно
развивать: развивать
словакия: словакии
добавить: добавьте
чистка: чистка
изменить: изменили
прогулка: прогулки
предрасположенность: предрасположенность
умеренный: умеренная
происхождение: происхождения
готовый: готовы готовый готовые
первый: первые первым первую первых
пиренейский: пиренейская
совать: совать
смириться: смиритесь
первобытный: первобытной
согреть: согреть
психика: психику
перманентный: перманентного
бульдог: бульдога бульдогов
терпеть: терпеть
дрессировка: дрессировка дрессировки
стандартный: стандартный стандартных стандартной
время: время времени
сука: суки сука
агрессивность: агрессивность
суровый: суровый суровым
требовать: требует
день: дней день
деятельность: деятельности
кость: костей
они: ими
другой: другие других другими
использовать: используйте использует использовать
подливать: подливайте
терпение: терпения
минусовый: минусовой
кли-кай: кли-кай
например: например
несколько: несколько
сетчатка: сетчатки
отличный: отличная отличные
рост: рост росте
опыт: опыты
потомство: потомство
дух: духом
производитель: производителями производителей
хотеться: хочется
процедура: процедурой процедуры
радостно: радостно
к: ко
реклама: реклама
получить: получите
макроэлемент: макроэлементами
использование: использованием
линять: линяет
первенство: первенство
организм: организм организма
грызун: грызуны
немедленно: немедленно
выраженный: выраженным выраженное
соседство: соседство
окд: окд
воспитание: воспитание воспитании
регистрироваться: регистрируется
грубость: грубость
эксперимент: эксперименты
мирно: мирно
вид: виду виде вид
распознавать: распознавать
сайт: сайту
сухой: сухие
свободный: свободного свободных
похвала: похвалу
занять: занять
полезно: полезно
схема: схеме
реагировать: реагирует
получиться: получились
социализация: социализация
дорогой: дорогое
крупный: крупная крупных крупными
мисочка-лежак: мисочек-лежаков
этот: эта
лишь: лишь
вариант: вариант варианты
стрижка: стрижка
перекормить: перекормленные
экстерьер: экстерьер экстерьера
признавать: признавать
нападение: нападению
оболочка: оболочка
форум: форум форуме
подкрепление: подкрепление
протяжение: протяжении
сушка: сушки
уточнять: уточняйте
боль: боль
расширять: расширять
психотип: психотип
лениться: ленитесь
десяток: десятка
группа: группах
обработка: обработки
выразительный: выразительный
позволять: позволяющая
разнообразный: разнообразные
привить: привиты
строгий: строгий
описание: описание
начало: начало
питбультерьер: питбультерьера питбультерьерами
миф: мифов
улучшение: улучшений
подчиняться: подчиняться
второй: второго
найти: найти
собачий: собачьих собачьи
однако: однако
искренне: искренне
обитать: обитает
поэтому: поэтому
случай: случаев случаях случае
копирование: копирование
короткий: короткий короткие короткая короткой
активность: активность
дружелюбность: дружелюбность
бордоский: бордоского бордоских
отзыв: отзывах отзывы
перечень: перечень
переходить: переходить
кошка: кошки
следовать: следует
обходить: обходите
животный: животному
оценка: оценки оценке
шум: шум
заметный: заметное
висячий: висячие
черта: черт чертами черта
особь: особи особей
сомнение: сомнений
мать: матери
худой: худыми
настоятельно: настоятельно
преимущественно: преимущественно
планировать: планируете
оттенок: оттенка
настоящий: настоящий
онкологический: онкологическим
осторожно: осторожно
дом: дома доме
скопиться: скопившейся
задача: задачи
предпочтительно: предпочтительно
ламинария: ламинария
порода: породы пород порода
термин: термин
ухо: ушей уши
принимать: принимавших
линия: линиях линий линии
целое: целом
объявление: объявления
выверять: выверять
наполовину: наполовину
основной: основные
элементарно: элементарно
новый: новую новый
привлекаться: привлекались
бытовой: бытовые
какой: каким какие
важный: важна
интеллект: интеллект интеллекта
охранный: охранные
покупать: покупайте
средне: средне
вес: вес
конец: конец
действие: действиях действием
утка: утки
тёмный: темного
тиреоидит: тиреоидит
ежедневно: ежедневно
позитивный: позитивное
пара: пар пару
слово: слов
голова: голову
подходящий: подходящая
именно: именно
рот: рта
продолжительность: продолжительность
влажный: влажной
процент: процент
обучать: обучая
бульмастиф: бульмастифа бульмастифов
отлично: отлично
трезво: трезво
обеспечить: обеспечить
доходить: доходит
положение: положении
угодье: угодьям
входить: входит
маленький: маленькими маленьких
зависеть: зависел зависит
лидерство: лидерства
золотисто-палевый: золотисто-палевый
подход: подход
обыватель: обывателей
щенок-подросток: щенков-подростков
питбуля: питбули питбуля питбулей питбулями
опасный: опасных
выплёскивать: выплескивать
фото: фото
идея: идея
резервирование: резервирования
ран: ран
сам: самого сама
яндекс: яндекс
количество: количество количества
участие: участие участия
выглядеть: выглядеть
пытаться: пытаться
оставлять: оставлять
мысль: мыслью
оставить: оставьте
исполняться: исполняться
ставить: ставить
уровень: уровень
холка: холке
предпочтение: предпочтений
характерный: характерно
двор: дворе
решить: решит
журнал: журнал
весь: всей всем
высота: высота
смыть: смыть
зелень: зелень
насилие: насилие
уголок: уголков
бойцовый: бойцовой бойцовых
тот: та тех тому
предпочитать: предпочитая
практиковать: практикующим
обычный: обычной
покров: покров
получать: получают
болезнь: болезни
уступка: уступки
ребёнок: дети детей детьми
изредка: изредка
целиком: целиком
заводчик: заводчиков заводчика
разозлить: разозлить
грязеотталкивать: грязеотталкивающим
нападать: нападает
возникнуть: возникнуть
образ: образом
доля: доля
доказывать: доказывать
европейский: европейских
поверхностный: поверхностные
унаследовать: унаследует
страна: страну стран страна
терять: теряя
признание: признание
посетить: посетить
лёт: лету
мощь: мощь
мускулистый: мускулистое
охрана: охраной
остаться: осталось
плохо: плохо
прирождённый: прирожденный
уважительный: уважительного
резкий: резкое
причинить: причиненную
помета: помете помета
дело: дело
скрещивание: скрещивания
реально: реально
продажа: продаже
возбудить: возбужденной
охранно-сторожевой: охранно-сторожевой
из-за: из-за
главное: главное
кан-корсо: кане-корсо
коготь: когтей
усиливаться: усиливается
большинство: большинством большинство
сушёный: сушеная
менее: менее
надежда: надежду
ген: генов
вероятный: вероятного
безграничный: безграничен
принадлежность: принадлежности
давать: давайте
требование: требования требований
лежать: лежащего
цель: целью
ткань: тканью
вести: ведут
слишком: слишком
ошибка: ошибки ошибка
будущее: будущего
убедить: убедить
ограничиться: ограничьтесь
гибридный: гибридных
мем: мем
согласиться: согласится
клуб: клубом
стандарт: стандарта стандарт
атрофия: атрофия
гигиена: гигиена
опоздать: опоздать
позволить: позволить
косточка-зубочистка: косточек-зубочисток
нестабильный: нестабильных нестабильную
семья: семью семьях семье
бой: боях бои
дорого: дорого
ветклиника: ветклиниках
разрешение: разрешений
жажда: жажду
команда: команд команды команда
стул: стула
малоопытный: малоопытным
чей: чей
неплохо: неплохо
обновить: обновить
полость: полости
постный: постное
правило: правило правила правил
игрушка: игрушки
наличие: наличии
жидкость: жидкости
выпадение: выпадение
разумеется: разумеется
пренебрегать: пренебрегать
идти: идет
граница: границ
управляемый: управляемый
удачный: удачными
легендарный: легендарный
происходить: происходило
льняной: льняное
английский: английскими английского
встать: встать
редкий: редкий
стоимость: стоимость
чистый: чистом чистой
длительный: длительному
управленческий: управленческие
обретать: обретает
иначе: иначе
особенно: особенно
охотничий: охотничий
струя: струей
поводок-водилка: поводок-водилку
жёсткий: жесткая
воля: волю
волосопад: волосопадов
необходимый: необходимыми
грюнендалить: грюнендаль
достаточно: достаточно
обязательно: обязательно
свой: свое свои
сложный: сложное сложная
сложность: сложности
пачкаться: пачкается
лучеро: лучеро
редко: редко
сочетаться: сочетается
имя: имя
бесплатный: бесплатных
нередкий: нередки
примесь: примесей
ранний: ранняя
связанный: связанные
англия: англии
понимать: понимать
любитель: любителей
несмотря: несмотря
кусать: кусает
водоём: водоемов
купить: купить
плотный: плотный
спорт: спорт
подкормка: подкормок
инстинкт: инстинктом
парфорс: парфорс
неплохой: неплохие
некоторый: некоторое
путь: пути
ниша: нишу
период: периоды период
растерзать: растерзать
непременно: непременно
бандогга: бандогги
наступить: наступило
предок: предки
сторона: сторону
степень: степень
аляскинский: аляскинский
выбирать: выбирать
дополнять: дополнять
подстраховаться: подстрахуйтесь
микро: микро
оказаться: оказались
провокация: провокации
здоровый: здоровый
послушание: послушание
расстройство: расстройство
домочадец: домочадцев
питьевой: питьевую
умертвить: умерщвленные
патология: патологии
далеко: далеко
совмещать: совмещать
одноклассник: одноклассники
марка: марки
запрет: запретов
скорее: скорее
путём: путем
прийти: пришла
дисплазия: дисплазия
буквальный: буквальный
против: против
случайный: случайные
чётко: четко
мясо: мясо
наблюдаться: наблюдается
компенсироваться: компенсируются
взять: взять
жестоко: жестоко
выдача: выдачей
частый: чаще
поиск: поиск
слышный: слышно
оптимальный: оптимальный
весить: весить
тазобедренный: тазобедренного
парка: парку
питание: питании
есть: ест
потребоваться: потребуется
скучать: скучающий
сдача: сдачей
защищённость: защищенности
реалия: реалиях
зрение: зрения
щётка: щеткой
тигровый: тигровый
сделать: сделано
гигиенический: гигиенические
потребность: потребность
память: память
упитанность: упитанности
расход: расходов
вовсе: вовсе
генофонд: генофонд
жизнь: жизни
современный: современных
думать: думающий
выход: выхода
находиться: находитесь
забывать: забывайте
драка: драка
рука: руку
сильно: сильно
рельеф: рельеф
глубокий: глубокому
едва: едва
отказаться: отказаться
девочка: девочки
подзыв: подзыва
строение: строением
небольшой: небольшой
впервые: впервые
фамилия: фамилии
ассоциация: ассоциаций
связка: связке
доброжелательно: доброжелательно
песок: песку
лежачий: лежачем
желудок: желудка
отличать: отличает
относительно: относительно
нужно: нужно
мимимишность: мимимишности
отапливать: отапливаемое
также: также
шёрстный: шерстный
ждать: ждать
предел: предел
помочь: поможет
момент: моменты
хороший: лучшими хорошее
возможно: возможно
удивительный: удивительным
выходить: выходит
охота: охотой
отсюда: отсюда
боец: бойцы
сезон: сезонам
повлиять: повлияла
изначально: изначально
агрессия: агрессию агрессией
лакомство: лакомства
крайне: крайне
выпускать: выпускайте
стоить: стоит
максимальный: максимальную
эпилепсия: эпилепсия
ласка: ласку
инвентарь: инвентарь
кобель: кобель
сведение: сведению
вполне: вполне
психопат: психопат
перемещать: перемещать
впечатление: впечатлений
недуг: недуги
любить: любят
выставлять: выставлять
невозможно: невозможно
занятие: занятие
убрать: убрать
стараться: старайтесь
умение: умения
прыжок: прыжки
молоко: молоком
отдельный: отдельных
различаться: различаться
злой: злая
альфа-статус: альфа-статус
легко: легко
многий: многих
допустимый: допустимой
останавливать: останавливая
температура: температуре
лента: ленту
специальный: специальную
здоровье: здоровье
потенциальный: потенциальная
порция: порции
встреча: встреч
малыш: малыша
сверхбрутальный: сверхбрутальный
регулярный: регулярной
помещение: помещение
специалист: специалиста
оценивать: оценивайте
лай: лай
управление: управлении
многое: многом
податливый: податливее
подавить: подавить
горный: горная
безопасность: безопасности
неправильный: неправильного
воздух: воздухе
навык: навык
разновидность: разновидность
стремиться: стремитесь
возможный: возможна
вакансия: вакансии
поводок: поводок поводка
собаконенавистник: собаконенавистники
сторожевой: сторожевая
достаточный: достаточного
знакомство: знакомство
служебник: служебники
трата: тратам
проводиться: проводились
начинаться: начинается
зимний: зимний
мастифоподобный: мастифоподобным
целеустремлённый: целеустремленные
своеобразный: своеобразные
разрушительный: разрушительное
выше: выше
нежелательный: нежелательных
палевый: палевый
единственный: единственное
управлять: управлять
вместе: вместе
отправиться: отправиться
чересчур: чересчур
принести: принесенный
любимый: любимые
распространить: распространенные
корм: корма
аутоиммунный: аутоиммунный
тёплый: теплой
собака-убийца: собак-убийц
практически: практически
выясниться: выяснилось
объём: объем
проблема: проблем
квалификация: квалификацией
подписываться: подписывайтесь
пройти: пройдешь
несправедливость: несправедливость
успокоиться: успокоиться
учёба: учебе
придерживаться: придерживайтесь
шустрый: шустрого
очень: очень
содержать: содержите
мышечный: мышечный
купание: купаниями
нагрузка: нагрузки
выполнять: выполнять
узнать: узнайте
наиболее: наиболее
бразилейро: бразилейро
наоборот: наоборот
продолжаться: продолжается
кличка: клички
вблизи: вблизи
список: список
исключительный: исключительных
готовиться: готовьтесь
обучение: обучением
возможность: возможность
впитывать: впитывающие
касаться: касается
мороз: мороз
одновременно: одновременно
шампунь: шампуня
проект: проекте
сразу: сразу
зуб: зубов
спаниель: спаниель
пора: пор
кг: кг
необходимость: необходимости
энергичность: энергичность
сидеть: сидеть
каникросс: каникроссом
бультерьер: бультерьера
среднее: среднего
вектор: вектор
линька: линька
ошейник: ошейник
ответ: ответ
ситуация: ситуаций
действительно: действительно
рф: рф
уличный: уличного
тактика: тактика
радужный: радужная
адекватный: адекватный
сустав: суставов
прокачать: прокачанный
непросто: непросто
пояс: поясом
причём: причем
мирный: мирное
свинфорд: свинфорд
попробовать: попробуйте
родитель: родителей
вызывать: вызывает
кормление: кормление
последний: последней
победный: победного
территориальный: территориальных
сыграть: сыграла
стремительно: стремительно
пыль: пыли
селекционный: селекционные
табу: табу
встречаться: встречаются
бег: бег
палочка: палочки
