низ: низ
уход: уход уходе ухода
донести: донесет
отлично: отлично
сам: сами самими самого
гиперактивный: гиперактивный
линия: линия линий линии линиях
возбудимый: возбудимых
корова: коров
содержаться: содержаться
держаться: держится
пёс: пес
нежиться: нежится
низкий: низкую низкого низкая
вряд: вряд
поиск: поиск поиски
спортивный: спортивный спортивной
шерсть: шерсти шерсть
ситуация: ситуациях
тело: тела тело
принадлежать: принадлежит
американский: американских
общий: общего общее
мука: мукой
средний: средняя среднее средний средних
упустить: упущенное
скрещивать: скрещивать
положение: положении
идеальный: идеальный идеальной
опыт: опыт опыта
зуб: зубы зубьями зубов
беспричинный: беспричинный
оттенок: оттенок
время: времен время
кормить: кормящие
собака: собака собаку собаке собак собаки собаках
скрестить: скрестил
шампунь: шампунь
питание: питании питания
чёрный: черный черные черную черном черного
сколько: сколько
храбрец: храбрец
соплеменник: соплеменниками
свой: своей своих своему своим
ранний: ранней раньше
отвар: отваром
предполагать: предполагающее
объясняться: объясняется
чайный: чайным
прародитель: прародителями
размер: размера размером
колтун: колтунов
характер: характер характера характеру
неуравновешенный: неуравновешенных
название: название
квартира: квартире квартира
себя: собой
разочаровать: разочарованные
прошлое: прошлое
процесс: процессом
округлый: округлой
белые: белые
стать: станет стало
вокруг: вокруг
выглядеть: выглядят выглядеть выглядя
сложение: сложение
учиться: учиться
система: системе систем
информация: информация информацию
расчёсывание: расчесывание
подходить: подходит
купировать: купированный
суровый: суровым
помета: помета помет
обсуждение: обсуждения
опасный: опасных
отношение: отношениях отношение отношения
год: год годы лет году
большой: большое большой
ветаптека: ветаптеки
сплошной: сплошного сплошной
салфетка: салфеткой
цена: цена цены
фото: фото
будущее: будущем
миндалевидный: миндалевидные
помогать: помогали
нормальный: нормального
уцелеть: уцелевших
правильный: правильный
развлекать: развлекает
гребень: гребнем
кончик: кончика кончиком
подход: подходом
корить: корена
грюнендать: грюнендали
подушечка: подушечки
м: м
сделать: сделанное сделано сделать
любой: любая любые
сука: сука суки суку
нос: нос
игра: игры игр
раненый: раненых
авторитет: авторитет
негативно: негативно
ниже: ниже
кошка: кошкой кошки
выбор: выбор
материал: материалов
гигиенический: гигиенические
животное: животного животное животным животных
потребность: потребность потребности
кузен: кузен
окрас: окрас окрасами окраса
стараться: старается
предотвратить: предотвратить
порок: пороки
желе: желе
яндекс: яндекс
вливаться: вливается
количество: количество количеством
единый: единую
сложный: сложных
крепкий: крепкие крепкая
заинтересовать: заинтересовано
давать: дают
владелец: владелец владельцев
выносливый: вынослив выносливая выносливого
недокус: недокус
россия: россии россия
сухой: сухой
половина: половина
пёс-пастух: псы-пастухи
линька: линьки линька
ребёнок: детям дети ребенком
жизнь: жизни жизнь
собака-поводырь: собак-поводырей
пастуший: пастушьих пастушья пастушьим
бельгийский: бельгийской бельгийских бельгийская бельгийский бельгийские бельгийское
гармонично: гармонично
участие: участие
режим: режим
поклонник: поклонники
семейный: семейная
пушистый: пушистый
стоять: стоят
среди: среди
разыскивать: разыскивали
овчарка: овчарка овчарками овчарки овчарок
зарекомендовать: зарекомендовали
небольшой: небольшая небольшое небольшие
пытаться: пытаться
дом: дом
дисквалифицировать: дисквалифицирующие
потомство: потомством потомство
пятно: пятнами пятна
больший: большим большие большей
самый: самых самым
истощить: истощена
категорически: категорически
поголовье: поголовье
питомник: питомника питомников питомники
веко: веки
роскошный: роскошный
благодаря: благодаря
зато: зато
лапа: лапы
петит: петит
детский: детские
плохой: плохом
программа: программы
разведение: разведению разведения
такой: такую таким
холка: холке
неугомонный: неугомонный
нетипичный: нетипичный нетипичные
радикальный: радикальным
итог: итоге итог
доминантный: доминантные доминантных
позаниматься: позаниматься
отпустить: отпущенная отпустить
соединить: соединенных
обратный: обратная
голландский: голландскими
здоровье: здоровью здоровье
выпуклость: выпуклость
следующий: следующих
двор: дворе
радужка: радужки
журнал: журнал
каприз: капризу
рабочий: рабочих рабочая
ассоциация: ассоциаций
натуралка: натуралка
вкусняшка: вкусняшка
российский: российских российские
высота: высота
воспитывать: воспитывать
разгрузить: разгрузить
команда: команду команда
загрязнение: загрязнения
поставить: поставленная
предусмотреть: предусмотреть
попробовать: попробовать
спрей: спреи
облегчать: облегчающие
что-то: чем-то
шея: шея шеи
волос: волосом
рука: руки
роуза: роуза
затылочный: затылочного
противопоказание: противопоказаний
просто: просто
кличка: кличке клички
стоимость: стоимости стоимость
забрать: забрать
изгиб: изгибом
рассчитывать: рассчитывают
сука-овчарка: суку-овчарку
испытание: испытаниям
подвижный: подвижная
страна: стране страна
отличать: отличает
относительно: относительно
нужно: нужно
шоу: шоу
мимимишность: мимимишности
также: также
гость: гостя
мощный: мощного
подчеркнуть: подчеркнуто
умный: умная умных
челюсть: челюсти
взрывной: взрывной
один: одну
хозяин: хозяину хозяин
принять: принято примет
воспитание: воспитания воспитание
разряжаться: разряжается
частый: частыми частое
порядок: порядка
должный: должны должен
запрещать: запрещает
шёрстный: шерстный
стоячий: стоячем
покров: покров
нервный: нервных
покупка: покупки
болезнь: болезни
цель: цели целей
момент: моменты момента момент
окружающий: окружающих
факт: факту факт
исключение: исключение
приятный: приятным
внутри: внутри
задача: задач
свидетельствовать: свидетельствует
абсолютно: абсолютно
мировой: мировой
жабо: жабо
грюнендалить: грюнендаля грюнендаль грюнендалю
отзыв: отзывы отзывах
малый: меньшей
сегодняшний: сегодняшних
грюнендаль-переросток: грюнендаля-переростка
энтлебухер: энтлебухер
человек: людям
относиться: относится относиться
всякий: всяких
зона: зоны зоне
либо: либо
беготня: беготни
терпеливо: терпеливо
рассматривать: рассматривает
считать: считать
корпус: корпус
мягкий: мягче мягкими
штат: штатах
активно: активно
сильный: сильного
некоторый: некоторых
хороший: лучший хорошим хорошие
элегантность: элегантность
молодой: молодой
добавить: добавьте
стандарт: стандарт стандартом
мочь: мог могут можете
прогулка: прогулки
отсюда: отсюда
ценность: ценность
бельгиец: бельгийцем бельгийца бельгийцев
нога: ног
отличаться: отличается отличаются
умеренный: умеренная умеренное
известный: известна
происхождение: происхождения
покатый: покатым
найти: найденных
громкий: громкое
необходимо: необходимо
формирование: формирование
удлинённый: удлиненной удлиненная
наследовать: наследуют
глаз: глаз глаза
показатель: показатель показателям
тяжесть: тяжести
достигать: достигать
парковый: парков
оставаться: остается
истерик: истерик
вода: водой
история: история
который: которым которой
велосипедист: велосипедистами
брать: брать
созревание: созревания
кинологический: кинологических
высоко: высоко
агрессия: агрессию агрессией
щенок: щенка щенки щенков щенкам щенок
щенячий: щенячью
конкретно: конкретно
спохватиться: спохватился
проверять: проверять
смелый: смелые
белок: белка
нормально: нормально
черта: черты
психика: психику
условие: условиям условия
кобель: кобеля кобели кобель кобелем
тщательно: тщательно
интеллектуал: интеллектуал
систематический: систематический систематических
поисковик-спасатель: поисковиков-спасателей
сложно: сложно
обнаружить: обнаруженные
подвес: подвеса
набор: набору
крайне: крайне
дрессировка: дрессировка дрессировкой
голос: голосом
стоить: стоит
это: это
готовый: готовым
раскрыть: раскрыть
отнестись: отнесется
связка: связок
эпилепсия: эпилепсия
пробежка: пробежках
агрессивность: агрессивность
существо: существа
различаться: различающихся
лакенуа: лакенуа
кто: кому
портрет: портрет
интересно: интересно
любить: любит
питомец: питомца питомец
калораж: калораж
половой: полового
банхар: банхар
ножницеобразный: ножницеобразный
расслабить: расслабленного
шесть: шесть
формировать: формирует
перекус: перекус
достойный: достойные
день: дней дня день
вес: веса вес
погода: погоду
характеристика: характеристика
быть: е будут
показывать: показывает
выставка: выставках выставки
служение: служением
учебный: учебной
руб: руб
отменяться: отменяются
они: ими
память: памяти
предать: преданным преданный
одинаковый: одинаковую
сведение: сведению
собрать: собрав
физически: физически
плоский: плоские
присущий: присущих
успех: успеха
сохранять: сохраняет сохраняя
предпочитать: предпочитает
сомалийский: сомалийской
зарождение: зарождения
недёшево: недешево
пристроить: пристроить
перейти: перейти
война: войны
фронт: фронтах
толстый: толстые
повод: поводу
взрослый: взрослую взрослых взрослым
укоротить: укороченный
ч: ч
независимый: независимую
расчёска: расчески
редкий: редким редкими
несколько: несколько
месячный: месячный
нуждаться: нуждается
место: местах место
пиккара: пиккар
невозможно: невозможно
сородич: сородич сородичей
родина: родиной
способный: способен
убрать: убрать
применять: применяемую
порода: породе пород породу породы порода
рост: рост
напористый: напористые
голова: головы голова
значит: значит
оправдывать: оправдывает
скрытый: скрыты
мысль: мысль
маленький: маленькие
пыль: пыль
производитель: производителями производителей
качество: качества качестве
интеллектуальный: интеллектуальной интеллектуальный интеллектуальным
опубликовать: опубликовал
копытное: копытных
отдельный: отдельных
первый: первой первым первый первую
менее: менее
жить: жить
прочь: прочь
представитель: представителям представитель
помимо: помимо
силуэт: силуэта
реклама: реклама
одноимённый: одноименное
перспективный: перспективными
тусклый: тусклую
легко: легко
грюнендаль: грюнендалей
терять: теряет
склонный: склонна
высокий: высокого высокая
мясной: мясного
петь: пет
лента: ленту
поместье: поместье
вещь: вещам
переход: переходом
полностью: полностью
бельгия: бельгия бельгии
потенциал: потенциал
незапамятный: незапамятных
рекомендовать: рекомендованный
адольф: адольф
грудь: груди грудью грудь
конфликт: конфликты
бада-хондропротектор: бады-хондропротекторы
порция: порции
мускулатура: мускулатурой
храбрость: храбрость
мороз: морозы
хх: хх
телёнок: телят
поглотить: поглощенный
цепь: цепи
холодный: холодную холодной
добавка: добавки
угольно-чёрный: угольно-черный
острый: острым
отсутствие: отсутствие
каждый: каждой
слишком: слишком
возникать: возникает
игнора: игнор
одиночество: одиночеству
рекомендоваться: рекомендуется
европа: европе
незнакомец: незнакомцами
работать: работала работать
получиться: получится
рацион: рационе рацион
дисциплина: дисциплиной
наверстать: наверстать
выделяться: выделяющихся
экспонироваться: экспонировались
лай: лай
инициировать: инициирует
попрыгать: попрыгать
лошадь: лошадей
кой: коем
схватывать: схватывают
влиять: влияют
содержание: содержание содержания
бруталый: бруталом
дефектность: дефектности
ровно: ровно
проявить: проявит
тыльный: тыльной
габарит: габаритов
работа: работе
актировка: актировка
пигментировать: пигментированные
сайт: сайту
морда: морда
спина: спины
подросток: подросткам
гигиена: гигиена
внутренний: внутренняя
носить: носили
прохожий: прохожими
жесткошёрстный: жесткошерстных
доброжелательный: доброжелательного
сила: силу
утомлённый: утомленными
сваливание: сваливанию
разновидность: разновидностей разновидности
сломать: сломав
вой: вой
сложить: сложенная
наступить: наступит
позволять: позволяет
активный: активный активную
терпеливый: терпелив
вакансия: вакансии
психический: психическую
задействовать: задействовали задействованных
привыкать: привыкает
вольер: вольере
умница: умница
вовремя: вовремя
темно-кария: темно-карий
продукт: продукты продуктов
передний: передней передних
книзу: книзу
этот: эта этих
оценка: оценке
сторожевой: сторожевая
прикус: прикус прикуса
непререкаемый: непререкаем
знакомство: знакомство
негативный: негативный
ветрикулокордэктомия: ветрикулокордэктомия
треугольный: треугольной
производить: производить
ушной: ушные
форум: форум форуме
вроде: вроде
выполнение: выполнением
роуз: роуз
кстати: кстати
сказываться: сказывается
территория: территорию
копыто: копыта
хрящ: хрящи
излишний: излишне
дукль: дукль
продемонстрировать: продемонстрировать
угроза: угроза
мочка: мочка
злоумышленник: злоумышленник
чей: чей
конец: конце конец
надёжный: надежного
служебник: служебников
импортировать: импортированы
тренировка: тренировок тренировках
стая: стаи
клуб: клуб
начинаться: начинаются
выше: выше
чередовать: чередуя
требовать: требуют
очёс: очесы
красавец: красавец
ость: ость
горизонтальный: горизонтальная
заводчик: заводчика
сфера: сферах
чесать: чесать
разделить: разделил
отправиться: отправилось
подурачиться: подурачиться
тканевый: тканевой
управлять: управлять
мускулистый: мускулистой
пугливый: пугливых
вместе: вместе
клеймо: клеймо
культивироваться: культивируются
цвергшнауцер: цвергшнауцер
прилегающе-длинный: прилегающе-длинный
трус: трус
потратить: потратить
двойной: двойной
бедро: бедра
пока: пока
особый: особых
школа: школы
посадить: посажены
варить: варят
реагировать: реагируя
привить: привиты
состояние: состоянии
часть: часть части
отстать: отстали
иметь: имеет иметь имеют имевшим
выполнить: выполнить
описание: описание
белый: белыми
главный: главная
практически: практически
аллергия: аллергии
пышный: пышное
убирать: убирать
вязка: вязки
профессор: профессора профессор
рейтинг: рейтинг
куперхейм: куперхейма
начало: начало
подойти: подойдут
ведущий: ведущий
выгул: выгулы
питомниказаводчик: питомниказаводчика
подниматься: поднимается
поддерживать: поддерживающие
лёгкий: легким
дважды: дважды
проблема: проблем
возраст: возрасту
натуральный: натуральных
щека: щеки
агрессивный: агрессивных
военный: военных
подчиняться: подчиняться
длинношёрстный: длинношерстная
общеизвестный: общеизвестный
загородный: загородный
особенно: особенно
длина: длину
подписываться: подписывайтесь
вежливый: вежливый
коробка: коробка
строго: строго
расчесать: расчесать
структура: структурой
использовать: используют использовать
штаны: штанами
заниматься: заниматься
длинный: длинный
однако: однако
пляж: пляжей
достаточно: достаточно
костный: костной
обязательно: обязательно
хвост: хвоста хвост
причина: причина причине
обитать: обитает
загривок: загривка
запретить: запрещено
становиться: становится
очень: очень
особь: особей особям особь особи
обычно: обычно
стабильность: стабильность
накануне: накануне
людный: людных
эталонный: эталонный
класс: класс
классический: классической
поводок: поводка
смотреть: см
копирование: копирование
дружелюбный: дружелюбная
задний: задней
черепной: черепная
фотография: фотографии
прекрасно: прекрасно
снизойти: снизойдет
активность: активность
тапочки: тапочек
широкий: широкие широким
кровь: кровей
имя: имя
помещение: помещении
группа: группе группу
специальный: специальные
мытьё: мытье
расти: растут
полаять: полаять
дружелюбность: дружелюбность
мера: мерам
надбровье: надбровий
клещ: клещи
прибегать: прибегать
разнообразный: разнообразных
корма: корме
воздействовать: воздействовать
тратить: тратить
специфический: специфическим
список: списке
круп: крупом
психологический: психологический
стэнли: стэнли
правило: правила правил
охотно: охотно
качественный: качественном
форма: формы форме
голосовой: голосовых
противник: противники
прежде: прежде
проплешина: проплешины
несмотря: несмотря
выставить: выставленный
купить: купить
присутствовать: присутствует
плотный: плотные
часто: часто
пользоваться: пользуется
старание: стараниям
пара: пары
собачий: собачьи
склонность: склонность
находиться: находятся
касаться: касается
вплотную: вплотную
лосьон: лосьоны
выделение: выделения
окрасить: окрашена
прийтись: придется
метрика: метрику
шум: шум
снизить: сниженная
заболевание: заболеваний
поддержать: поддержит
одновременно: одновременно
корм: корм
овальный: овальные
висячий: висячие
проникаться: проникается
тщательный: тщательный
соответствующий: соответствующие
лидер: лидера лидеру лидеры
позиционировать: позиционирует
проект: проекте
тонкий: тонкими
винт: винта
противоречивый: противоречив
сигнализировать: сигнализирует
рль: рль
разводить: разводили
необходимый: необходим
удивить: удивили
популярность: популярностью
кольцо: кольца
пора: пор
поскольку: поскольку
трудолюбивый: трудолюбивый
обучение: обучения
кг: кг
необходимость: необходимости
городской: городской
пухлявый: пухлявее
краткий: краткая
полгода: полгода
пылесос: пылесоса
коллектив: коллективы
сей: сих
среднее: среднего
ухо: уши ушей
мантия: мантии
универсальный: универсальная
ветеринарный: ветеринарной
пастьба: пастьбе
цвет: цвет
ответ: ответ
поясница: поясницей
сквер: скверов
тервюрен: тервюрена
зенненхунд: зенненхунд
настоящий: настоящий
передовой: передовую
исключительно: исключительно
начать: начал
необработанный: необработанных
мгновенно: мгновенно
опустить: опущенной
делать: делает
почта: почту
другой: других
эксперт: экспертов
выродиться: выродились
николас: николас
купать: купать
обходиться: обходятся
брид: брид
ураганный: ураганный
важный: важный
подшёрсток: подшерстка
разводиться: разводится
депигментировать: депигментированные
входить: входить
вконтакте: вконтакте
нежданный: нежданного
сустав: суставов
бугор: бугра
впечатление: впечатление
объявление: объявления
грозить: грозят
причём: причем
создать: создать
согреваться: согревается
основной: основные
жёсткость: жесткость
возбудить: возбужден
новый: новую
тазобедренный: тазобедренных
интеллект: интеллект
охранный: охранные
джентльмен: джентльмен
зло: зло
энтузиаст: энтузиастов
конечность: конечностей конечности
предок: предка
столетие: столетию
короткий: коротким
природный: природную
продажа: продажу
р: р
энергия: энергии энергия
навсегда: навсегда
родитель: родителей
одноклассник: одноклассники
ценник: ценник
носитель: носителя
точёный: точеной
путём: путем
кормление: кормление
связь: связь
занимать: занимает
свободный: свободное
выведение: выведении
бордер-терьер: бордер-терьер
битва: битвы
сша: сша
транспортировать: транспортировать
монопородный: монопородных
дисплазия: дисплазия
малинуа: малинуа
губа: губы
постав: постава
шутцхунд: шутцхунд
бег: бега
кипячёный: кипяченой
собаковод: собаковод
родословный: родословными
случай: случае
партнёр: партнером
выбрать: выбрать
немецкий: немецкими
репутация: репутации
именно: именно
сравнение: сравнению
температурный: температурный
будущий: будущие
забота: забота
случайный: случайные
последний: последних
кроме: кроме
стимуляция: стимуляции
социализироваться: социализироваться
основать: основана
г: г
хотя: хотя
позволить: позволит
увлажнить: увлажненной
плавание: плавание
вязаться: вязались
отбраковываться: отбраковываются
атлетический: атлетическое
х: х
примесь: примеси
добрый: добрые
предпочтительный: предпочтительнее
