свирепый: свирепого
туалет: туалет
слабый: слаб слабее
использовать: используя использовать
противник: противника
знакомиться: знакомясь
подозрительный: подозрительных подозрительное
утеплить: утепленной
тело: тела тело
кровь: крови кровь
широко: широко
боец: бойцов
средний: средняя среднее средней
популярность: популярности
принцип: принципе
тестировать: тестирует
скот: скота
следить: следить
хребет: хребта
сколько: сколько
четверолапый: четверолапого
энтропия: энтропия
раскормить: раскормить
миссия: миссия миссию
перелеска: перелесках
знак: знаком
название: название
разряд: разряд
эталон: эталон
домой: домой
собака: собаку собаками собакой собак собака собаках собакам собаке собаки
примерно: примерно
милый: милы
блистать: блистали
вывоз: вывоз
общение: общением
римский: римского
обсуждение: обсуждения
искривление: искривление
бить: бить
подкожный: подкожного
подход: подхода
цена: цена
реальность: реальности
зачастую: зачастую
удаваться: удается
заметка: заметку
чувствительный: чувствительные
материал: материалов
обнаруживать: обнаруживает
казаться: кажется казаться
племенной: племенными
владелец: владельцам владельца владельцев владельцу владельцы
выщипываться: выщипывается
сука: суках суки
мускулистый: мускулистыми
простой: простого проще
пробовать: пробовать
игра: игру
волков: волков
бессмысленный: бессмысленное
близкий: ближайшие
холка: холку холке
побегать: побегать
зато: зато
низкий: низкими низкий низким низкая
россия: россия россии
живот: живот
морда: морде мордой морда
сюсюканье: сюсюканья
обратный: обратная
потискать: потискать
следующий: следующих
радужка: радужки
представитель: представителей представителями представители
упражнение: упражнений
охранник: охранник
команда: команду команды команда
занятие: занятий занятие
шея: шея шеи
волос: волосом волос
овчарка: овчарки
стричь: стричь
прямолинейный: прямолинейны
шерсть: шерсть шерсти
обижаться: обижаться
рука: руками руках
ирландец: ирландцы ирландца ирландцах ирландец ирландцев
миниатюрный: миниатюрной
челюсть: челюсти
метод: метод метода
должный: должны должен должно должна
приберегать: приберегая
килограмм: килограммам
плата: платы
заменять: заменять
тримминг: тримминг
возникнуть: возникнет
кембриджский: кембриджскую
чёрный: черные черного
ирландский: ирландских ирландского ирландские ирландскому ирландским ирландский
островной: островному
месяц: месяц месяца месяцев
необходимый: необходимы необходим
тонкий: тонкий
жесткошёрстный: жесткошерстная жесткошерстных жесткошерстном
сера: серу
столь: столь
спустя: спустя
ромашковый: ромашковым
дело: дел делу дело деле
усвоить: усвоил
нога: ног ноги ногами
учитывать: учитывайте учитывая
отличаться: отличается
выраженный: выражен
сузить: суженная
важно: важно
признак: признаками
зимовать: зимовать
тесный: тесные тесном
душа: душе
пытаться: пытайтесь пытается
история: история
гипотиреоз: гипотиреоз
щенок: щенка щенков щенки щенком щенок
нормально: нормально
роща: рощах
потрудиться: потрудиться
выгул: выгул выгула
раковина: раковину
успешно: успешно
заворот: заворота заворот
обязательный: обязательный
крупяной: крупяных
напускной: напускной
каждый: каждого каждые каждый
юный: юного юный юных
приятно: приятно
английский: английская английский
характеристика: характеристика характеристик
гигант: гигант гиганты гигантов
практика: практике
укрепиться: укрепится
патрик: патрика
уильям: уильяма
физически: физически
переход: переходы
удлинённый: удлиненный удлиненными
заводчик: заводчик заводчиков заводчика заводчики
год: годы года годам лет год годов году
полк: полк
навык: навыков
удалить: удалите
зкс: зкс
вобблер: вобблера
конура: конуре
город: городом
смазать: смажьте
порода: породе породам породы пород порода породой
значит: значит
номер: номера
где-то: где-то
двухмесячный: двухмесячного
утвердить: утвердили
палец: пальцы пальцами
смерть: смертью
быстро: быстро
социализировать: социализированы
раз: раза
видео: видео
помимо: помимо
записать: записать
обследование: обследования
откровенный: откровенной
подойти: подойдет
полноценный: полноценного
разрешаться: разрешается
меню: меню
племя: племенами
полностью: полностью
смысл: смысл
бросаться: бросались
возможный: возможные
бабушка: бабушки
систематический: систематическое систематический
домашний: домашних домашнего
неповоротливый: неповоротливым
позаботиться: позаботьтесь
отрастание: отрастания
небольшой: небольших
вслед: вслед
локтевой: локтевого
частота: частота
скука: скуки
игрушка: игрушках
рацион: рациона рационе
датский: датских
охотник: охотника охотниками
лопатка: лопатками
проблематично: проблематично
содержание: содержание содержанием содержания
ген: гены
опытный: опытного
немного: немного
приучать: приучать
постель: постели
бостон-терьер: бостон-терьер
пребывать: пребывали
волкодав: волкодава волкодаву волкодавам волкодавы волкодавами волкодав волкодавов
типичный: типичны типичный
витаминный: витаминные
царить: царящую
поверхность: поверхностях
защита: защиты защите
оставаться: остаются оставаясь остается
услуга: услуги
посягать: посягать
исполнять: исполняет
открыть: открыты
подвес: подвес
глюкозамин: глюкозамином
облик: облика обликом
прививка: прививках
кстати: кстати
связь: связь связи
национальный: национальной
соревнование: соревнованиях
продемонстрировать: продемонстрировать продемонстрировали
ветпаспорт: ветпаспорт
расставить: расставленные
другой: другую других другими
переносить: переносит
баранина: баранину
точно: точно
побережье: побережью
клуб: клуб
настроить: настроено настроены
повреждение: повреждений
система: система
превышать: превышать
месячный: месячным
рахит: рахита
кусательный: кусательный
сердечный: сердечных
красный: красные
количество: количествах
наниматься: нанимался
мягкий: мягкой
похожий: похожие
лоб: лба лоб лбом
энергичный: энергичные
миролюбивый: миролюбивой
бытовать: бытует
заподозрить: заподозрить
пока: пока
жир: жира
прямодушный: прямодушный
от: ото
индейка: индейки
добродушный: добродушных
состояние: состоянии
официальный: официальный
достижение: достижении
лёгкий: легким легкая
дважды: дважды
ответственность: ответственностью
возраст: возрасту возрастом
давать: давать
выгуливать: выгуливаете выгуливать выгуливают
собачка: собачкой
рефлекс: рефлекс
среднестатистический: среднестатистический
грэхема: грэхема грэхем
частенько: частенько
эктопаразит: эктопаразитов
крупногабаритный: крупногабаритным
спортивный: спортивные спортивных
омега: омега
выставка: выставки
пресекать: пресекать
остеосаркома: остеосаркома
плотно: плотно
поводок: поводку поводком поводке поводок
лорд-генерал: лорд-генерал
качество: качестве качество качества
тримминговать: тримминговать
поле: поле
питомец: питомцу питомцам питомца
закрепить: закрепленный
смотреть: см
плюс: плюс
истинный: истинное
фотография: фотографии
обрезание: обрезание
невзирая: невзирая
расти: растут
агрессивный: агрессивная агрессивных
работать: работать
поделиться: поделится
сумма: суммы
уход: уходе уход
грозить: грозящими
столько: столько
насиловать: насилуйте
развалиться: развалившейся
ушко: ушком
комфорт: комфорт
лежание: лежание
родить: рожденный
результат: результат результаты результате
высокий: высокая высокие
гвардеец: гвардейцев
питомник: питомники питомника питомников питомнике
вырождение: вырождение
прародитель: прародители
поладить: поладить
взрослый: взрослой взрослого взрослыми взрослых взрослым
выбирать: выбирайте
глаз: глаза глазами
летний: летний летней
самый: самый самых
грязь: грязь
прийтись: придется
трудный: трудной
решиться: решились
дирхаунд: дирхаунда дирхаундов
часть: части
ус: усы
век: века вв
потренировать: потренируют
вести: вести
настой: настоем
малыш: малышу малышам малыши малыша
питаться: питающегося питаться
ветеринарный: ветеринарным
прогулка: прогулка прогулки прогулок прогулке
поскольку: поскольку
дом: домах дом
обучение: обучения обучению
величество: величества
косматый: косматый косматым косматых косматые
капитан: капитана
краткий: краткая
весьма: весьма
компаньон: компаньона
любой: любого любой любым
отношение: отношение отношении отношению
арена: арене
сдаваться: сдаюсь
эпоха: эпохи
ребёнок: ребенка детям детей
эксперт: экспертов
подушка: подушке
пайка: паек
отказываться: отказывайтесь
выуживать: выуживая
удаление: удаление
разработать: разработанной
подходящий: подходящей
вконтакте: вконтакте
создать: создать
брудастый: брудастый
тазобедренный: тазобедренных
особь: особями особи
час-другой: час-другой
разведение: разведением разведении
выдержка: выдержки
роль: роль
поприще: поприще
продажа: продажу
поинтересоваться: поинтересуйтесь
ценник: ценник
животное: животных животным животного животными животные животное
один: одного одной одном
преодолеть: преодолевшие
затеять: затеет
занимать: занимает
пиодермия: пиодермия
одинаково: одинаково
побаловаться: побаловаться
ребята: ребята
вынудить: вынуждена
охотничий: охотничьих охотничий охотничьем охотничьей
светлый: светлая
выбрать: выбрать
доступно: доступно
оценить: оцените
напасть: напав
пластичность: пластичность
рабочий: рабочим рабочем
основать: основана
допустить: допустим
шёрстный: шерстного
сустав: сустава суставы суставами суставов
хотя: хотя
положить: положил
протирать: протирая
порядок: порядок порядка
хозяйский: хозяйский
х: х
злобный: злобного
кожа: кожу кожа кожи кожей
предпочтительный: предпочтительнее
королевский: королевский
внешний: внешней
лишний: лишним
котик: котиком
надбровье: надбровьях
хвост: хвостом хвоста хвост
придворный: придворной
который: которую которое которой которого которым которые который
заведение: заведения
атмосфера: атмосферу
потрескаться: потрескалась
костяк: костяка
связка: связки
породный: породный породных породным
свободно: свободно
патология: патология патологий
середина: середины
ежегодный: ежегодную
дать: даст дайте
возрождаться: возрождался
размер: размеры
говядина: говядину
мера: меру мере мера
соблюдать: соблюдайте
два: двум двух
информация: информация
поддерживать: поддерживающим
клещ: клеща
друг: друг друга
максимально: максимально
создание: создание созданиями
хотеть: хочет хотите
взять: возьмете взявшим
недоверие: недоверия
независимость: независимостью
гребень: гребнем
проводить: проводить
авторитет: авторитет
далее: д
кошка: кошкой кошки кошек
знать: знает
цепляться: цепляться
дружба: дружбе дружбы
мириться: мириться
окрас: окрас окрасом окрасов
изделие: изделий
прятаться: прятаться прячется
вплоть: вплоть
гнойный: гнойное
взаимный: взаимном
половина: половина
хотеться: хотелось
классический: классический
отзываться: отзываются
габарит: габариты
сравнительно: сравнительно
добыча: добыча
старичок: старички
объяснить: объяснить
цирк: цирка
лапа: лапах лапы лап
категорически: категорически
это: этим это
серый: серые
веко: веки
очаровываться: очаровываться
замахиваться: замахиваться
продолжительность: продолжительностью продолжительность
корень: корню
хороший: лучшего лучший хорошей лучшими
длинный: длинные длинный длинной
считаться: считается считаются
удаль: удаль
лечить: лечить
любимый: любимой
натянутый: натянутой
спровоцировать: спровоцировавшей спровоцировать
контакт: контакте контакт контакты
сжиматься: сжимается
чествовать: чествует
вручную: вручную
завезти: завезенных
просто: просто
губительно: губительно
мало: мало
человек: людей человеку человека человеком
борзая: борзой борзых
синдром: синдром
одиночество: одиночестве одиночеству одиночество
карма: карму
вид: видом виде
подчеркнуть: подчеркнуто
брутальность: брутальность
мир: миру
тысяча: тысяч
сушка: сушка
избрать: избрал
час: часа часов часу
оценивать: оценивает
особый: особыми
западный: западных западной
мальчик: мальчике
территория: территории
вывих: вывих
кромвель: кромвель
приводить: приводят
заменить: заменить
пластина: пластины
глазной: глазные
добавить: добавьте
неудобно: неудобно
чистка: чистка
омускуленный: омускуленной
помеха: помеха
проживание: проживание
мусор: мусор
исчезать: исчезающий
происхождение: происхождения
стык: стыке
отдел: отдел
налаживать: налаживать
отнять: отнятых
необходимо: необходимо
грязный: грязные
капризный: капризны
готовый: готовы
первый: первые первый первую
потерпеть: потерпит потерпеть
деньга: деньги
лёгкость: легкость
пища: пищи
свой: своем своим свой своего своей своих
унижаться: унижается
остановиться: остановитесь
задний: задние
заведомо: заведомо
виртуозно: виртуозно
кобель: кобеля кобели
оставлять: оставляйте
дрессировка: дрессировка
стандартный: стандартный стандартного
время: время
безумно: безумно
агрессивность: агрессивность
день: дней день
плечо: плеча
деятельность: деятельности
начать: начали
вытереть: вытереть вытрите
стесняться: стеснялся
недёшево: недешево
избежание: избежание
поставить: поставить поставленные
обидчивый: обидчивы
нагрузка: нагрузкой
отдельный: отдельные
например: например
несколько: несколько нескольких
место: местах
враг: враг
хрупкий: хрупкими хрупкие
проверять: проверяйте
рост: рост
крутой: крутой
приспособить: приспособленных
отечественный: отечественных отечественный
решение: решений
обладатель: обладатель
придумать: придумано
обидеть: обидеть
скучно: скучно
интервал: интервалом
твёрдый: твердые твердых
талисман: талисманом
к: ко
реклама: реклама
мясо: мясом мясо
неуважение: неуважения
выступить: выступили
полотно: полотна
доверить: доверите
лосьон: лосьоном
остальной: остальные
флегматичный: флегматичный
продавец: продавец
насадка: насадкой
плохой: плохой
полагаться: полагается
окд: окд
преподносить: преподносили
отойти: отошел отойти
выразить: выражена
спокойно: спокойно
проблема: проблемами
уголок: уголки уголке
воспитание: воспитание
явно: явно
безусловно: безусловно
работа: работы
эксперимент: эксперименты
мирно: мирно
посол: послам
хватка: хватку хваткой
сам: самой самим
руководство: руководством
металлический: металлическим
красота: красотой
сайт: сайту
мясной: мясной
оба: обеими
природный: природных
специалист: специалисту специалисты
полезно: полезно
получаться: получаются
картофель: картофель
дорогой: дорогое
крупный: крупная крупных крупной крупные крупным
быть: будут
этот: эта этому этих
лишь: лишь
вариант: вариант вариантами
убираться: убираются
борзовидный: борзовидных
повергать: повергали
некрупный: некрупных
невысокий: невысокой
форум: форум форуме
позвоночник: позвоночника позвоночником
конец: конце конец концов
папильон: папильоном папильон
секрет: секретом
начало: начала начало
дружелюбный: дружелюбные дружелюбная
наш: нашей
живой: живых живой
тип: типу типах типа типы
лениться: ленитесь
такой: такие такого
шампунь: шампуни
автострада: автострады
посредственный: посредственные
ремённый: ременной
восточный: восточным
реагировать: реагируя
выщипать: выщипанными
бродячий: бродячей бродячих
описание: описание
рано: рано
стандарт: стандартом стандарт
короткий: короткое короткая короткими
вычесать: вычесать
округлый: округлые
вымирание: вымирание
налёт: налета
венгрия: венгрии
зубной: зубного зубную
гречневый: гречневая
рубеж: рубеж
глубоко: глубоко
однако: однако
битва: битве
огромный: огромные
германия: германии
внушительный: внушительные
смахивать: смахивающий
играть: играть играет
многократный: многократными
соотноситься: соотносится
продолжить: продолжить
поэтому: поэтому
отказ: отказ
предлагать: предлагают
копирование: копирование
супруг: супругу
годовичок-подросток: годовичкам-подросткам
далёкий: подальше
активность: активность
вооружиться: вооружившись
ти: ти
согласный: согласен
дружелюбность: дружелюбность
чуткий: чуткое
уважение: уважении
переменчивый: переменчивому
отзыв: отзывах отзывы
умный: умное
чистокровный: чистокровного чистокровный чистокровных
диск: дисков
упрощённый: упрощенный
следовать: следует
животный: животному
мимо: мимо
шум: шум
доброжелательный: доброжелательный
висячий: висячие
принести: принесут
собираться: собирается
перспектива: перспективы
запоминать: запоминают
сохранить: сохранивших
кельт: кельтам
нетерпимость: нетерпимость
соответствующий: соответствующих
прямой: прямая прямой
общий-то: общем-то
миска: миске
назад: назад
преимущественно: преимущественно
сетка: сетке
оттенок: оттенка оттенок
животазаворот: животазаворот
необработанный: необработанными
кость: кости костями
непозволительно: непозволительно
нечасто: нечасто
интерес: интерес
костистый: костистые
мочь: могут можете
мать: матерью
н: н
хищник: хищникам хищником
соперничество: соперничестве
покупатель: покупателям
формат: формата
выставить: выставлен
корн: корне
любитель: любителя любителей
творог: творог
ухо: ушей уши ухо
видеть: видеть
объявление: объявления
медленно: медленно
тримминговаться: триммингуется
тонкость: тонкостями
основной: основные
дорожить: дорожить
диагноз: диагноз
интеллект: интеллект
охранный: охранные
покупать: покупайте
многие: многие
средне: средне
вес: вес
святой: святого
купать: купают
управлять: управляют
голос: голос
приучить: приучить
позволять: позволяют позволяющими
произойти: произошли
круповой: круповой
неукротимый: неукротимые
именно: именно
серьёзно: серьезно
котейка: котейку
чуждый: чужды
вредный: вредны
опорно-двигательный: опорно-двигательная
отклонение: отклонения
костный: костная
попытка: попытках
рассылать: рассылая
вредить: вредит
заниматься: занимающихся занимаются
симпатичный: симпатичней
диван: диване
составлять: составлять
пёс: пес пса
крик: крик
подросток: подростки
зуб: зубами зубы
военный: военным
обеспечить: обеспечить обеспечат
разгуливать: разгуливали
говорить: говорят
инстинкт: инстинктов инстинкт инстинктах
остеохондроз: остеохондроз
развитие: развития
оценка: оценка оценке
наблюдать: наблюдайте
выгнутый: выгнутыми выгнутой
череп: черепу череп
никак: никак
помощь: помощи
тот: те тех
исполин: исполин
фишка: фишка
фото: фото
истребить: истреблены
проволокообразный: проволокообразный
вы: вами
грубый: грубое грубым
расширить: расширенная
яндекс: яндекс
обращение: обращение
сезонный: сезонную
избегать: избегайте
собственный: собственной
кто: кого
помета: помет
успех: успехов
экспонироваться: экспонироваться
поведение: поведением
строиться: строиться
фрисби: фрисби
здоровье: здоровью здоровья здоровье
взгляд: взгляде
журнал: журнал
линия: линии
весь: всей всему
высота: высота
дракончик: дракончик
коллаген: коллагена
заглянуть: загляните
делать: делать делают
особенный: особенное
страна: стране стран страна
зелень: зелень
увеличивать: увеличивают
открыться: открылся
э: э
самостоятельность: самостоятельностью
гигрома: гигрома
нарушение: нарушение
болезнь: болезни болезнь
неопытный: неопытные
изредка: изредка
целиком: целиком
расправляться: расправлявшиеся
отказаться: откажитесь отказаться
выдрессировать: выдрессировать
совершенно: совершенно
растерять: растеряв
приобретать: приобретая
либо: либо
зона: зоны зонами
начинать: начинать начинает начиная
минута: минут
ряд: ряду
выводить: выводят
минимально: минимально
какой: какие
доля: доля
вытеснить: вытеснили
помоечный: помоечной
правило: правилом правило правила
полежать: полежать
советовать: советуем
интеллектуальный: интеллектуальные
вода: водой
гладкий: гладким
раболепствовать: раболепствует
отход: отходы
крепкий: крепкий крепкого
ответственный: ответственный
муштра: муштры
фирменный: фирменная
пусть: пусть
крайний: крайняя
добрый: добр добрая
плохо: плохо
кормление: кормлениями кормлений кормления кормление
заметно: заметно
королева: королева
хитрить: хитрит
безболезненно: безболезненно
почётный: почетная
гладко: гладко
защитник: защитника
немой: нем
грозный: грозный грозным
родиться: род
перейти: перейти перейдя
кельтский: кельтскими
ваш: вашей
статус: статус
переходить: переходите
отдавать: отдавая
главное: главное
дог: догов
максимум: максимум
серьёзность: серьезности
маленький: маленькие
когтерез: когтерезом
скакательный: скакательными
менее: менее
вздумать: вздумайте
подмышка: подмышки
дисквалификация: дисквалификацией
существовать: существовали
дефект: дефектов
порция: порцию порции
отец: отцом
безграничный: безграничен
естественность: естественность
ревность: ревности
во-вторых: во-вторых
клетка: клетка клетки
собрат: собратьев
излучать: излучают
снижаться: снижается
слишком: слишком
котофей: котофея
зимой: зимой
коготь: когтями
трясти: трясти
запрет: запрет
зарегистрировать: зарегистрированных
пренебречь: пренебречь
гигиена: гигиена
комплекс: комплексам комплексы комплексом
крыса: крысой
всего-то: всего-то
чудесный: чудесное
раздражительный: раздражительны
подобный: подобные
вольер: вольере
запустить: запустить
сытый: сытое
покров: покрова
пора: пора пор
уникальный: уникальный
рубль: рублей
поступать: поступает
родина: родине
волкодав-кобель: волкодавы-кобели
заузить: зауженной
силиконовый: силиконовым
расчёсывание: расчесывания
опасный: опасной опасны
мочка: мочка
смело: смело
отрабатывать: отрабатывать
неплохо: неплохо
переборщить: переборщил
постный: постное
слабо: слабо
жёсткий: жесткую жесткая
внимание: внимание
воспаление: воспаления
прикус: прикуса прикус
переходный: переходный
приличный: приличные
ушной: ушного ушную
щека: щек
ветошь: ветошью
риск: риска риск
глубокий: глубокая
топорщиться: топорщащиеся
разнообразить: разнообразить
редкий: редкий
средневековье: средневековья
увлажнять: увлажняющие
спасибо: спасибо
стоимость: стоимость
допустимый: допустимый
маска: маской
иначе: иначе
особенно: особенно
несправедливый: несправедливое
удовольствие: удовольствие
поесть: поела
вытянутый: вытянутое вытянутой
строго: строго
последний: последние
спешить: спешите
импортировать: импортировано
осмотреть: осмотреть
выход: выходы
кроха: крох
включать: включать
достаточно: достаточно
рисковать: рискуете
хозяин: хозяина
ход: ходе
сагиттариус: сагиттариус
поверьте: поверьте
пара: пару
польский: польского
выпуклый: выпуклая выпуклый
редко: редко
сделать: сделали сделано
кабачок: кабачок
неустрашимый: неустрашимыми
неделя: неделю
так: т
зоомагазин: зоомагазина
вынужденный: вынужденной
отметка: отметки
европа: европы
ринг: рингах
осторожность: осторожность осторожностью
точнее: точнее
охотно: охотно
форма: формы
иметь: иметь имеют
купить: купить
плотный: плотный
ухаживать: ухаживать
пожилой: пожилым
меняться: меняться
повторение: повторениями
обнаружить: обнаружен
приемлютый: приемлют
масло: маслом
пункт: пункт
заболевание: заболеваний
целесообразный: целесообразнее
идея: идеи
наказание: наказание
запас: запас
грудной: грудным грудная
снаружи: снаружи
спина: спина
вывести: выведенная
свежий: свежем
розовидный: розовидной
голова: голова
непременно: непременно
предок: предки предков
аджилить: аджилити
задача: задача
хозяйка: хозяйкой
экзотика: экзотики
запор: запоры
рейсинг: рейсингом
идеал: идеала
нервный: нервного
ссср: ссср
волк: волки
аллергик: аллергики
оказаться: оказались
упитанный: упитанный
наличие: наличие
замашка: замашки
испортить: испортили
ирландия: ирландии ирландию ирландия
ротвейлер: ротвейлеры
чистый: чистой
проветриться: проветриться
великанов: великанов
далеко: далеко
предполагаться: предполагается
неправильно: неправильно
одноклассник: одноклассники
презентовать: презентовали
скорее: скорее
подавать: подает
по-настоящее: по-настоящими
трепет: трепет
послушание: послушания
трата: траты
улучшение: улучшением
волосок: волоски
обширный: обширному
дисплазия: дисплазия
необыкновенный: необыкновенную
каша: каш
овсяный: овсяная
безобидный: безобидного
мнение: мнение
против: против
случайный: случайные
косолапый: косолапые
тщательный: тщательнее
чётко: четко
кроме: кроме
движение: движении
наблюдаться: наблюдается
позволить: позволит
жестоко: жестоко
разница: разницы
оказать: оказанные
плестись: плетется
среднее: среднем
сегодня: сегодня
расширяться: расширяющееся
частый: чаще
поиск: поиск
квадратный: квадратного
привить: привить
вообще: вообще
терпеливый: терпеливы
климат: климату
характер: характер
чужак: чужаков
практиковать: практикуют
некоторый: некоторые
напоминание: напоминания
белые: белые
цепь: цепь
стать: станет
сажать: сажать
противопоказанный: противопоказано
суровый: суровым
болезненно: болезненно
гулять: гуляете
укорачивать: укорачивают
сторож: сторожа
реалия: реалиях
обогатиться: обогатился
щётка: щеткой
зрение: зрения
правильный: правильный
собранный: собранный
провокатор: провокаторов
незначительный: незначительными
дополнительно: дополнительно
недельный: недельных
вписываться: вписывается
присмотреться: присмотритесь
потребность: потребность
полёживать: полеживают
периодически: периодически
порок: пороки
трапеза: трапезы
квартирный: квартирным
заинтересовать: заинтересовано
генофонд: генофонд
нежный: нежный
щит: щит
жизнь: жизни
современный: современных
заканчиваться: заканчивается
забывать: забывайте
подрощённый: подрощенного
выдающийся: выдающиеся
жирный: жирным
отмереть: отмершие
сильно: сильно
мешать: мешает
минутный: минутные
принятие: принятии
всё-таки: все-таки
постоянный: постоянном
пережёвывание: пережевывание
впервые: впервые
группа: группы
российский: российских
воспитывать: воспитывать
брутальный: брутальным
снисходительный: снисходителен
выдержать: выдержанный
печенька: печеньку
изгиб: изгибом изгиб
тигровый: тигровые
бады: бады
желудок: желудка
почесать: почесать
супер-премиум: супер-премиум
относительно: относительно
изоляция: изоляции
массивный: массивная
нужно: нужно
врождённый: врожденную
мимимишность: мимимишности
азия: азии
также: также
процесс: процесс
зубок: зубок
мама: мама
покупка: покупки
любимец: любимца
цель: цели
момент: моменты
окружающий: окружающих
внутри: внутри
перегрузка: перегрузки перегрузках
нежирный: нежирные
белок: белок
палочка: палочек
возможно: возможно
нижний: нижней
ставка: ставку
букет: букет
квартира: квартирах
подушечка: подушечках
бородка: бородку
корпус: корпус
заразиться: заразиться
повышать: повышайте
поясница: поясница
лежанка: лежанкой
вволю: вволю
предмет: предметах
тяжёлый: тяжелым
поджарый: поджарых
забавный: забавны
заигрывание: заигрывания
агрессия: агрессию агрессией
старание: стараний
виллебранд: виллебранда
впоследствии: впоследствии
тёмный: темный
поваляться: поваляться
лакомство: лакомства
рыбный: рыбным
крайне: крайне
знакомство: знакомства
стоить: стоит
послушный: послушны
бедро: бедрами
ножницеобразный: ножницеобразный
паховой: паховые
провоцировать: провоцируют
обнимашка: обнимашки
чашечка: чашечки
зависеть: зависит
отдых: отдых
герцогиня: герцогиню
явный: явную
наложить: наложил
показатель: показатели
вполне: вполне
чистить: чистящей
проволочный: проволочным
отдохнуть: отдохнули
курсинг: курсингом
недуг: недуги
любить: любят
нуждаться: нуждается
подобрать: подобран
невозможно: невозможно
способный: способен
охотиться: охотились
прыжок: прыжки
труд: трудом
домочадец: домочадцы
аккуратно: аккуратно
служба: службе
взглянуть: взглянуть
угроза: угрозу
какой-нибудь: каким-нибудь
прочь: прочь
возложить: возложена
серьёзный: серьезного
полный: полное
легко: легко
объятие: объятия
превратить: превратить
провислый: провислая
рваться: рвется
лента: ленту
производитель: производителей
столетие: столетий столетия
основа: основу основы
заговорить: заговорили
кардиомиопатия: кардиомиопатия
интенсивно: интенсивно
несформироваться: несформировавшегося
новый: новый
палево-коричневый: палево-коричневые
трехразовый: трехразовые
искренний: искренней
телячий: телячьего
выглядеть: выглядит
лидерский: лидерские
ажиотаж: ажиотажу
теоретически: теоретически
сложность: сложностей
подавить: подавить
заложить: заложенные
воздух: воздухе
грозность: грозности
во-первых: во-первых
субпродукт: субпродуктами
тыква: тыкву
подмешивать: подмешивать
вакансия: вакансии
прямо: прямо
стол: стол
передний: передних
апатичный: апатичные
начинаться: начинается
полтора: полтора
обрабатывать: обрабатывать обрабатывают
сказать: скажешь
конфликт: конфликт
размёт: разметом
привязать: привязан
случаться: случается
вместе: вместе
течение: течение
жизненно: жизненно
прийти: придя
чересчур: чересчур
кое-кто: кое-кто
запретить: запрещены запрещено
ватный: ватных
пройти: пройти
рисовый: рисовая
большинство: большинство
тёплый: теплой
лев: львом
вздутие: вздутие
главный: главная
сила: силами
цнс: цнс
кокер-спаниель: кокер-спаниель
щипаться: щиплется
катаракт: катаракта
полгода: полугода
рейтинг: рейтинг
собака-телохранитель: собак-телохранителей
генетический: генетических
кавказский: кавказские
пачкаться: пачкающихся
вернуть: вернуть
дисциплина: дисциплины
действовать: действуют
орешек: орешек
получить: получат
подписываться: подписывайтесь
поражение: поражение
присутствие: присутствие
типично: типично
самостоятельно: самостоятельно
наскок: наскоки
птица: птицей
точность: точностью
наклонный: наклонными
очень: очень
обычно: обычно
поболтать: поболтать
истребление: истребления
холистик-класс: холистик-класса
рада: рада
бас: басом
свёртываемость: свертываемости
бодигард: бодигардов
видимый: видимых
египетский: египетских
наоборот: наоборот
постепенно: постепенно
кличка: клички
пустобрёх: пустобрех
состоять: состоящему
предрасположенность: предрасположенностью
частность: частности
вблизи: вблизи
крем: кремом
изучить: изучить
напальчник: напальчником
отпускать: отпускать
касаться: касается
выставочный: выставочных
четвероногий: четвероногого
весело: весело
терпеть: терпят
вырастить: вырастить
индивидуальность: индивидуальность
проект: проекте
отдать: отдать
склонный: склонны
подрасти: подросшего
отдыхать: отдыхать
бедлингтон-терьер: бедлингтон-терьер
кг: кг
препарат: препаратам
кефир: кефир
чувствовать: чувствует
эмаль: эмаль
завысить: завысить
курица: курицы
стрижка: стрижке
линька: линька
грейхаунд: грейхаундов
коленный: коленной
собственность: собственности
разрекламировать: разрекламированы
остров: острову
вручать: вручая
шейный: шейный
попечение: попечение
обходиться: обходятся
комплекция: комплекции
кусочек: кусочком
подопечный: подопечного
становиться: становятся
непросто: непросто
волна: волне
причём: причем
развить: развитая
догадаться: догадайтесь
вельможа: вельможам
дилатационный: дилатационная
хронический: хроническим
укусить: укусившего
давно: давно
премия: премию
вейтпуллинг: вейтпуллинг
предусматривать: предусматривают
супермен: супермены
натуральный: натурального
отряхиваться: отряхиваться
конечность: конечности
ой: ой
клин: клин
рассмотреть: рассмотреть
натуралка: натуралкой
плоский: плоским
слой: слой
губа: губы
пожилое: пожилого
идти: идущий
акробатический: акробатические
принц: принца
хондроитин: хондроитином
промыть: промойте
пироплазмоз: пироплазмозом
г: г
громила: громилам
трилистник: трилистников
приём: приема
поразвлечься: поразвлечься
просторный: просторной
толщина: толщины
шаг: шаг
еженедельный: еженедельный
