партнёрство: партнерство
явный: явным явной явные
тело: тела теле тело
кровь: крови
широко: широко
средний: средняя среднее
тусклый: тусклая
отвечать: отвечать
необходимость: необходимость необходимости
агрессия: агрессия агрессии
из-под: из-под
активный: активные активны
сколько: сколько
глицериновый: глицериновой
быть: будете е будут
посоветовать: посоветовали
бич: бич
воспроизводить: воспроизводят
наметить: намеченным
локоть: локтях локтей
название: название
половой: половым половое
собака: собаку собакой собак собака собаках собакам собаке собаки
документ: документами
маскироваться: маскируется
шалить: шалить
переезд: переезда
открытый: открытом
палевый: палевого палевые
обсуждение: обсуждения
покапывать: покапывать
оставаться: оставаться остаются
английский: английских английским английский английского
цена: цена
приспособиться: приспособиться
зачастую: зачастую
очки: очками
бульмастиф: бульмастиф бульмастифе бульмастифом бульмастифа бульмастифу бульмастифам бульмастифы бульмастифов
рельефный: рельефные
подушечка: подушечки
генетический: генетические
материал: материалов
служебный: служебная служебным
сюрприз: сюрпризов
эмоция: эмоций
бесконечный: бесконечное
неутомимый: неутомимый
предел: пределов
предприимчивый: предприимчивые
окаймить: окаймленные
туманный: туманного
мотивация: мотивации
резец: резцов
мускулистый: мускулистыми мускулистая
сторона: стороны
дисквалифицировать: дисквалифицирующие
обучаться: обучаются
водоём: водоеме
больший: большим большего
город: город
остановить: остановить
поголовье: поголовье
покровительственно: покровительственно
пробежка: пробежки
зато: зато
положить: положенного
россия: россия
прогуливаться: прогуливающемуся прогуливающуюся
морда: морде морду морда
дремать: дремать
забыть: забудьте
обратный: обратная
компактный: компактный компактное
справиться: справиться
температура: температуры
отчётливо: отчетливо
великобритания: великобритании великобритания
представитель: представителей представителями
искать: искать
кобель: кобелях кобеля кобели кобелей кобелями
охранник: охранник
чистка: чисткой
команда: команду команды команда
шея: шея
миска: миской
песочный: песочного
компаньон: компаньон компаньоны
шерсть: шерсть шерсти
заинтересоваться: заинтересуется
поверхность: поверхности поверхностях
злобный: злобную
блеск: блеск
низкий: низкий низкая низкую
обстоять: обстоят
кинолог: кинологи
брутальный: брутальный
рыба: рыба
держать: держат
челюсть: челюсти
слюнявость: слюнявость
небольшой: небольшого небольшими
должный: должны должен должна
самый: самая самый самое самые
кресло: кресло
приключение: приключениям
килограммовый: килограммовой
породный: породного породные
аллергия: аллергией аллергии аллергию
сторож: сторож сторожа
начать: начнет
вельша-корги: вельш-корги
звук: звуков звуки
бурбуля: бурбулей
бравый: бравый
мозоль: мозоли мозоль
тонкий: тонкий
иметься: имеется
утратить: утратив
вальяжно: вальяжно
участок: участки участках
столь: столь
назвать: назвать
равно: равно
спустя: спустя
включая: включая
нога: ног ноги ногами
оглядываться: оглядывающимся
тень: тени
выработать: выработан
история: история
брать: брать
отстранить: отстраненное
щенок: щенка щенков щенки щенком щенок щенке щенку
завидеть: завидев
сенбернар: сенбернара
момент: моменту моменты момент
выгул: выгул
удаль: удали
успешно: успешно
тигровый: тигровым тигрового тигровых
волчий: волчьим
переквалифицироваться: переквалифицироваться
армейский: армейских
питомец: питомцев питомцу питомец питомца питомцем
форма: форма форму формы
трёхмесячный: трехмесячного
положительный: положительной
голова: голове головы голова
чувствовать: чувствуют
забывать: забывает забываем
семья: семьи семью
характеристика: характеристика
выставка: выставках выставок выставки выставке
фигура: фигуры
руб: руб
помощь: помощью помощи помощь
коричневый: коричневая коричневые коричневого
полицейский: полицейских
заводчик: заводчик заводчиков заводчики
около: около
зарождение: зарождения
купание: купания купанием
хулиган: хулиган
пахнуть: пахнет
пятно: пятна
голень: голенями
п-образный: п-образный
лидировать: лидирующие
клетка: клеткой клетку клетка
профессионально: профессионально
перетаскивание: перетаскиванию
зкс: зкс
кормление: кормлении кормление
еда: еды
коготь: когти
порода: породе породы пород породами породу порода
преувеличение: преувеличением
значит: значит
разрешение: разрешения
отнестись: отнеситесь
женский: женская
двухмесячный: двухмесячного двухмесячных
снежный: снежные
маска: маска
требовательный: требовательны
быстро: быстро
опубликовать: опубликовал
квадратный: квадратная
тестироваться: тестировались
впасть: впадет
видео: видео
полноценный: полноценного полноценные
вывезти: вывезти
характер: характере характер
шутка: шуткам
разрешаться: разрешается
меню: меню
вода: воды водой
никакой: никаких
забавный: забавные забавному
кошка: кошка кошки кошку
условие: условии условиях
смысл: смысл смысла
кеннел-клуб: кеннел-клуб
домашний: домашних домашней домашнего
пёс: псы псом
владелец: владельца владельцев владельцу владельцы владельцем
диван: диванах дивана
скука: скуки
бесконечно: бесконечно
покусывать: покусывать
беспричинный: беспричинная
хороший: хорошим лучший лучшая
содержание: содержание содержания
девочка: девочка девочек девочки
мелкий: мелких
немного: немного
корма: кормах
дерматит: дерматитам дерматиты
перебирать: перебирайте
международный: международных
представление: представления
назначать: назначать
приятный: приятное
рекомендовать: рекомендуют
способный: способному способных
всепрощающий: всепрощающие
реагировать: реагировать
наступление: наступления
ноздря: ноздрями
путь: путь
принимать: принимало принимает
окрас: окраса окрас окрасом окрасов
глюкозамин: глюкозамином
кстати: кстати
опустить: опущенная
относиться: относящиеся
он: нему
связь: связь связи
осветленность: осветленность
расставить: расставленные
переносить: переносит переносят
точно: точно
неглубокий: неглубокие
энергичный: энергичной
атопический: атопическим атопический
уйти: ушло
предварительный: предварительных
выпустить: выпустить
налёт: налет
умиротворённость: умиротворенности
да-да: да-да
сегодняшний: сегодняшнем сегодняшние
пока: пока
стать: стали станет
шквал: шквал
уточнить: уточните уточнили
жилистый: жилистые
маленький: маленький маленького
задворки: задворок
состояние: состоянии состояниями состояний
сустав: суставах суставы суставов
обладать: обладают
прямой: прямыми прямой
подкормка: подкормками
помещаться: помещающиеся
лёгкий: легким легче
давать: давать дают
природный: природные природной
обязательный: обязательные
перемена: перемены
коробка: коробка
сильный: сильных сильного сильный сильными
российский: российским
напоминать: напоминающие
будка: будкам
заниматься: заниматься
замедлить: замедленные
явление: явления явление явлением
волевой: волевому
плотно: плотно
психика: психика
вывих: вывиху
награда: награды
полениться: полениться
качество: качестве качества
преподносить: преподносит
бывать: бывают бывает
окрасить: окрашенное
мощь: мощи
смотреть: см смотрите
сходиться: сходятся
официальный: официальными
фотография: фотографии
осматривать: осматривать осматривайте
изгибаться: изгибается
невзирая: невзирая
работать: работать работают
уход: уходе уход
современный: современные
знать: знать знает
заметить: замечено
постель: постель
хитрый: хитрая
испачкать: испачканы
результат: результат
ряд: ряде
особь: особь особями особи особям особей
питомник: питомники
верхний: верхней
противостояние: противостоянию
имидж: имидж
возникнуть: возникла
выбирать: выбирайте выбирать
глаз: глаза глаз глазами
тип: типом типу типы
прийтись: придется
вопреки: вопреки
прилечь: прилег
часть: части
вниз: вниз
незначительно: незначительно
количество: количеством количества
приемлемый: приемлемо приемлемый
дог: дога
массивный: массивное массивная массивные
сказать: сказать
комплекс: комплексами комплексом
век: века веке веков
спросить: спросить
америка: америку
год: года лет год году
мир: миром
поскольку: поскольку
пользоваться: пользуются
формула: формула
краткий: краткая
темп: темпы темпе
любой: любого любую любой
универсальный: универсальные
отношение: отношение отношении отношению
овощ: овощей
называть: называть
формироваться: формироваться
место: место
систематический: систематическом
малыш: малышей малыш малыша
больно: больно
исключительно: исключительно
лететь: лететь
пятка: пятку
драчун: драчуна
отметить: отметить
уроженец: уроженец
профессионал: профессионалы
ужесточиться: ужесточились
игривость: игривость
эксперт: экспертов
равный: равная
доверить: доверить
вконтакте: вконтакте
свет: свет
впечатление: впечатление
устойчивый: устойчивый
социализировать: социализирована
контраст: контрастов
изоляция: изоляция
сочетание: сочетание
любимец: любимцев любимца
тазобедренный: тазобедренных
разведение: разведением
ярко: ярко
срок: срок
выдержка: выдержки
пересечь: пересеченной
месторождение: месторождений
подбородок: подбородок
животное: животных животным животного животные животное
сомнение: сомнение
сырой: сырую
приобретаться: приобретается
злобность: злобности
нанести: нанесите
одинаково: одинаково
сша: сша
апортировка: апортировка
зрительный: зрительный
появление: появления
интервал: интервалов
адекватно: адекватно
переводить: переводить
волос: волос
длина: длины
конституция: конституции
тон: тон тона
любимый: любимое
выбрать: выбрать
отрезать: отрежет
врождённый: врожденному
оценить: оцените
кровать: кровать
защитный: защитный
основать: основана
хотя: хотя
увлажнить: увлажненной
наладить: наладит
кожа: кожу кожа
мягкий: мягкие
предпочтительный: предпочтительнее предпочтительные
мозолистый: мозолистые
сам: сами само самом самим
парус: парусах
неприятный: неприятных
минеральный: минеральными
витамин: витаминов витамины
перемежаться: перемежаются
связка: связки
свободно: свободно
окружность: окружности
собственный: собственным собственными собственное
хорошенько: хорошенько
хлопчатобумажный: хлопчатобумажной
квартира: квартире квартирах
опыт: опыта опыты
след: следу
алексей: алексей
размер: размеры размера
официально: официально
облаивать: облаивать
выражать: выражать
мера: меру мера
информация: информация
подходить: подходит
независимый: независимое
друг: друг
резиновый: резиновой
масса: масса массу
хондропротектор: хондропротекторы
чутьё: чутье
атаковать: атакует
корпорация: корпорация
среднестатистический: среднестатистическому
трижды: трижды
юар: юар
далее: д
ниже: ниже
охраняться: охраняться
выбор: выбор
угодье: угодья
родословный: родословную
мириться: мириться
крокет: крокеты
курс: курса курс
такой: такое такая такого такую таким
крепкий: крепкие крепким крепких
воспринимать: воспринимать
сухой: сухой сухие
польза: пользу
ребёнок: детям детьми
протереть: протереть
классический: классический
сидеть: сидят сидеть
сравнительно: сравнительно
среди: среди
истинный: истинный
разный: разную разные
племенной: племенной
экстерьерный: экстерьерные
дурачиться: дурачиться
это: этим это
детский: детские детским
программа: программы программе
ограниченный: ограниченного
обильно: обильно
пушистый: пушистым
развитой: развитые
кто: кем
находиться: находится
диоксидина: диоксидина
потомок: потомками
заинтересованный: заинтересованной
полный: полной полного полное
смышлёный: смышленого
макушка: макушке
просто: просто
вырасти: вырастет
человек: людей человека
приход: прихода
набирать: набирают
позиция: позиции
храп: храпа храпу
одиночество: одиночестве одиночеством одиночеству
вид: видом
подчеркнуть: подчеркнуто
знакомить: знакомить
прочий: прочих
час: часа час
необходимый: необходимый необходимыми необходим
фанатизм: фанатизма
ночь: ночь
нападение: нападения
угроза: угрозы угроза
лимфома: лимфому
отдохнуть: отдохнуть
утяжелитель: утяжелителями
полчаса-час: полчаса-час
западный: западных
взрывчатый: взрывчатых
зрелый: зрелыми
заменить: заменить
контакт: контакт
ведать: ведали
выражение: выражение
добавить: добавьте
проступать: проступают
народ: народа
умеренный: умеренная умеренное умеренную умеренные умеренной
происхождение: происхождения
стык: стыке
тёмный: темные темного темная темный
заболевание: заболевания
стайный: стайную
необходимо: необходимо
наследовать: наследуют
натянутый: натянута
двухлетний: двухлетнего
пища: пищи пищу
холландер: холландера
шварценеггер: шварценеггеры
черта: черты
тщательно: тщательно
оставлять: оставляйте
упрямец: упрямцем
лакомство: лакомство
дрессировка: дрессировка дрессировки
стандартный: стандартный стандартное
время: время времени
сука: суки сук
плохой: хуже плохом
агрессивность: агрессивность
ланолиновый: ланолиновой
юный: юные
требовать: требует
день: дней дня день
препятствие: препятствия
перемещаться: перемещаться
пара: парами пар пару пара
местность: местности
шелковистый: шелковистый
американский: американский
хозяин: хозяином хозяина
просмотр: просмотров
перевернуть: перевернутую
взрослый: взрослого взрослых взрослым
ладить: ладить
взять: возьмите
умение: умений умения
променад: променадов
избежание: избежание
взаимопонимание: взаимопонимание
категория: категории
весовой: весовые
несколько: несколько
превосходно: превосходно
охрана: охраны
обнаружиться: обнаружились
рост: рост
ответ: ответа
одиночка: одиночку
вредность: вредностям
потомство: потомство
понравиться: понравившийся
использовать: использует
искоренение: искоренение
высокобелковый: высокобелковый
сила: силы силу
тёмно-синий: темно-синие
твёрдый: твердые твердых
реклама: реклама
исполниться: исполнится
оборона: обороны
расправляться: расправляются
базовый: базовые
организм: организм
остальной: остальные остальном остальное
выгнутый: выгнутую выгнутый
посадка: посадки
матроскин: матроскиным
выраженный: выраженным
окд: окд
процедура: процедуру
рекомендоваться: рекомендуется
спокойно: спокойно
получиться: получится
характерный: характерны
воспитание: воспитание
безусловно: безусловно
предоставлять: предоставляет
здоровый: здорового здоровой
проводиться: проводится
работа: работы работа работу
наступать: наступают
ласковый: ласков
мирно: мирно
блестящий: блестящая
мысль: мыслями
правильно: правильно
неудовольствие: неудовольствие
кардиган: кардиган
который: которыми которой которая которых которым которые который
сайт: сайту
увлечься: увлеклись
прочёсывание: прочесывании
бульдожий: бульдожьей
выращивание: выращивание
следствие: следствие
суточный: суточная
специалист: специалисту
груз: груза грузов
занять: занять
получаться: получаются
настороженность: настороженности
дорогой: дорогое
оттягиваться: оттягиваться
недуг: недугов
черепаший: черепашьем
этот: эта этому
лишь: лишь
набрать: набрать
вариант: вариант варианты
долго: долго
экспериментальный: экспериментальных
рабочий: рабочие
производить: производить
форум: форум форуме
немецкий: немецкого
спорт: спорта спорт
заворот: завороту
фактурный: фактурнее
стоп: стопом
хрящевой: хрящевой
минимизировать: минимизировать
начало: начала начало
усиливать: усиливающий
сезонный: сезонно
раствор: раствор
диморфизм: диморфизмом
положение: положение
любитель: любитель любителями
заводить: заводить
бебиситтер: бебиситтеры
соблюдать: соблюдающие
член: членам
десяток: десятка
хозяйский: хозяйскую
резкий: резких
светлоокрашенный: светлоокрашенных
разнообразный: разнообразные
разработать: разработать
значительно: значительно
экзема: экземы
натуральный: натуральной натуральное натурального
описание: описание
коллаген: коллаген
пляж: пляже
мишень: мишень
грунт: грунту
завершить: завершивший
слабый: слабее
выражаться: выражающихся
лоскуток: лоскутки
здоровье: здоровьем здоровья здоровье
познакомиться: познакомились
телепатический: телепатическом
найти: найти
консервы: консервами
однако: однако
одеяло: одеяла
потащить: потащит
становиться: становится
межпальцевый: межпальцевый
покувыркаться: покувыркаться
устраивать: устраивать
бладхаунд: бладхаунда
поэтому: поэтому
интересный: интереснее
случай: случаев случаи случае
копирование: копирование
промышленный: промышленных
черепной: черепная
прекрасно: прекрасно
активность: активность активности
направить: направленные
подверженный: подвержены
основание: основания
тяжелоатлет: тяжелоатлет
вялый: вялую
дружелюбность: дружелюбность
плавно: плавно
превышение: превышение
иммунитет: иммунитет
отзыв: отзывах отзывы
переходить: переходить
крупный: крупных крупной крупными
заключаться: заключается
способ: способ
ореховый: орехового
животный: животному животный
шум: шум
неизбежный: неизбежное
подвывание: подвывания
окантовка: окантовка
косметический: косметического
особо: особо
экс-помощник: экс-помощники
псовина: псовина псовиной
подсказать: подскажите
допустимый: допустимо допустимый допустимой
гулять: гуляют
актуально: актуально
наскок: наскоках
широкий: широкой широкая
назад: назад
породистый: породистого
оттенок: оттенка
лето: летом
поиск: поиском поиск
поначалу: поначалу
импортировать: импортированными импортирована
болезнь: болезней болезни болезнях болезнь
мочь: могут
специальный: специального специальных
минимум: минимум
принцип: принципам
заправлять: заправляло
другой: других
грузный: грузных
хватать: хватает
ухо: ушей уши
толщина: толщину
целое: целом
объявление: объявления
сделать: сделать сделано
голубой: голубые
бульдог: бульдогов бульдог
шалость: шалости
основной: основные
новый: новую новый
неокрепший: неокрепшие
пережить: пережить
мочекаменный: мочекаменную
интеллект: интеллект
охранный: охранные охранный
конечность: конечностей конечности
проявление: проявления
средне: средне
образовывать: образовывает
протирать: протирайте
вес: вес весом
степень: степени
конец: конец
питание: питания
голос: голос
линять: линяют
ежедневно: ежедневно
приучить: приучить
позволять: позволяют позволяющее
сон: сна сне
подобный: подобная подобные
офтальмологический: офтальмологическим
морщина: морщины
чей-то: чью-то
обладатель: обладателями
научиться: научился научиться
именно: именно
конфронтация: конфронтацию
отклонение: отклонения
злоупотреблять: злоупотреблять
сутки: сутками
обоснованный: обоснованно
продолжительность: продолжительность
плавание: плавание
подопечный: подопечный
воспитывать: воспитывают
аппетит: аппетитом
вряд: вряд
короче: короче
бросаться: бросаться
полотно: полотно
питательный: питательный
развитие: развития
темно-ореховый: темно-орехового
экстаз: экстаз
вещество: веществ
даваться: даются
выдержать: выдержавшего
подоспеть: подоспеет
скопиться: скопившуюся
цель: целях
подавлять: подавляющего
никак: никак
обижать: обижает
слегка: слегка
бороться: бороться
ребятня: ребятни
сравнить: сравнить
чемпион: чемпионами
гора: гору
периодический: периодические периодическом
фото: фото
дж: дж
фенотип: фенотипа
крепыш: крепыш
мальчик: мальчиков
яндекс: яндекс
водоросль: водоросли
распространить: распространенному
миллион: миллиона
участие: участие
сугроб: сугробы
нестись: несется
хотеть: хотите
череп: черепа
выразительный: выразительным
проводить: проводят
оперативный: оперативным
экстерьер: экстерьером экстерьера
уличный: уличном
лапа: лапы лап
холка: холке
расценка: расценки
подкрепление: подкрепления
незнакомец: незнакомцу незнакомцев
настойчивый: настойчивому
часа-два: часа-двух
взгляд: взгляде взглядом
журнал: журнал
психотропный: психотропных
высота: высота
какой-либо: каким-либо
безопасность: безопасность
месяц: месяца месяцам месяцев
заглянуть: загляните
удаваться: удавалось
создание: созданию
делать: делать
мастиф: мастиф мастифов
присущий: присущий
цепь: цепей
произвести: произведенное
отстоять: отстоять
разрушение: разрушений
шарахаться: шарахаться
реалия: реалиям
постав: постав
контактный: контактнее
агрессивный: агрессивного
предпочитать: предпочитая
оккупировать: оккупировал
еженедельно: еженедельно
порядок: порядка
обеспечить: обеспечьте
любопытный: любопытная
диагностировать: диагностированы
свирепый: свирепых
совершенно: совершенно
контролировать: контролировать
хватка: хватки
либо: либо
требование: требование
привить: привитый
начинать: начинать начинает начиная
молчаливый: молчаливого
белый: белого
минута: минут
совет: совет
настороженный: насторожен
обезжиренный: обезжиренного
ущерб: ущерба ущерб
пищевой: пищевую пищевой
перегружать: перегружать
долгожитель: долгожители
каждый: каждые каждом
ответственный: ответственный
увеличивать: увеличивая
нелегко: нелегко
утонченно-элегантный: утонченно-элегантные
навстречу: навстречу
послушный: послушный
повысить: повысило
алмазный: алмазных
плохо: плохо
неисправимый: неисправимым
свалить: свалить
перекус: перекус
созревание: созревание
дождаться: дождитесь
бежать: бежим
заметно: заметно
бабушкин: бабушкино
стальной: стальной
взросление: взросления
фито-лосьон: фито-лосьоном
снабдить: снабдив
немой: нем
грозный: грозный
нужный: нужен
перейти: перейти
разумный: разумнее
физический: физические
ткань: ткани тканью
вымах: вымахом
быстрый: быстрее
главное: главное
загородный: загородного
советский: советских
доминантно-независимый: доминантно-независимый
проверить: проверьте
максимум: максимум
прохождение: прохождение
уголок: уголках
менее: менее
нагрузить: нагрузить
уровень: уровне
тот: тех тому
обработать: обработанной обработайте
слюнтяй: слюнтяй
игривый: игривый
площадка: площадке
высокий: высокие высокий
скрытый: скрытой
грудь: груди грудь
замирать: замирающим
простой: прост
собрат: собратьев
обстановка: обстановке
осторожный: осторожные
отсутствие: отсутствие
невероятно: невероятно
частичка: частичка
слишком: слишком
несанкционированный: несанкционированной
вести: ведут
один: одном
требоваться: требуется
прогулка: прогулкой прогулках прогулок
противоречие: противоречий
альбион: альбиона
отвислый: отвислые
подшёрсток: подшерсток подшерстка
бесстрашие: бесстрашие
погонять: погонять
облегчить: облегченным
ровно: ровно
щенячий: щенячья щенячьи
усиленно: усиленно
спина: спины спина
внезапный: внезапных
гигиена: гигиена
внешность: внешностью внешности
метод: методом
ваш: ваш
жёлтый: желтые
вольер: вольере вольер
какой-то: какие-то
соболиность: соболиность
увкуснять: увкуснять
однотонный: однотонными
квартирный: квартирных квартирного
оценка: оценке
крупныхчересчура: крупныхчересчур
поведенческий: поведенческие
рубль: рублей
родина: родине
сидение: сидении
отруби: отрубей
прощупать: прощупайте
охота: охоты
суровый: суровой сурового
общительный: общительная
покатый: покатый
мочка: мочка
увлечь: увлеченный
отучение: отучению
буква: букву
сонливо-ленивый: сонливо-ленивыми
жидкость: жидкости
хардора: хардор
зарегистрировать: зарегистрировал
зубной: зубной зубная
аномалия: аномалии
прикус: прикуса
смазывать: смазывая
клише: клише
порвать: порвать
варежка: варежкой
отказываться: отказываются
обидчик: обидчика
расстраивать: расстраивает
спотыкаться: спотыкаться
подстраховка: подстраховки
удлинённый: удлиненным
иметь: имеет имея имеют
стоимость: стоимость
удалять: удалять
подойти: подойдут
удерживать: удерживать
особенно: особенно
плембрак: плембрак
внутренний: внутренним
жёсткий: жесткая
отсутствовать: отсутствует
заполучить: заполучили
предельно: предельно
страна: стран страна
достаточно: достаточно
дрессировать: дрессировать
обязательно: обязательно
свой: свое своих
утолстить: утолщенный
корпус: корпусом корпус
обязать: обязан
привычка: привычки
успеть: успели
редко: редко
возраст: возраста возрасте
объёмный: объемная
тренировка: тренировки тренировка тренировок
курцхаар: курцхаар
неделя: неделю
однородность: однородность
браконьерство: браконьерства
правильный: правильные
выматывать: выматывают
поводок: поводке
осторожность: осторожность
понимать: понимать
купить: купить
плотный: плотный
часто: часто
предок: предок
первый: первый
ушко: ушки
перестраховываться: перестраховываться
красный: красного
неплохой: неплохие
угловатость: угловатость
грудной: грудной
ниша: нишу
период: периоды период
шлейка: шлейки
мазь: мазью
скула: скулам
парковый: парковых
залом: заломы
привлекать: привлекают привлекать
паразит: паразитов
бриггс: бриггса
убирать: убирают
готовый: готовые
равнобедренный: равнобедренного
кончик: кончиком кончике
живой: живой живую
подкармливать: подкармливать
наличие: наличие
егерь: егерей егерям
спортсмен: спортсмен
чаемый: чаем
усвоить: усвоить
дисплазия: дисплазию дисплазии
карий: карие
меланхоличный: меланхоличным
отменный: отменное
крупа: круп
перечисленный: перечисленные
отечественный: отечественное
усиленный: усиленный
холод: холода
одноклассник: одноклассники
коикерхондие: коикерхондье
скорее: скорее
индивидуальный: индивидуальный
путём: путем
правда: правда
возможность: возможности возможность
мнение: мнение
сушка: сушку
чистить: чистить
случайный: случайные
чётко: четко
кроме: кроме
нарушитель: нарушителя
движение: движении
мясо: мясо мясе
шоу-особь: шоу-особей
позволить: позволит
рыхлый: рыхлому
треугольник: треугольника
тянуться: тянулись
сочетать: сочетать
частый: чаще
породность: породность
утруждаться: утруждаться
отход: отходом
тренировочный: тренировочного
ряженка: ряженки
плоский: плоская
социальный: социальные
зуб: зубы
закисание: закисания
лесной: лесного
прародитель: прародителями
догадаться: догадаться
некоторый: некоторые
рассосаться: рассосется
выглядеть: выглядят
помыкать: помыкать
поражение: поражения
термически: термически
чемпионский: чемпионские
помета: помета
подвижный: подвижными
подозрительность: подозрительность
серьёзный: посерьезнее
салфетка: салфеткой
короткий: короткая коротких
светлый: светлые
коллектив: коллективе
промывать: промывайте
нос: нос
игра: игры
дополнительно: дополнительно
потребность: потребность
смесь: смесь
периодически: периодически
порок: пороки
ушной: ушное
пясть: пястями
отлежаться: отлежаться
изменять: изменять
линька: линьки линька
жизнь: жизни жизнь
перманентный: перманентной
занимать: занимать
скамейка: скамейках
они: ними
ждать: ждите
сильно: сильно
вступать: вступать
скакательный: скакательных
укус: укус
дело: дела деле
напыление: напыление
повзрослеть: повзрослеет
раз: разы
плечо: плечами
пространство: пространства
скромно: скромно
вертикальный: вертикальное
намёк: намека
добродушие: добродушие
сторожевой: сторожевыми сторожевые
бады: бады
желудок: желудка
задержать: задержать
тяжёлый: тяжелые
относительно: относительно
нужно: нужно
мимимишность: мимимишности
полезный: полезных
также: также
неоднородный: неоднородным
бруталый: бруталы
побежать: побежит
поставить: поставленные
расслабленность: расслабленность
помочь: поможет
нежирный: нежирные
белок: белок
бегать: бегать
клык: клыки
стандарт: стандарт
отсюда: отсюда
боец: бойцы
богатый: богатым
ровный: ровная
норма: норма
стоить: стоить стоит
смешивать: смешивать
ранее: ранее
иерархия: иерархии иерархию
сложно: сложно
складка: складки
крипторхизм: крипторхизм
прилегать: прилегающее
крайне: крайне
собирать: собирая
темно-рыжий: темно-рыжих
воспитанный: воспитанная
ласка: ласку
существо: существа
брыть: брыли
интересно: интересно
любить: любит любят
попозировать: попозировать
зависеть: зависит
образоваться: образуются
вопрос: вопрос
отдых: отдых
затягивать: затягивать
порка: порок
защитить: защитит
кормить: кормить
переубедить: переубедить
показатель: показатели
портить: портят
утомлённый: утомленным
захватывать: захватывать
думать: думающей
молочный: молочных
щётка: щетки
невозможно: невозможно
убрать: убрать
влажный: влажными
прыжок: прыжки
отдельный: отдельных
профессия: профессии
прочь: прочь
повседневный: повседневной
представлять: представляет
отдыхать: отдыхающий
легко: легко
многий: многих
склонный: склонна
идеально: идеально
лента: ленту
слизь: слизь
соткать: сотканные
воспитать: воспитать
глубокий: глубокой
возникать: возникает
теоретически: теоретически
скучать: скучающего
ванная: ванную
отличный: отличные
титул: титулы
идеальный: идеального идеальная
насадка: насадки
застраховать: застрахован
пасти: пасти
закон: законы
навык: навыкам
вакансия: вакансии
прямо: прямо
обратно: обратно
пункт: пункты
передний: передних
покой: покоя
приходиться: приходится
добродушный: добродушные
забавно: забавно
начинаться: начинается
ставить: ставящие
постоянно: постоянно
план: плане
вроде: вроде
кефир: кефира
достаточный: достаточным
бесполезный: бесполезному
расцениваться: расценивается
сорт: сорта
съесть: съесть
очаг: очаг
упитанный: упитанные
единственный: единственное
привязать: привязан
позадираться: позадираться
тихий: тихим
жара: жару
сформировать: сформирует
большинство: большинство большинства
применение: применение
главный: главная
практически: практически
необоснованный: необоснованной
песок: песок
полгода: полугода
рейтинг: рейтинг
ведущий: ведущий
весь: всеми
дефект: дефекты
назойливый: назойливого
преувеличивать: преувеличивайте
производитель: производители
подписываться: подписывайтесь
лояльный: лояльнее
импровизированный: импровизированные
повышенный: повышенной
самостоятельно: самостоятельно
интенсивный: интенсивные
запретить: запрещено
согнать: согнать
очень: очень
лужа: лужам
обычно: обычно
интенсивность: интенсивность
всевозможный: всевозможные
проточный: проточной
масляный: масляный
стража: страже
нагрузка: нагрузки
помощник: помощников
отличаться: отличавшийся
наиболее: наиболее
одежда: одежда
мытьё: мытье
заводчик-любитель: заводчики-любители
лидерство: лидерстве
гадость: гадости
сопение: сопения
спать: спящих
глянцевый: глянцевая
предмет: предметов
избежать: избежать
кличка: клички кличку
правило: правила
довольно: довольно
предоставить: предоставив
частность: частности
слизистый: слизистой
предложный: предложен
свидетельствовать: свидетельствуют
экземпляр: экземпляр
насыщать: насыщают
брахицефальный: брахицефальные
касаться: касается
стремительный: стремительными
молодой: молодых
аниматор: аниматоры
избыточный: избыточного
разборка: разборки
догнать: догнать
перспективный: перспективной
одновременно: одновременно
шампунь: шампуня
уловка: уловка
провести: проведите
сократить: сократить
харизматичный: харизматичный
данные: данным
проект: проекте
сразу: сразу
продолжать: продолжают
сигнализировать: сигнализирует
наследство: наследству
прокачка: прокачкой
пора: пор
кг: кг
созреть: созреет
свободный: свободной
охватывать: охватывающая
среднее: среднего
согласие: согласия
хождение: хождение
минимальный: минимальная
риск: риск
рацион: рацион
отзываться: отзываться
рот: рот
серый: серое
вейтпуллинг: вейтпуллинга
тупоугольный: тупоугольная
иной: иная иных
флегматичный: флегматичном
приковать: прикованных
радикальный: радикальная
важный: важный
собачий: собачьем
стая: стае
наедине: наедине
причём: причем
разграничивать: разграничивающий
переулок: переулкам
полноценно: полноценно
прохаживаться: прохаживаться
энергия: энергии
родитель: родителей
вызывать: вызывает
ожидание: ожидании
хвост: хвост
слой: слой
ремонт: ремонта
лежать: лежащей
губа: губы
трусливость: трусливость
пытаться: пытаются
рысью: рысью
чёрный: черными
дом: доме
хондроитин: хондроитином
паста: пасты
гораздо: гораздо
г: г
пет-класс: пет-класса
осмотр: осмотр
