ясно: ясно
овощ: овощи
гарантия: гарантия гарантию
ситуация: ситуациях
тело: тела телу
колебаться: колеблется
кровь: крови
средний: средняя среднее
отменный: отменная
приступать: приступая
летний: летнего
агрессия: агрессия
посторонний: посторонних постороннего
чёрный: черный черные черная черного
сколько: сколько
название: название названия
кинологический: кинологический
насильно: насильно
собака: собаку собакой собак собака собаках собакам собаке собаки
примерно: примерно
округлый: округлой округлые округлый
готовность: готовность
расположить: расположена
хороший: лучшим хорошего лучшие лучшему хорошей
возникать: возникают
физический: физических физической
симптом: симптомы
обсуждение: обсуждения
амбициозный: амбициозно
оно: оно
цена: цена
лечение: лечение
далёкий: далекие подальше
материал: материалов
служебный: служебная
поголовье: поголовья
погибнуть: погибнуть
отвлекаться: отвлекаться
подпалина: подпалин
обратить: обратите обратить
владелец: владельцам владельцев владельцы владелец
поведение: поведения поведение
подобный: подобного подобный подобное
пастуший: пастушьих пастушья пастушью
палец: пальца пальцев
ухудшение: ухудшение
стоять: стоят
любовь: любовь любви
нюанс: нюансы
сторона: стороны стороне сторону
долгий: дольше
сиба-ин: сиба-ину
некупированный: некупированном
волков: волков
семейство: семейства
режим: режиму
остановить: остановить
пекинес: пекинес
холка: холку холке
расчёсывание: расчесывании
россия: россия россии
ряд: ряда ряд
обратный: обратная
справиться: справиться
длительный: длительные длительное длительных
начинать: начинают начинать
смочь: сможете
радужка: радужки
представитель: представителей
предложение: предложение
контроль: контролем
массив: массива
команда: команду команде командам команд команда
шея: шея шеи
овчарка: овчарки овчарок овчарке овчарку овчарками овчарка
выплеснуть: выплеснуть
шерсть: шерсть шерстью
низкий: низкий низкая
специально: специально
применять: применять
волк: волк волком волка
микроорганизм: микроорганизмы
заводчик: заводчиками заводчиком
небольшой: небольшого невелик
должный: должны должен
воспитание: воспитания воспитание воспитанием
узкий: узкая
содержать: содержать
взгляд: взгляд
класс: класса
энергия: энергию
защита: защита
центр: центру
становиться: становиться становятся
босерон: босероны босерону босеронами босеронов босерон босероном босерона
сегодняшний: сегодняшних сегодняшний
месяц: месяц
висячий: висячими
большой: большой большое
необходимый: необходимы необходимое
пирожное: пирожные
общение: общения
участок: участки
овечка: овечками
указывать: указывая
назвать: назвать
спустя: спустя
безразличный: безразличным
служить: служить
выраженный: выражен выраженные
важно: важно
наклонный: наклонен
чуткий: чуткая
норма: норм
популярный: популярны
многий: многим многих
история: история
сообразительный: сообразительны
созревание: созревания
редкий: редкое редкая
щенок: щенка щенков щенки щенок
проявляться: проявляется проявляться
борозда: борозда
покупать: покупая
поощрять: поощрять
сбалансированный: сбалансированного
наш: наших нашей
заворот: заворота
принять: примите
разрешать: разрешать
значительный: значительному
голова: голове голова
несправедливость: несправедливости
выдвигаться: выдвигается
семья: семьи
ископаемый: ископаемая
шерстяной: шерстяного
характеристика: характеристика
немецкий: немецкий
стоп: стоп
беспомощный: беспомощными
руб: руб
предать: преданным преданного
около: около
следующий: следующие следующее
пол: пола
пятно: пятна
папа: папой
коготь: когти
весёлый: веселым
считать: считает
абсолютный: абсолютное
игровой: игровой
состав: составов
перефразировать: перефразируя
гипотеза: гипотезы
французский: французская французские французской французского французскому французский французскую
видео: видео
удивлять: удивляет
гетерохромия: гетерохромия
претерпеть: претерпев
защитить: защитить
характер: характере характера характеру характер
организовать: организовать
меню: меню
полностью: полностью
никакой: никаких
дом: домов доме
возможный: возможные возможна
полвека: полвека
домашний: домашних домашнего
такой: таких такое такие такая такому таким
локтевой: локтевого
босой: боса бос
атлетичный: атлетичный
привычка: привычка
речь: речь
образ: образ образом
содержание: содержание содержании содержания
чистый: чистыми
традиционный: традиционных
датироваться: датируется
щека: щекам
работа: работе работы работа
немного: немного
дегельминтизация: дегельминтизации
разновидность: разновидностей разновидности
боязливость: боязливость
составлять: составляет составляете
разлука: разлуки
настоящий: настоящим
прогнозный: прогнозные
окрас: окраса окрас окрасом окрасу окрасов
задача: задачей
подчиняться: подчиняется
связь: связь
точно: точно
надёжный: надежного
клуб: клуб
комфортный: комфортные
тестирование: тестирования тестирование
внешность: внешность
власть: власть
прослеживаться: прослеживается
внутриклеточный: внутриклеточном
пока: пока
стать: стали стать станет
сводистый: сводистые
предназначение: предназначения
зоомагазин: зоомагазины
облегчить: облегченный
выполнить: выполнить
торфяной: торфяная
официальный: официальный официальное
выставка: выставка выставке
наказание: наказаниях
возраст: возрасту возрастом возраста возрасте
преобладание: преобладание преобладанием
интерес: интереса
способ: способами способ
выполнение: выполнения
давать: давать дают
позыв: позывы
проделка: проделки
обувь: обувь
спокойный: спокойный спокойных
предмет: предметы
жирный: жирна
сохранение: сохранении
подвергать: подвергать
проходить: проходил
плотно: плотно
тёмный: темными темнее темный
казаться: кажутся
причина: причина
признак: признаки
постоянный: постоянным постоянной
суметь: сумев
качество: качестве качества
бывать: бывают
крупный: крупный крупная крупных крупного крупной крупное
смотреть: см
выносливый: выносливой выносливое
свинина: свинина
доверие: доверие
фотография: фотографии
агрессивный: агрессивная агрессивным
уход: уходе уход
знать: знать
развернуть: развернуты
помнить: помните
страдать: страдают
высокий: высокая высшей высокого
питомник: питомники питомника питомнике
переносить: переносят
возникнуть: возникла
сложение: сложения
выбирать: выбирайте
глаз: глаза глазами
район: районе
характерный: характерные
тип: типом
грязь: грязь
прийтись: придется
мягкий: мягкий
самый: самым самыми
самостоятельный: самостоятельной
распределяться: распределяется
морда: морды морда
часть: части
сказать: сказать
поздний: позже
форма: форме форму формы
конечность: конечностях конечности
право: праву
купировать: купированными купированные купировали купированы купировать
длинношёрстный: длинношерстную длинношерстной
поскольку: поскольку
существо: существо
социализировать: социализированное
краткий: краткая
язык: язык
отношение: отношение отношению отношения
всякий: всякого
заболевание: заболеваниям заболевания
животноводство: животноводства
уха: ухе
ребёнок: ребенка детям детей
отметить: отметить
нести: несет
эксперт: экспертов
купать: купать
ранний: раннего раньше
стремление: стремление
доверить: доверить
вконтакте: вконтакте
проявление: проявление проявлениях
версия: версии
дать: дать дано
ярко: ярко
мощный: мощной мощную мощного
роль: роль
отличительный: отличительная
поинтересоваться: поинтересуйтесь
развитие: развитие развития развитию
животное: животных животным животного животными животное
заслужить: заслужившим
разбойник: разбойников
олень: оленей
исключение: исключений
общий: общий общего
появление: появления появлению
серьёзный: серьезном
зарабатывать: зарабатывать
болеть: болеет
волос: волос
длина: длины длина
шпиц: шпиц
привязанность: привязанности
шутить: шутят
выбрать: выбрать
кусочек: кусочки
основать: основана
сустав: сустава
лакомый: лакомые
хотя: хотя
продукт: продуктов продукты
ассортимент: ассортимент
рельефный: рельефный
предпочтительный: предпочтительнее
обрезать: обрезают
хвост: хвостом хвоста хвост
установить: установить
больший: большая
проблема: проблемы проблема проблем
серый: серая серого
познакомиться: познакомиться
исследуться: исследуется
точка: точки
достижение: достижения
лохматость: лохматость
открытый: открытой
авторитетный: авторитетных
двух-трёхлетний: двух-трехлетнего
мера: меру мере
известный: известны
ограничение: ограничения
информация: информация
прийти: придет
масса: масса
максимально: максимально
телосложение: телосложения
будущее: будущем будущего
доберман: доберманом доберман
опаска: опаски
попрошайничество: попрошайничество
проводить: проводить проводите
справедливость: справедливость
выбор: выбор
специалист: специалистов специалисту специалисты
приложить: приложить приложил
родословный: родословную
обитание: обитания
правильный: правильного
зенненхунд: зенненхунда
польза: пользу пользы
юра: юра
странный: странным
предел: пределами
племенной: племенной
объяснить: объяснить
любой: любое любые
лапа: лапах лапы
вредный: вредные
равномерный: равномерным
выпас: выпаса
учесть: учесть
последовательно: последовательно
применяться: применяются применяется применялась
владеть: владеть
крепкий: крепким
длинный: длинные длинный длинная длинными
считаться: считается считаются
разведение: разведении разведение
взаимоотношение: взаимоотношений
без: безо
полный: полной полного
создать: создан
причинять: причинять
просто: просто
человек: людей человека
мех: меха
замедлить: замедленный
пёс: псов пес пса
рыжий: рыжий рыжих
учитывать: учитывая
встречаться: встречающаяся встречаются
брать: берут
сложность: сложность сложности
фрукт: фрукты
угроза: угрозы
который: которое которой которая которых которые который
территория: территории
лес: лесу лесов
вмешательство: вмешательства вмешательству
сердце: сердцем
контакт: контакт
сельский: сельском сельского
определённый: определенное определенных
добавить: добавьте
происхождение: происхождения происхождении
слабый: слабого
готовый: готовы готовые
первый: первые первого первый
исторически: исторически
пригодный: пригодного
пропорциональный: пропорциональны пропорционален
пища: пищи пищей
свой: своем свой своей
неприхотливый: неприхотливая
удлинённый: удлиненная
задний: задние задних
черта: черты черт черта
организация: организация
вакцинация: вакцинации
гладкий: гладкая
терпеть: терпеть
написать: написал
вожак: вожаком
дрессировка: дрессировка дрессировке дрессировки
время: время времени временем
истинно: истинно
ватный: ватными
приблизительно: приблизительно
сука: суки
отдельно: отдельно
агрессивность: агрессивность
защищать: защищать
давление: давление
день: дней дня день
аббат: аббатов
специализированный: специализированных специализированного
заседание: заседании
другой: другие других другими
просмотр: просмотров
использовать: используйте использовать
классика: классика
недёшево: недешево
автор: автор
толстый: толстые
разумный: разумным
нагрузка: нагрузкой нагрузке нагрузок
алина: алина
малышев: малышева
бойкий: бойкого
место: местах места месту
грызть: грызть
рост: рост росте
проветривать: проветриваемой
одиночка: одиночку
редкость: редкость редкости
согласно: согласно
изменение: изменений
допустить: допустят
определяться: определяется
умеренный: умеренное
к: ко
реклама: реклама
половой: половые
получить: получите получила получит
описать: описал
сыр: сыр
важный: важную
достигнуть: достигнет достичь
франция: франция франции
лакомство: лакомствами лакомств
оценить: оценен оценить
мускулатура: мускулатурой
отрицательный: отрицательную
грубый: грубая
немедленно: немедленно
ротвейлер: ротвейлером
непосредственно: непосредственно
зоошампунь: зоошампуни
желать: желающим
дойти: дошла
рекомендоваться: рекомендуется
получиться: получится
год: лет год годом году
здоровый: здорового
малыш: малыш малыши малыша
правильно: правильно
оба: обоих
взаимный: взаимной
добиться: добиться
сайт: сайту
процедура: процедур
сухой: сухие
активный: активный активным
понять: понять
член: членом членов членами
этот: эта этому этих
быть: будут
саблевидный: саблевидную
лишь: лишь
вариант: вариант варианта
медведь: медведей
рабочий: рабочие
иметь: имеющий имеет иметь
форум: форум форуме
оказывать: оказывает
сторож: сторожем
белка: белки
просматриваться: просматриваться
специальный: специальными специальные
данный: данный
тампон: тампонами
черно-подпалый: черно-подпалым черно-подпалый
сила: сил силу
нужный: нужное нужного
тяжело: тяжело
уважаемый: уважаемом
заводить: заводить
чистота: чистоте чистоты
расставить: расставить
контролировать: контролирует
соблюдение: соблюдение соблюдению соблюдении
защитник: защитником защитника
раковина: раковине
молодой: молодую
значительно: значительно
шоу-класс: шоу-класса
описание: описание
начало: начало
состояние: состояния
загородный: загородных
здоровье: здоровьем здоровью здоровья здоровье
иной: иную
найти: найти
собачий: собачьих
бежать: бегущий
глубоко: глубоко
однако: однако
гребень: гребнями
психика: психики
преданность: преданность
размер: размер размера
отличаться: отличаются
первоклассный: первоклассным
поэтому: поэтому
аборигенный: аборигенная
предлагать: предлагают
специализироваться: специализируется
копирование: копирование
короткий: короткий короткая
прекрасно: прекрасно
активность: активность
подверженный: подвержены
существовать: существует
насыщенный: насыщенный
систематический: систематических
удивительный: удивительную
дружелюбность: дружелюбность
незнакомец: незнакомцам
близкий: ближе
побаловать: побаловать
направление: направление
отзыв: отзывах отзывы
нога: ноги
черно-серый: черно-серого
заключаться: заключается
кошка: кошки
следовать: следует
взять: возьмут возьмет
шум: шум
доброжелательный: доброжелательный
принести: принесут
боль: боли
натуральный: натуральные натуральных
прямой: прямая прямые прямой
баланс: баланс
отличие: отличие
вырубка: вырубке
арлекин: арлекин арлекинов
учиться: учится
ровный: ровным
назад: назад
планировать: планируете
оттенок: оттенка оттенком
поначалу: поначалу
цвет: цвет цвета цветов
клиника: клинику
работать: работают работает
нечасто: нечасто
мочь: могут
предпочтительно: предпочтительно
влияние: влияния влияние
распределение: распределением
порода: породы пород порода
недоверчивый: недоверчив
особый: особого
творог: творог
объявление: объявления
медленно: медленно
сделать: сделать сделано
шалость: шалости
основной: основные
эгида: эгидой
интеллект: интеллект
охранный: охранные
псовый: псовых
многие: многие
средне: средне
пастбищный: пастбищного
вес: вес
показаться: показаться
степень: степени степень
уважение: уважение
конец: конец
питание: питания питание
семь: семи
широкий: широкая
ясный: ясный
линять: линяют
ежедневно: ежедневно
нос: носа нос
подходящий: подходящая
именно: именно
вопрос: вопросы вопрос
серьёзно: серьезно
потемнеть: потемнеет
приучать: приучают
отклонение: отклонения
продолжительность: продолжительность
процент: процент
телятина: телятине
публика: публике
затылочный: затылочный
срочный: срочного
острый: острая
два: двумя две двух
говорить: говорят говорить говорит
маленький: маленькими маленьких меньше
зависимость: зависимости
доминирование: доминированию
современный: современной
слегка: слегка
самка: самок
фото: фото
переходящий: переходящая
прибылой: прибылых
допускаться: допускается
сам: самого
комиссия: комиссия
яндекс: яндекс
умный: умны умная
гармонично: гармонично
кто: кого
вперёд: вперед
пытаться: пытаться
хотеть: хотите
череп: черепа череп
ухо: уха ушами уши
неудобство: неудобства
различный: различного
собака-пастух: собака-пастух
журнал: журнал
наружный: наружной
высота: высота
чей: чьи
страна: стране странах страна
двух-треха: двух-трех
применение: применения
хозяин: хозяину хозяина
получать: получают
болезнь: болезни
таков: таков
целиком: целиком
один: одной
либо: либо
уравновесить: уравновешенным
полицейский: полицейской
взрослеть: взрослеет
незаменимый: незаменимая
белый: белого
обнаружить: обнаружили
охота: охоте охоты
жест: жест
простой: простых простейших
обязательный: обязательны
ваш: ваши ваш вашего ваших
увидеть: увидеть
перегружать: перегружать
признание: признание
дружелюбный: дружелюбного
дисквалификация: дисквалификации
зверь: зверя
католический: католических
овца: овец
проявить: проявить
шоколад: шоколад
няня: няни
атлетический: атлетического
суета: суеты
результат: результатам результатами результата
кобель: кобели кобелей
весь: всему всем
движение: движения
терпение: терпение
истинный: истинного
условие: условиях условия
заметно: заметно
сумма: сумму
сородич: сородичами
резкий: резкое
объект: объектов
развитой: развитой
рукопись: рукописи
являться: являются
перейти: перейти
каждый: каждом
быстрый: быстрее быстрое
костяк: костяком костяк
серьёзность: серьезности
рынок: рынке
селекционный: селекционной
стандарт: стандарты стандарта стандартов
уровень: уровне
тот: тех тому ту
жёсткий: жестким
путать: путайте путают
обучать: обучайте
разноцветный: разноцветные
сведение: сведения
доходить: доходят
во-вторых: во-вторых
грудь: груди грудь
остро: остро
требование: требования требований
цепь: цепи
подошва: подошвой
отсутствие: отсутствие
слишком: слишком
позволить: позволило
одиночество: одиночеству
рацион: рационе рацион
никто: никто
развить: развита
покусывать-пощипывать: покусывать-пощипывать
успех: успехом успех успехи
подшёрсток: подшерсток
запрет: запрет
кой: коем
связать: связано
неохотно: неохотно
портить: портить
рвота: рвоте
играть: играют играет
услужливость: услужливостью
экономия: экономия
очаровательный: очаровательных
мускулистый: мускулистая мускулистого мускулистые
представляться: представляется
свобода: свободы
сытый: сытое
густой: густой
покров: покрова
оценка: оценке
появиться: появился появившуюся
бдительность: бдительности
рубль: рублей
убывание: убыванием
излишний: излишне
мочка: мочка
воспитанник: воспитанник
работоспособность: работоспособность
стая: стаи
желтизна: желтизной
сильный: сильное сильные
внимание: внимание
блестящий: блестящей
бодрость: бодрость
прислуживаться: прислуживаться
прикус: прикуса прикус
трюк: трюков
неделя: недель
впадина: впадина
интернет: интернет
идти: идет
полустоячий: полустоячими
диагностирование: диагностирования
средневековье: средневековья
стоимость: стоимость
удалять: удалять удаляя
бабочка: бабочка
особенно: особенно
отметина: отметины отметин
строго: строго
час: часов
верх: верху
сложный: сложным
достаточно: достаточно
дрессировать: дрессировать
обязательно: обязательно
осветить: осветил
нарушить: нарушить
кабанов: кабанов
расположение: расположение
придавать: придает
редко: редко
действенный: действенным
бесконечный: бесконечную
тренировка: тренировки
компаньон: компаньонами компаньоном
лишать: лишать
заложить: заложено
друг: другом друга
купить: купить
часто: часто
документальный: документальные
ушко: ушки
горный: горного
хирургический: хирургического хирургическому
принимать: принимает
предположение: предположения
завести: завести
желание: желание
спина: спина
предок: предки предком
хозяйка: хозяйкой
решение: решением
корпус: корпусу корпус
достаточный: достаточных
подпасть: подпал подпала
наличие: наличие
какой-либо: какие-либо
курятина: курятине
усвоить: усвоить
запретить: запретили запрещено
крупа: круп
сложиться: сложилось
гуманно: гуманно
строгость: строгость
обман: обман
навсегда: навсегда
одноклассник: одноклассники
скорее: скорее
бахромчатый: бахромчатая
разный: разного
выпасть: выпавшую
структура: структуре
дисплазия: дисплазия
возможность: возможности возможность
сходство: сходство
министерство: министерства
сердить: сердят
случайный: случайные
передний: передние
ответ: ответе ответ
чётко: четко
случай: случаи случае
кроме: кроме
хозяйство: хозяйстве хозяйства
сторожевой: сторожевую
сегодня: сегодня
водный: водных
эволюционный: эволюционное
частый: чаще
поиск: поиск
накопиться: накопившуюся
наклон: наклона
разработать: разработанное
привести: привело привести
трактат: трактат
тазобедренный: тазобедренного
потребоваться: потребуется
знаток: знатоки
помощь: помощь
период: период
заставить: заставить
явление: явление
встать: встал
представить: представлен
малый: наименьшую
пройти: пройдет прошла
светлый: светлые светлый
раболепие: раболепием
конкретный: конкретном
потребность: потребность
порок: пороки
подколенный: подколенная
формироваться: формировалась
забота: заботы
остевой: остевой
линька: линьки линька
жизнь: жизни
абсолютно: абсолютно
пушистый: пушистый
рука: руку
жизнерадостный: жизнерадостным
лишний: лишний
план: планах
видеть: видит
впервые: впервые
запах: запаха
воспитывать: воспитывать
мышиный: мышиного
неприятный: неприятного
гладкошёрстный: гладкошерстной
желудок: желудка
умилять: умиляют
отличать: отличает
относительно: относительно
нужно: нужно
мимимишность: мимимишности
также: также
мраморный: мраморных
процесс: процесс
внешний: внешнем
любопытный: любопытным
несложный: несложных
ждать: ждать
армия: армии
цель: цели
момент: моменты момент
окружающий: окружающих
возможно: возможно
нижний: нижней
конфета: конфеты
регион: региону
крупяной: крупяные
старший: старшего
методика: методике
живот: живота
поясница: поясница
болезнетворный: болезнетворная
рутинность: рутинности
детство: детства
прогулка: прогулок
стадо: стадами
взаимопонимание: взаимопонимания
обучить: обучить
развиваться: развивалась
изначально: изначально
высоко: высоко
наблюдательность: наблюдательность
мелочь: мелочам
наследственный: наследственным
направить: направлено
область: области
стоить: стоит
это: это
опасно: опасно
житель: жителям
питомец: питомца питомцем
ножницеобразный: ножницеобразный
подолгу: подолгу
массовый: массовой
квартирный: квартирного
микрофлора: микрофлора
обиход: обихода
заниматься: занимался
игривый: игривого
квартира: квартиры
вполне: вполне
сохранять: сохраняет
палка: палкой
укоротить: укороченный
выглядеть: выглядящая
любить: любят
нуждаться: нуждается
сладкоежка: сладкоежки
график: графиков
невозможно: невозможно
способный: способен
стараться: старайтесь
приоритетный: приоритетной
отар: отары
служба: службы
построить: построить
каша: каши
шёрстка: шерстки
париж: париже
выносливость: выносливость
сохранить: сохранить
лента: ленту
воспитать: воспитать
метис: метисом
известно: известно
дух: духа
отличный: отличные
воплощать: воплощают
альтернатива: альтернативы
во-первых: во-первых
заплатить: заплатить
вакансия: вакансии
прямо: прямо
насилие: насилия
лобный: лобная
начинаться: начинается
генетик: генетикам
подниматься: поднимаются
генетически: генетически
сей: сей
обустроить: обустроить
надлежащий: надлежащем
выше: выше
прекрасный: прекрасным
выражаться: выражается
молоко: молоко
отит: отитов
занятие: занятия
обойтись: обойтись
управлять: управлять управляли
стоящий: стоящие
пробежка: пробежке
плавный: плавный
чересчур: чересчур
ягодица: ягодицах
избранник: избранника
посадить: посажены
корм: корма
большинство: большинство
незамедлительно: незамедлительно
заболеть: заболеть
вздутие: вздутие
главный: главная
практически: практически
логично: логично
цениться: ценится
рейтинг: рейтинг
дефект: дефекты
теряться: теряться
подписываться: подписывайтесь
прижать: прижаты
очень: очень
обычно: обычно
ладить: ладит
особенность: особенности
бок: бокам
умение: умение
выполнять: выполнять
наиболее: наиболее
нежирный: нежирный
периодический: периодическом
наоборот: наоборот
разнообразный: разнообразных
постепенно: постепенно
избежать: избежать
врозь: врозь
специфический: специфическим
кличка: клички
правило: правила правил
мясной: мясных
довольно: довольно
держать: держать
изучить: изучить
скорый: скором
приемлет: приемлет
проверка: проверку
дело: деле
потомок: потомок
моральный: моральное
сократить: сократить
проект: проекте
сразу: сразу
склонный: склонны
настроить: настроены
опека: опеку
сводиться: сводится
кг: кг
необходимость: необходимости
заняться: занявшийся
среднее: среднего
разрушить: разрушить
прилегать: прилегающая
действительно: действительно
потенциальный: потенциальные
низко: низко
темперамент: темперамент
снижение: снижению
облик: облике
ловкий: ловкое
внутренний: внутренней
величина: величина
кормление: кормления
останки: останки
специализировать: специализированном
причём: причем
загрязниться: загрязнилась
красноватый: красноватым
неприемлемый: неприемлемы
основание: основанием
сходить: сходя
родитель: родителей
подробно: подробно
упругий: упругой
вольер: вольер
бугор: бугор
взрослый: взрослым
утвердить: утвердила
собака-чемпион: собакой-чемпионом
лосниться: лоснящейся
раздражительный: раздражительным
недостаток: недостатками
городской: городским
гораздо: гораздо
приём: приема
некоторый: некоторым
монотонность: монотонности
полноценный: полноценным
пет-класс: пет-класса
шаг: шаг
беспрекословно: беспрекословно
птичий: птичьем
