пилочка: пилочку
событие: событий
использовать: используя используйте использовали использовать
кинолог: кинологов кинологи кинолог кинологом
вытирать: вытирать
тело: тела теле
пигментация: пигментацию
широко: широко
средний: средняя
скот: скота
напоминать: напоминали
основа: основе основу
пища: пища пищу
дрожжевой: дрожжевое
из-под: из-под
зоошампунь: зоошампунь
похожий: похожих
активный: активные активная активное
познакомить: познакомить
гиперкератоз: гиперкератоза
следить: следить
участвовать: участвовать
сколько: сколько
своевременный: своевременной
быть: будете будучи е будьте будут
склонный: склонен склонны
больший: наибольшим большую
буфало: буфало
уметь: умеют
солновать: солную
душа: души душ
послушный: послушные
название: название названием названия
погоня: погоню
поглаживать: поглаживайте
домой: домой
собака: собаку собаками собакой собак собака собаке собаки
обсуждение: обсуждения
рукавица: рукавицей
кровожадный: кровожадном
поинтами: поинтами
ваш: вашему ваше ваши ваш вашего ваша
английский: английских
цена: цена
рыба: рыбу рыбой
зачастую: зачастую
блеск: блеска
бюджетный: бюджетным
подушечка: подушечки
дегельминтизация: дегельминтизация
забывать: забывая забывайте
мастиф: мастифы мастифам мастиф мастифов
материал: материалов
приподнять: приподнимите
казаться: кажется
предотвратить: предотвратить
представлять: представлял представляет
тибетский: тибетским
дыхание: дыхание
массивный: массивным массивный массивные
укоротить: укороченную
обратить: обратите обратить
повтор: повтор
поведение: поведения поведении поведение
храп: храп
возвышаться: возвышается
любовь: любовь любовью
сторона: стороны сторон
бдр: бдрах
де: де
стремиться: стремилось
скапливаться: скапливаются
ниспадать: ниспадает
использование: использовании
россия: россия россии
морда: морде морду морда
раковина: раковины
обратный: обратная обратное
длительный: длительные
следующий: следующих следующий
начинать: начинают начиная
радужка: радужки
размер: размеров
предварительно: предварительно
представитель: представителей представитель представители
кобель: кобелях кобели кобелей
грань: грани
лещеватый: лещеватую
команда: команду команд команды команда
нападение: нападение
шея: шея шеи
наблюдаться: наблюдаются
отмечать: отмечают
развитой: развитым
компаньон: компаньон
выплеснуть: выплеснуть
рыхлый: рыхлое
особенность: особенностью особенности
шерсть: шерсть шерсти шерстью
ласково: ласково
поверхность: поверхности
некупированный: некупированными
трик: трике
низкий: низкий низкую
документ: документы документов
увеличение: увеличении
шаг: шага шаг
нынешний: нынешним
накатать: накатанной
грязнуля: грязнулю
крупа: крупа круп
соответствовать: соответствуют
розовый: розовый
гость: гостя
сага: сага
третий: третий третья
челюсть: челюсти челюсть
завезнный: завезнных
должный: должны должен должно должна
воспитание: воспитания воспитание
кто-либо: кого-либо
покупка: покупку
пойти: пойдут
содержать: содержать
взгляд: взгляд взгляде
исключение: исключение
класс: класса классом класс
сторож: сторож
энергия: энергию
центр: центру
смочить: смоченный
человек: людям людей человека человек человеком люди
месяц: месяц
питомец: питомцами питомец питомца питомцем
недюжинный: недюжинную недюжинной
большой: большой
сверху: сверху
столь: столь
назвать: назвать
спустя: спустя
следом: следом
сдержать: сдержать
теория: теория теории
включая: включая
отличаться: отличается отличаются
выраженный: выражен
обильный: обильные
важно: важно
упругий: упругие
главный: главный главных главная
бордос: бордосов бордоса бордосам бордосы бордос
статья: статью статьи
дог: догом дога доги доге догов дог
история: история истории
щенок: щенка щенков щенки щенок щенку щенкам щенками
забываться: забываться
парка: парке парку
эффективный: эффективным эффективнее
уживться: уживтся
ненароком: ненароком
альтернатива: альтернатива
внимательный: внимательны
государство: государства
поощрять: поощрять поощряйте поощрял
попросить: попросите
заворот: заворота
выжить: выжить
пытливый: пытливым
великан: великаном великану
напускной: напускной
форма: форма форму
помт: помтов
голова: голове головы головой голову голова
валяться: валяться
тплый: тплой
семья: семьи семье семей
портрет: портрет
характеристика: характеристика
род: рода
стоп: стоп
исключить: исключите
выставка: выставках выставки выставке
определнный: определнном определнный определнных
помощь: помощью помощь
дом: дому дома
предать: преданным преданном преданы
включить: включить
тортик: тортик
эмоция: эмоции эмоциями
выступать: выступает
лоскут: лоскутом
около: около
зарождение: зарождения
купание: купания
ожирение: ожирение
пол: пола пол
война: войны
кунстлера: кунстлера кунстлер
удалить: удалите
экзекуция: экзекуции
неторопливый: неторопливого
окрик: окрики
убрать: уберут
смазать: смажьте
коготь: когти когтями
порода: породе породы пород порода
унаследовать: унаследовали
самоотверженно: самоотверженно
отнюдь: отнюдь
стать: стала стал стать станет
появление: появление появления появлении
любимый: любимый любимой любимая
маска: маска маской маски
палец: пальцы пальцами пальцев палец
заплатить: заплатили
быстро: быстро
квадратный: квадратная квадратный
маленький: маленькой маленький маленькими
яичко: яичек
чувствовать: чувствовало
первый: первой первым первый первая первую
удаться: удалось
военный: военное
диск: диск диском
раз: раза
видео: видео
помимо: помимо
великолепный: великолепный великолепные
жирный: жирную жирным
слаженный: слаженнее
беспокойно: беспокойно
начать: начать
внимание: внимания вниманием внимание
вода: воды вода водой
условие: условии условиях условия
возможный: возможные
кровосмешение: кровосмешения
медлительный: медлительными
высвободить: высвободить
спускать: спускать
горбатуюпровиснуть: горбатуюпровисшую
распространнный: распространнным распространнной распространнном распространнных
губа: губу губы
такой: таких такая такого таким
древний: древних древнейших
катастрофически: катастрофически
локтевой: локтевого
чистокровный: чистокровные чистокровной чистокровных
косточка: косточками
рацион: рациона рационе рацион
лопатка: лопатками лопатки
коричневатый: коричневатого
содержание: содержание содержанием содержания
уважение: уважением уважение
сера: серы
немного: немного
когтереза: когтереза
движение: движение движения движении
попытка: попытки
аналог: аналог
сон: сон
рекомендовать: рекомендуют
защита: защиты
огромный: огромного огромные огромный огромным огромное
натуральный: натуральном
рак: рака
достоверный: достоверные
охранник: охранники
запомнить: запомните
ветеринар: ветеринару ветеринар ветеринара
допускать: допускает
задача: задачей задача
богатырь: богатыря
городской: городских городскому
масло: масло
протереть: протрите
ушной: ушные
прокормить: прокормить
хватка: хватка хватке
сопернический: сопернические
территория: территорию территории
связь: связь
меньен: меньен меньена
приподниматься: приподнимаются приподнимается
выделить: выделили
опустить: опустить опущен
доверять: доверять
уткнться: уткнтся
сбалансированный: сбалансированном
оставить: оставил
трещина: трещин
клуб: клуб
комфортный: комфортные
прыгать: прыгать
внешность: внешность
месье: месье
количество: количествах
домашний: домашние домашней домашнего
освежванная: освежванных
незнакомый: незнакомыми незнакомого
лоб: лба лоб
острый: острую острых
владелец: владельцев владельцу владельцы владельцем
профессионал: профессионалу
спокойствие: спокойствия спокойствии
артрит: артрита
изучение: изучение
устрашать: устрашающую
недостаток: недостатком недостаток
пока: пока
ориентироваться: ориентироваться
антисептик: антисептиком
бурбуля: бурбуль
бутилировать: бутилированная
принимать: принимая принимает
состояние: состоянии
доверие: доверием
изучить: изученных
выполнить: выполнить
французский: французские французский французскую
яйцо: яйца
полнота: полноте
считать: считали считал считают считать
очаровательный: очаровательным очаровательный
тоса-ин: тоса-ину
год: годах года лет год годов году
дважды: дважды
лимфома: лимфомы
аналогично: аналогично
размять: размять
основный: основного
уязвимый: уязвимая
протирать: протирать
признание: признания
чемпион: чемпион
выучить: выученное
мягкость: мягкость
пресекать: пресекать
старший: старше
мебель: мебель
плотно: плотно
дойдт: дойдт
причина: причина причиной
проверить: проверить проверенного
ежедневный: ежедневного ежедневных
воздержаться: воздержитесь
смотреть: см
иммунитет: иммунитетом
ван-капель: ван-капеля
фотография: фотографии
осматривать: осматривать
возвысить: возвышена
одрнит: одрните
агрессивный: агрессивная агрессивными агрессивное
уход: уходе ухода уход
воспользоваться: воспользуйтесь воспользоваться
помнить: помните
общественность: общественности
бордоский: бордоским бордоский бордоского бордоские бордоских бордоском
результат: результат результаты
страдать: страдают
высокий: высокая высокую
питомник: питомники питомника питомнике
верхний: верхней верхнюю
переносить: переносят
роль: ролями
глаз: глаза глаз
приняться: принялись
самый: самый самым самое
грязь: грязь грязи
организовать: организованной
создавать: создают создавая
присесть: присев
знать: знайте
корм: корм корма
порок: порокам пороки
воодушевлнный: воодушевлнные
начаться: началась
туша: туш
вниз: вниз
переврнутуй: переврнутую
незначительно: незначительно
страстный: страстным
сказать: сказать
поинта: поинты
прогулка: прогулка прогулки прогулках прогулок прогулке
страшный: страшнее
обожать: обожает
поскольку: поскольку
манипулятор: манипуляторы
обучение: обучения
правило: правилам правила
сука: сукам суки сук сукой
краткий: краткая
расширить: расширенный
обзавестись: обзавестись обзавелись
истинный: истинные
бордосский: бордосский
долгий: долгое
сильный: сильная сильную сильные
отношение: отношение отношениями отношения
заболевание: заболеваниям заболеваний
место: место места
компания: компанию
исключительно: исключительно
прохладный: прохладный
край: края
всецело: всецело
способ: способов
эксперт: экспертов
сопровождать: сопровождают
навязчивость: навязчивость
упрямство: упрямством
факт: факт факты
сражение: сражения
вконтакте: вконтакте
вольготно: вольготно
лёгкий: легче
вызвать: вызовет
версия: версии версия
консервы: консервы
растянутый: растянутая
создать: создать создаст создал
шрстный: шрстный
веслый: веслый
дать: дать
ярко: ярко
срок: срок
проявлять: проявлять
отличительный: отличительная
подбородок: подбородок
взяться: взялся
чередовать: чередовать
животное: животных животным животного животными животные животное
различие: различия
один: одного одна одной
усваивать: усваивают
чадо: чадо
толстячок: толстячок
земля: земле
лидер: лидер
яблоко: яблоком
тон: тон
охотничий: охотничьих охотничий
выбрать: выбрать
привлк: привлк
подсолнечный: подсолнечное
скула: скулы скулам
пс: пс
докучать: докучать
оба: обеих
мясистый: мясистые
основать: основана основали
хотя: хотя
нижний: нижняя
расстояние: расстоянии
определиться: определитесь
друг: друзей друг друге другом друга
плоскость: плоскости
век: веке
спор: споры
лишний: лишним лишнее
отрицать: отрицали
незначительный: незначительные
складочка: складочек
выгуливать: выгуливать
встреча: встречи встречей встреча встречу
афганский: афганская
который: которую которой которого которая которых которым которые который
витамин: витаминов
одержать: одержал одержала одержать
породный: породный
осмотр: осмотре
мягкий: мягкую мягкая
заметный: заметный заметна
посильный: посильную посильное
любитель: любителем
квартира: квартире
официально: официально
мера: меру мере
бутылка: бутылку
плод: плоды
известный: известны известной
угощение: угощением
интерьер: интерьеру
информация: информация
подходить: подходит подходили
телосложение: телосложение телосложением
соразмерный: соразмерна
масса: масса массу
максимально: максимально
сохраниться: сохранилось сохранились
тесный: тесный
создание: создание
сустав: суставы суставов
совместно: совместно
атаковать: атакует
будущее: будущем будущим будущего
независимость: независимостью
трижды: трижды
сначала: сначала
передний: передними передние передних
остальной: остальных
защищнность: защищнности
ниже: ниже
кошка: кошкой кошки
мытьё: мытья
истина: истину
характер: характера характер
участник: участником участников
настоять: настоянная
окрас: окрас окрасом
малый: малейшей малейшая малых малейшее малейший меньшем
прятаться: прятаться
вздрнут: вздрнута
нарост: наростами
сухой: сухой сухим
водный: водные
безопасный: безопасным
габарит: габариты
кончик: кончик кончиками кончиках
среди: среди
травмоопасный: травмоопасными травмоопасным
число: число числе
дуга: дуги
любой: любое любом
последовать: последовать
планировать: планируя
линия: линию линия линии
положительный: положительными
официальный: официального
комната: комнату
программа: программы программах
корень: корню
новый: новых новой новый
подружиться: подружиться
крепкий: крепким
считаться: считается
собаковод: собаководов собаководы
заводить: заводите
случай: случая случаях случае
тревожный: тревожный
шотландский: шотландская
рука: руки руку
утяжелнный: утяжелнные
заполнить: заполнена
кишка: кишок
палочка: палочкой
объм: объм
спрос: спроса
вид: видом вида виду виде вид
пёс: псов пес пса псом
любящий: любящим
находить: находить
час: часа часов
бар: баре
приобретать: приобретайте приобретает
гулять: гуляя
внеочередной: внеочередная
вперд: вперд
эйлер: эйлеру
последовательный: последовательной
разбитый: разбитые
мировой: мировой
алкоголь: алкоголя
видимость: видимость
женский: женского
отсутствовать: отсутствовать отсутствуют отсутствует
усилие: усилия усилий
добавить: добавьте
холка: холка холке холкой
умеренный: умеренная умеренную
происхождение: происхождения происхождение
резец: резцы
объмный: объмную
повторно: повторно
необходимо: необходимо
готовый: готовы
прочный: прочные прочными
ореховый: ореховым
кунстлер: кунстлером
задний: задние
раздор: раздора
дверь: дверь
скопление: скопление
тщательно: тщательно
разрез: разрез
импортировать: импортировали
оставлять: оставляйте
ничтожно: ничтожно
лакомство: лакомство
написать: написал
дрессировка: дрессировка дрессировке дрессировки
предплечье: предплечья
стандартный: стандартный
время: время времени временем
прямой: прямым прямая прямые прямое прямой
плохой: хуже
агрессивность: агрессивность
устроить: устроить устройте устроит
полость: полость
требовать: требует требуют
нежеланный: нежеланного
чистить: чистите
наказание: наказания
деятельность: деятельности
показывать: показывает
паспорт: паспортом паспорт
пясть: пясти
другой: другие другого другими другим
мажента: мажент
хозяин: хозяином хозяину хозяина
худоба: худобу
ротовой: ротовая
оборот: оборот
взять: возьмите взять
младший: помладше
тотчас: тотчас
стелиться: стелиться
предпочитать: предпочитает предпочитают
характерный: характерна характерен
речной: речную
категория: категории
несколько: несколько нескольких
охрана: охраны
множество: множество
враг: враг
стойкий: стойким
рост: рост
борзая: борзая борзых
экстравагантный: экстравагантный
вверить: вверенной вверенную
сведт: сведт
согласно: согласно
прививка: прививки
гриб: грибы
часовой: часовых
строгий: строгим
повторить: повторить
кровавый: кровавой кровавых
резко: резко
реклама: реклама
соответственно: соответственно
описать: описал
заводчик: заводчиком заводчиков заводчика заводчики
крав: крав
силиконовый: силиконовыми
нужный: нужным нужные
счастливый: счастливы
хромать: хромать
побегать: побегал
франция: франция франции
дисквалифицировать: дисквалифицирующим
неглубокий: неглубокой
второй: второй
ум: умом
тропа: тропе
султана: султаной
рекомендоваться: рекомендуется
мочка: мочки мочка
получиться: получится
отдать: отдайте отдать
займт: займт
продолжительный: продолжительный
достигать: достигает
грубость: грубость
здоровый: здорового здоровый
имя: имени имя
повредить: повредить
брон: броне
беспричинно: беспричинно
шесть: шести
правильно: правильно
неосторожный: неосторожное
завоевать: завоевать
руководство: руководством
незаметно: незаметно
лапа: лапами лапы
сайт: сайту
вертикальный: вертикальной
вымирание: вымирания
длинный: длиннее
кофеин: кофеина
родословная: родословной
отложить: отложить
решить: решите решил
получаться: получаются
конечность: конечностями конечностей конечности
скрываться: скрывается
дорогой: дорогое
недуг: недугов
чайный: чайной
этот: эта этих
лишь: лишь
относиться: относиться
вариант: вариант вариантом варианты
променад: променадам
рбра: рбра
признавать: признавать
форум: форум форуме
угроза: угроза угрозе
предпочтение: предпочтение
хозяйничать: хозяйничать
минерал: минералов
беспокойный: беспокойный
испортить: испорченная
предложить: предложив
приободрить: приободрите
начало: начала начало
прекращать: прекращать
закруглить: закруглены
удлиннный: удлиннная удлиннный
светло-коричневый: светло-коричневым
член: членам членов члены
приучение: приучение
компенсировать: компенсировать
близко: близко
старый: старой
обещание: обещанием
кобелма: кобелм
признак: признак
лгкий: лгких
морской: морской
описание: описание
лепта: лепту
грубый: грубые
мужской: мужского
мишень: мишень
послушание: послушанием
присущий: присущи
транспортировка: транспортировки
оттенок: оттенки оттенка
спасение: спасения
посадить: посаженные посажены
пройтись: пройдитесь
приступать: приступать
социализировать: социализированный
здоровье: здоровьем здоровье
округлый: округлые
мускулатура: мускулатура
сырой: сырые
найти: найти
еда: еда
собачий: собачьих
оказаться: оказалась оказаться оказалось
увлажннный: увлажннным
раскачивание: раскачивание
иноходь: иноходь
усыпить: усыпили
обработка: обработка
отсутствие: отсутствием отсутствие
поэтому: поэтому
консультация: консультацию
копирование: копирование
короткий: короткий короткая
неразвитый: неразвитые
победа: победу
активность: активность
затронуть: затронули
подверженный: подвержены
предусматривать: предусматривает
дружелюбность: дружелюбность
галочка: галочку
вкусный: вкусный
попасть: попали
иить: иили
низ: низа
пьер: пьер пьера
отзыв: отзывах отзывы
размножение: размножения
крупный: крупных крупной крупными
выпуклый: выпуклую выпуклый
нуль: нулю
следовать: следует
неприятный: неприятный неприятного
представить: представил представили
резкий: резкие
выделение: выделения
толкнуть: толкнуть
хлопоты: хлопот
мимо: мимо
шум: шум
порядочный: порядочную
поиск: поиску поиск
цилиндрический: цилиндрическую
особь: особи
успокоить: успокойте
процедура: процедуры
некий: некий
книга: книгу
влажный: влажный
придться: придтся
некоторый: некоторую
широкий: широкой широкая широкое широких
опасный: опасными
миска: миске
цвет: цвет цвета
клиника: клинику
кость: кости
утверждать: утверждал утверждало
несоответствие: несоответствия
мочь: могут можете
локоть: локти
протекать: протекает
поливать: поливают
произойти: произошла произошли
выведение: выведения
привязанность: привязанность
отходить: отходить
малыш: малышами малыша
груз: грузом
сделка: сделки
объявление: объявления
неаккуратно: неаккуратно
сделать: сделать сделаете сделано сделайте сделает
бульдог: бульдогов
основной: основные
полова: половой
дополнительный: дополнительным
мячик: мячик
оказать: оказать
родитель: родителями
интеллект: интеллект интеллектом
охранный: охранные
скрещивать: скрещивали
пробежка: пробежку
многие: многие
проявление: проявления
средне: средне
культура: культуры
вес: вес
спина: спину спина
боевой: боевых
серуесть: серуем
игривый: игрив игривым
конец: конец
питание: питания питании
повторный: повторное
купать: купают
голос: голос
ежедневно: ежедневно
позволять: позволяют позволяйте
нос: носа нос
разделна: разделн
разведение: разведение разведения разведению
брать: берите
рвться: рвтся
хриплый: хриплое
немногочисленный: немногочисленных немногочисленным
именно: именно
тмной: тмной
отклонение: отклонения отклонение
чрезмерный: чрезмерная
утихать: утихают
улица: улице
свежий: свежая свежем
измениться: изменилось
ответственность: ответственность
добродушный: добродушный
продолжительность: продолжительность
два-три: два-три
диван: диване
местонахождение: местонахождение
составлять: составлять
возбуждение: возбуждение
близкий: близких
поехать: поехали
горло: горле
вряд: вряд
любопытный: любопытен
облегчать: облегчает
скученный: скученными
обеспечить: обеспечить обеспечит
подстилка: подстилке
короче: короче
сознание: сознании
затянуться: затянуться
бобовый: бобовые
сезонный: сезонной
улыбка: улыбку
предстат: предстат
непослушный: непослушного
лениться: ленятся
почтный: почтным
отдых: отдыха
современный: современной
череп: черепу череп
слегка: слегка
нелюдимый: нелюдимым
оберегать: оберегали
деликатно: деликатно
посторонний: посторонним
обращаться: обращаться
фото: фото
достоверно: достоверно
вы: вами
взбодрить: взбодрит
сам: самого сама
отучить: отучите
яндекс: яндекс
ротвейлер: ротвейлер
барабанный: барабанные
детский: детским
тренироваться: тренируется
цитрусовый: цитрусовые
участие: участие участия
гармонично: гармонично
стереотип: стереотипы
убить: убили
гастон: гастон
ребнка: ребнка
хотеть: хотите
социализация: социализации
сравнение: сравнении
атака: атаку
складываться: складываются
возня: возня
относить: относят
верный: верным
селекционер: селекционеру селекционеров селекционеры
премиум-класс: премиум-класса
журнал: журнал
тяжлый: тяжлые
четыре: четыре
весь: всей
высота: высота
загривок: загривок
жаркий: жаркий
поглаживание: поглаживанием
привязь: привязи
одышка: одышку
чей: чьи
нуждаться: нуждаются нуждается
предстать: предстанет
поддерживать: поддерживал
мяч: мяч
внешний: внешним внешнюю
тот: та тех тому
подтянутый: подтянутую подтянутая
мощный: мощного
пристально: пристально
пищеварение: пищеварение
голодный: голодного
кисломолочный: кисломолочными
покров: покров
вакцинация: вакцинацию
подобрать: подобранном
болезнь: болезни
возглавлять: возглавлявший
ребёнок: дети ребенком детьми
записаться: запишитесь
алан: аланов алан
инфекция: инфекций
ухо: ушами уши ухо
аргентинский: аргентинского
четвероногий: четвероногим четвероногого
чрезмерно: чрезмерно
добыча: добычи добычей
пугать: пугающая
требование: требование
раймона: раймон
бульмастиф: бульмастифами
вдоволь: вдоволь
минута: минут
излишний: излишним излишнее излишнюю
подсказать: подскажет
настороженный: насторожен
придание: придания
объятие: объятиях
внимательно: внимательно
ринуться: ринется
очевидный: очевидное
наклонный: наклонный
селекция: селекции
развлечение: развлечении
подвес: подвеса
проявить: проявить проявите проявит
немногие: немногие
проясниться: прояснились
пусть: пусть
гипервозбудимость: гипервозбудимость
распространить: распространены
взрослый: взрослые
допустимый: допустимы
слюна: слюна
плохо: плохо
ущерб: ущерб
перекус: перекус
упасть: упасть
природа: природа природу
вооружиться: вооружитесь вооружиться
взросление: взросления
диморфизм: диморфизм
дальнейший: дальнейшей дальнейшем
дело: дело
отправляться: отправляйтесь
этап: этап
вечерний: вечерним
перейти: перейти
внести: внесли
счастие: счастью
метеоризм: метеоризма
чрной: чрной
постараться: постарается
своенравный: своенравны
простой: простую простым
невыраженный: невыраженная
ткань: ткани
проводиться: проводиться
нетипичный: нетипичную
главное: главное
повсеместно: повсеместно
регулярно: регулярно
посадка: посадку посадка
костяк: костяком
овощ: овощами
аккуратный: аккуратного
броситься: бросится
наградить: наградила
объяснение: объяснение
уголок: уголках
менее: менее
скулить: скулить
сигнал: сигнал
пойдт: пойдт
собрат: собратьями собратьев
атлетичный: атлетичным
мечтательный: мечтательный
ветеринарный: ветеринарный ветеринарную
углубляться: углубляются
рыжий: рыжих
тест: теста
судьба: судьбы
прислушаться: прислушайтесь
грудь: груди грудь
вышеупомянутый: вышеупомянутого
клетка: клетка
цель: целью
англичанин: англичане
одиночество: одиночеству одиночество
последний: последний последнего
лгковать: лгкую
требоваться: требуется
ограничиться: ограничьтесь
удержать: удержать
успех: успехом успех
стандарт: стандарта стандарту стандарт
победитель: победителя победителем
роды: роды
работа: работа
сзади: сзади
день: день
списать: списанный
мелкий: мелкие
наружное: наружного
бездействие: бездействие
тёмный: темнее
небольшой: небольшие
необходимый: необходимую необходимые
зимний: зимнее
снова: снова
оценка: оценке
зарегистрировать: зарегистрировала зарегистрировали
неосуществимый: неосуществимой
шланг: шланга
рубль: рублей
разный: разным
спереди: спереди
заключение: заключению
поменяться: поменяетесь
сказываться: сказывается
сложный: сложнее
затруднительно: затруднительно
смело: смело
вечером: вечером
сообразительность: сообразительностью
трх: трх
ведро: ведро
красавец: красавец
воспаление: воспаления
благоприятный: благоприятную
поясница: поясницу поясница
неделя: недель неделю
каждый: каждый
визит: визит
отрицательно: отрицательно
племенной: племенных
сожительство: сожительство
однообразный: однообразнее
часть: часть
чеснок: чеснок
иметь: имеет имеют
обратиться: обратиться
японский: японскими
напугать: напугать
стоимость: стоимость
подтверждать: подтверждающих
среда: среду
осмотреть: осмотрите
иначе: иначе
бульдогообразный: бульдогообразную бульдогообразный
шарм: шарм
особенно: особенно
отметина: отметины
филипп: филиппом
окончание: окончания
трусливо: трусливо
бельмондо: бельмондо
обмотать: обмотайте
дрессировать: дрессировать
достаточно: достаточно
ваза: вазы
обязательно: обязательно
покинуть: покинуть
родство: родства
рисковать: рискуете рисковать
почка: почек
прилегать: прилегают
войти: войти
фактор: факторов
ассоциироваться: ассоциироваться
кропотливый: кропотливого
круглый: круглые
нетрезвый: нетрезвым
кабанов: кабанов
полениться: поленитесь
редко: редко
возраст: возраста возрасте
угощать: угощать
москва: москве
тренировка: тренировки тренировка
прикус: прикусом прикус
примкнуть: примкнул
смочь: смог
возвращение: возвращении
популярность: популярность
пять: пять
семейный: семейной
поводок: поводке поводка
обстоятельство: обстоятельствах
мечтать: мечтаете
несмотря: несмотря
сладость: сладости
купить: купить
часто: часто
подопечный: подопечных
поставить: поставлены
свой: своего своей своих своему
предел: пределах
лукавство: лукавства
допускаться: допускаются
трапециевидный: трапециевидная
путь: пути
вытянуто: вытянуто
тонкий: тонкая
разводить: разводили
период: периоды
дорогов: дороговой
непременно: непременно
пэт: пэт
ласковый: ласковым
приверженец: приверженцы
основание: основание
паразит: паразитов
открыть: откроет
придавать: придают
отвлекать: отвлекающих
меланхоличность: меланхоличность
искоренить: искоренить
независимый: независимые
система: системы
делать: делает делают
облегать: облегает
наличие: наличие
килограммовый: килограммовая
чаемый: чаем
усвоить: усвоить
дисплазия: дисплазию дисплазии
сердце: сердце
интересный: интересной
уверенность: уверенность уверенностью
эпилепсия: эпилепсии
ватный: ватный ватной ватным
хмурый: хмурый
светлана: светланы
джентльмен: джентльмен
повзрослеть: повзрослевшая
далеко: далеко
тянуть: тянуть
прошедшее: прошедшие
отбирать: отбирать
одноклассник: одноклассники
скорее: скорее
проходить: проходя
кровопролитный: кровопролитные
вс: вс
огорчнный: огорчнное
слабый: слабая слабые
волосок: волоски
правда: правда
возможность: возможности
сходство: сходство
приказ: приказы
случайный: случайные
ведт: ведт
мясо: мясо
позволить: позволит позволят
трубчатый: трубчатые
соучастник: соучастником
чувство: чувство
продукция: продукцию
выделяться: выделялся
частый: чаще
подшрсток: подшрсток
профессиональный: профессиональным
накопиться: накопившуюся
лечь: легла
численность: численности
солидный: солидный
бочкообразный: бочкообразную
тазобедренный: тазобедренного
зуб: зубы зубам
вялость: вялость
есть: ест
выговор: выговором
себя: собой
белые: белые
выглядеть: выглядят
учить: учить
уютный: уютным
укорачивать: укорачивают
представительный: представительный
лицо: лице
обременять: обременять
общение: общении
светлый: светлые
марля: марлю марлей
игра: игры
сородич: сородича
потребность: потребность
периодически: периодически
накапливать: накапливать
повод: повод
сократиться: сократилось
разгром: разгром
линька: линьки линька
документация: документацию
жизнь: жизни
делиться: делились
два: двух
занимать: занимать
овчарка: овчарка
они: ними
отмереть: отмершие
едва: едва
скакательный: скакательных
мешать: мешает
уйти: уйти
гласить: гласит
короткошрстный: короткошрстные
давать: давай
двигаться: двигаться
затем: затем
плечо: плечи плеч
оттого: оттого
запах: запах запаха
терпение: терпением
ключик: ключик
празднество: празднеств
переходить: переходит
общительность: общительность
восстановление: восстановление восстановлению
затруднительный: затруднительна затруднительные
игрушка: игрушка
шоу: шоу
поблажка: поблажка
мимимишность: мимимишности
куполый: куполо
аквитанский: аквитанский
процесс: процесс
параметр: параметры
жить: живут
однородный: однородным
лук: лук
бактерия: бактерий
мама: мама
ждать: ждать
любимец: любимца любимец любимцы
помочь: поможет
момент: моменты момент
издать: издана издал
сюда: сюда
слабозаварить: слабозаваренным
уплощить: уплощены
возможно: возможно
ранка: ранок
охота: охотой
возбужднный: возбужднном
корпус: корпус
клык: клыки
повышать: повышайте
живот: живота
травля: травли
сердечно-сосудистый: сердечно-сосудистой
кожа: кожи
упустить: упустить
оснащнный: оснащнные
подгрудок: подгрудка
привести: привести
образовать: образуют
ложбинка: ложбинкой
мистер: мистера
сложно: сложно
складка: складки
уживаться: уживается
крайне: крайне
повозиться: повозиться
область: области
стоить: стоит
это: это
генотип: генотип
воспитанный: воспитанная
садиться: садись
сглаживать: сглаживает
ласка: ласку ласки
произвол: произвол
прибылой: прибылые
ножницеобразный: ножницеобразный ножницеобразным
чужак: чужаку чужака
зависеть: зависит
щенячий: щенячьего
школа: школу
спокойный: спокойном
пара: парой
подчркнут: подчркнуты
женственность: женственность
свойство: свойство
заставлять: заставлять
любить: любят
щедро: щедро
предупредительный: предупредительный
отвесный: отвесные
промышленный: промышленного
хитрость: хитрости
расходиться: расходятся
пыль: пыль
качество: качества
сила: силой силу
трусливый: трусливое
восприниматься: воспринимаются
нелишний: нелишним
сезон: сезон
прочь: прочь
многий: многих
легко: легко
рыжеватый: рыжеватый
ежеминутно: ежеминутно
устроиться: устроившись
манера: манера
том: томах
лента: ленту
тряпка: тряпкой
морис: морисом
щткать: щтки
потенциальный: потенциальная
воспитать: воспитать
любимица: любимицу
захотеть: захотела
дефект: дефектом дефекты
известно: известно
диплом: диплом
письменный: письменный
внушать: внушает
фуа: фуа
ям: ям ямах
отличный: отличные
опрокинуть: опрокинутое
уверить: уверены
чистоплотный: чистоплотного
устать: уставший
воздух: воздухе
раздражительность: раздражительности
визуально: визуально
передаться: передаться
эластичный: эластичные
субпродукт: субпродуктами
продукт: продуктами продукты
подходящий: подходящее подходящим
порадовать: порадует
расправа: расправы
удивляться: удивляйтесь
вакансия: вакансии
гипотеза: гипотезу
стол: стол
прекрасный: прекрасная
сверить: сверьте
бойцовый: бойцовых
доставать: достают
знакомство: знакомство
чужой: чужой
мир: мира
прародитель: прародителем
теряться: теряется
конфликт: конфликт
выше: выше
грудной: грудная
грозный: грозным
аквитание: аквитанию
испанец: испанцев
карим: карим
обострн: обострн
единственный: единственное
удобно: удобно
соединна: соединн
нездоровый: нездоровый
размашистый: размашистые
вместе: вместе
непереносимость: непереносимость
важность: важности
течение: течение
отправиться: отправиться
клеймо: клеймо
любвеобильный: любвеобильным
тесто: тесто
ещ: ещ
баловаться: балуется
коричневый: коричневого
увлекаться: увлекался
поцелуй: поцелуев
средство: средством
большинство: большинство
наряду: наряду
практически: практически
рейтинг: рейтинг
породистый: породистую
проживать: проживали
похвастать: похвастать
скорость: скорости
обернуть: оберните
напоследок: напоследок
красный: красной
мужчина: мужчина
проблема: проблем
знак: знак
кран: крана
длина: длину
независимо: независимо
подписываться: подписывайтесь
непродолжительный: непродолжительной
серьзный: серьзный
прижать: прижаты
комплекс: комплексом
целый: целую
обдумывание: обдумывание
запретить: запрещено
очень: очень
особый: особой
немало: немало
тврдость: тврдость
наиболее: наиболее
покраснение: покраснение
инстинкт: инстинкт
специальный: специальной
кличка: клички кличку
черта: черта
кипячный: кипячной
француз: французов
господин: господин
довольно: довольно
крем: кремом
привычный: привычной
отбросить: отбросить
надбровный: надбровные
обойдться: обойдтся
устранение: устранения
скорый: скором
удаление: удаления
одарить: одарит
составить: составит составленный
суконный: суконной
респираторный: респираторных
группа: группу
одновременно: одновременно
полный: полным
приплюснуть: приплюснута
проект: проекте
сразу: сразу
недопустимо: недопустимо
угол: угол
своеобразный: своеобразный
наследство: наследству
заусеница: заусениц
пора: пор
колли: колли
кг: кг
насколько: насколько
необходимость: необходимости
утренний: утренним
температура: температура
дружба: дружбы
среднее: среднего
фрукт: фруктами
шрсткать: шрстку
туловище: туловище
массивность: массивностью
страна: страна
перепонка: перепонки
низко: низко
тмный: тмные
понежиться: понежиться
приземистость: приземистость
встречаться: встречались встречаются
брид: брид
оскалить: оскалит
отдалнный: отдалнно
важный: важный
кардинальный: кардинальными
люк: люке
стая: стае
ругать: ругайте
становиться: становятся
робость: робость
развить: развитая
плюсна: плюсны
глубина: глубине
вызывать: вызывает
ложка: ложки
подробно: подробно
являться: является
хвост: хвост
рысью: рысью
рогатый: рогатого
жюри: жюри
драться: драться
паста: пасты
гораздо: гораздо
ворчание: ворчанию
типичный: типичные
неопущение: неопущение
склочный: склочные
пет-класс: пет-класса
