уход: уход уходу уходе
гигиенический: гигиеническим гигиеническими
востребованность: востребованности востребованность
отлично: отлично
сам: сами самого само
экономика: экономике
линия: линия
держаться: держится
пёс: пес псами
незначительный: незначительные
рабочий: рабочее рабочих рабочая рабочие
происхождение: происхождение происхождения происхождением
поиск: поиск
шерсть: шерсти шерсть
второй: вторая
направление: направлению
американский: американских американским американские американской американская американскую
овчарка: овчарку овчаркам овчарка овчарки овчарке овчарок
обладать: обладающий обладают
общий: общего
средний: средняя среднее средних средней
упустить: упущенное
положение: положении
скот: скота
необходимость: необходимость необходимости
идеальный: идеальный идеальную
сочетание: сочетания
проблема: проблемы
свободно: свободно
собака: собака собаку собаке собак собаки
чёрный: черный
сколько: сколько
перебраться: перебравшись
вязать: вязали
полотно: полотно
ранний: ранней ранних
развитие: развития
переселенец: переселенцев
рекомендовать: рекомендовали рекомендован
страсть: страсть
размер: размера
непослушный: непослушным
отдых: отдыха
прийтись: пришлось придется
характер: характер
удалить: удалены
название: название
экспонирование: экспонировании
половой: половым
некоторый: некоторые
себя: собой
прошлое: прошлое
аллергия: аллергию аллергией
отапливать: отапливаемой
выводиться: выводившийся
мера: меру мере
англичанин: англичанин англичанина
сочетать: сочетают
система: системе
известный: известны
выразительный: выразительнее
период: период
информация: информация
свой: своих свой свое своим
слегка: слегка
обязанность: обязанность
тот: те
подходить: подходит подходят
урожай: урожай
печатный: печатных
друг: друг друга
помета: помета пометы
физический: физических физическими
специализация: специализациями
обсуждение: обсуждения
явление: явление
террор: террор
отмечаться: отмечаются
сохраниться: сохранилось
год: год лет годов года году
миска: миску
английский: английской английских английским английские английская английскую
старотипный: старотипные
цена: цена цене
фото: фото
окружение: окружения
любой: любую любого
любопытный: любопытны
короткий: короткая
показать: показать
сторож: сторожа
правильный: правильный правильная
дисплазия: дисплазии
пробежка: пробежками
универсальность: универсальность
сделать: сделано
создавать: создавать
авторитет: авторитет
остальной: остальных остальное
природа: природы
ниже: ниже
материал: материалов
активный: активных активной
стадо: стадом
поголовье: поголовья поголовье
колтун: колтуны
животное: животного животные животное животным животных
потребность: потребность
крупный: крупного крупная крупных
окрас: окрас окраса
недуг: недуга
повзрослеть: повзрослевших
яндекс: яндекс
непререкаемый: непререкаемой
расчёска: расческой
ушной: ушное
кормить: кормили
состав: состав
привлечь: привлекла
обожать: обожают
подходящий: подходящий
предок: предков предки
владелец: владельцам владельца владельцев
опустить: опущенный
россия: россии россия
помощник: помощник помощников
линька: линьки линьками линька
три: тремя
передний: передняя передней
жизнь: жизни жизнь
собственный: собственной собственных
классический: классический классические
участие: участие
мелькать: мелькают
кончик: кончик
игра: играми играх
среди: среди
страдать: страдает страдают
предел: пределами
дом: дом дома доме
бретонский: бретонский
племенной: племенной племенных
они: ними
тело: тело теле
череп: череп
больший: большим
социализация: социализации социализация
сравнение: сравнении
глухой: глухими
питомник: питомников питомник питомники
зато: зато
который: которых которого котором которым которые которой
статичный: статичном
подопечный: подопечному подопечные подопечного
продолжительный: продолжительной
угнетать: угнетает
холка: холке
морда: морде мордой морда
подкрепление: подкрепления подкреплением
обратный: обратная
младший: младшее младшего
рост: ростом рост
двор: дворе двор
радужка: радужки
журнал: журнал
приводить: приводить
представитель: представителей представителями представители
норма: нормы
зарядить: заряженный
искать: искать
эпаньоля: эпаньоль
высота: высота
находиться: находится
вычёсывание: вычесыванием
загрязнение: загрязнения
обучение: обучению обучении обучения
квартирный: квартирное
привить: привили
шея: шея
волос: волосом волос
обоняние: обонянием
цвет: цветов цвет
штат: штатов штаты
просто: просто
пройтись: пройтись
лёгкий: легком
разбавлять: разбавлять
сторожевой: сторожевыми
оттенок: оттенком оттенка
мало: мало
подпалый: подпалый
родственный: родственная
страна: стране страна
низкий: низкий
зрение: зрением
нуждаться: нуждаются
флайбола: флайболу
влажный: влажные
мимимишность: мимимишности
пара: паре пара пару
порода: породах породами породе породы порода породой
также: также
истребить: истребить
дать: дан данные
процесс: процесс
этикет: этикета
частый: частые
умный: умная
соболиный: соболиный соболиного
фермерский: фермерскую фермерская фермерской фермерские
первый: первое первым первую
идеал: идеале
небольшой: небольшого
должный: должны должна должен
достаточный: достаточной достаточного
зарубежный: зарубежный
потомство: потомства
обычный: обычной обычным
порядок: порядка
нянька: няньки
шёрстный: шерстный шерстного
североамериканский: североамериканском
поимка: поимке
покров: покров покрова
хозяйство: хозяйства
место: местом
покупка: покупки
лишённый: лишенный
болезнь: болезни
момент: моменты момент
изредка: изредка
интерес: интересами интерес
дискомфорт: дискомфорта
исключение: исключение
сложение: сложением
неизвестный: неизвестное неизвестным
белок: белок
перфекционист: перфекционисты
совместный: совместного
заводчик: заводчиков заводчик заводчика
самостоятельный: самостоятельная самостоятельному
зарегистрировать: зарегистрировали
пастушеский: пастушеский пастушеской
дерево: деревья
отзыв: отзывы отзывах
намокание: намокании
чрезмерно: чрезмерно
человек: людям человек
пастуший: пастушья пастушьими
ребёнок: детей ребенка
интенсивный: интенсивной интенсивных
защитить: защитят защитить
квартира: квартирах
бедный: бедного
большой: большой
необходимый: необходимы необходима
корпус: корпус
добавить: добавьте
чистка: чистка чистки
хороший: лучший хорошее
тёплый: теплое
сильный: сильного
стандарт: стандарт
детский: детских
рыхлый: рыхлым
совет: совет
пахучий: пахучая
включая: включая
нога: ног ноги
отличаться: отличается отличаются
пинчер: пинчер
умеренный: умеренная умеренное
вытеснить: вытеснили
стык: стыке
овальный: овальной
ровный: ровная
дополнительный: дополнительный дополнительных
европейский: европейских европейские
сто: сто
главный: главный главных главная
ферма: фермы фермах
умеренно: умеренно
замечательный: замечательные замечательно
удлинённый: удлиненной
считаться: считаться
исторически: исторически
оставаться: остается
мировой: мирового
пожалуй: пожалуй
история: история
промышленный: промышленные
бордер-колли: бордер-колли
щенок: щенка щенки щенков щенок
лапа: лап
привезти: привезли
добродушие: добродушием
команда: команда
задний: задние
депрессия: депрессию
лакомство: лакомства
дрессировка: дрессировку дрессировка дрессировки
иерархия: иерархии
мыть: моют
терпеть: терпеть
утратить: утратили
пастух: пастухи
процедура: процедурами процедуру
стандартный: стандартный
стоить: стоит
подбирать: подбирать
это: это
пастух-универсал: пастух-универсал
время: время
препарат: препараты
питомец: питомцев питомцы питомец
итог: итог
нос: носы носу
лохматый: лохматой лохматого
сука: суки сук
заинтересовывать: заинтересовывать
поселенец: поселенцам
прямой: прямым прямой
обидиенс: обидиенс
агрессивность: агрессивность
ласка: ласку
кобель: кобели кобелей
фермер: фермерам фермера фермеров
вести: ведет
диплом: дипломы
право: правах
вольерный: вольерное вольерная
условие: условиях условии
характеристика: характеристика
немецкий: немецкий
вариация: вариации
деятельность: деятельности
лайк: лайка
весомый: весомую
сила: силах
хозяин: хозяином хозяина хозяин
сведение: сведению сведений
кролик: кроликов
успех: успеха
ветеринар: ветеринаром
исходить: исходя
физически: физически
дело: дело
около: около
квалификация: квалификаций
купание: купания
смочь: сможет
пахнуть: пахнет
пол: пола
перейти: перейти
якутский: якутская
продажа: продаже
испытание: испытаний
опоссум: опоссумов
например: например
слизистый: слизистых
несколько: несколько
из-за: из-за
имущество: имущества
умственный: умственных
тяга: тяга
широкий: широкими
поведение: поведение
значит: значит
ежедневный: ежедневным
сельхозпродукция: сельхозпродукции
приемлемый: приемлемы
облаять: облаять
решение: решений
обладатель: обладатель
качество: качества
учитываться: учитывается
работать: работает работающей работать
прохождение: прохождение
почистить: почистить
менее: менее
арсенал: арсенал
курчавый: курчавый
свободный: свободных
шотландский: шотландские шотландских
усилить: усилить
раз: раза
помимо: помимо
континент: континенте
соответственно: соответственно
реклама: реклама
использоваться: использоваться
легко: легко
репутация: репутация
признать: признана признает
обязать: обязаны
превратить: превратить
спорт: спортом спорт
терять: теряет
тест: теста
база: базой
лента: ленту
лосьон: лосьоном
производитель: производителей
источник: источниках
полностью: полностью
здоровье: здоровье здоровья
непопулярный: непопулярны
изогнутый: изогнутая изогнуты
остро: остро
счищать: счищают
кангала: кангал
клетка: клетка
по-прежнему: по-прежнему
продавец: продавец
переживать: переживает переживать
родословный: родословные
домашний: домашних
выраженный: выраженным
специальный: специальным
интенсивно: интенсивно
новый: новый новой новое
эффектный: эффектные
определённый: определенном
отсутствие: отсутствие
специалист: специалист
слишком: слишком
невероятно: невероятно
ступить: ступивший
одиночество: одиночеству
фауна: фауны
мочка: мочки мочка
рекомендоваться: рекомендуется
европа: европе
получиться: получится получиться
точный: точных
воспитание: воспитание воспитанием
украшать: украшающий
такой: таких такие такого
внутрь: внутрь
наверстать: наверстать
шуба: шубе
требоваться: требуется
реализовать: реализует
вольер: вольеру вольер
отличный: отличные
век: веков
работа: работы работе работой
клуб: клубом
потомок: потомков потомки
месяц: месяцев
график: график
влиять: влияют
дорогой: дороже
список: списком
содержание: содержание содержания
ген: гены
день: день
наполнить: наполненной
веранда: веранде
мелкий: мелких
габарит: габаритов
белый: белый
усиленно: усиленно
сайт: сайту
сухой: сухие
приносить: приносит
спина: спины спина
хвост: хвосте хвоста хвост
гигиена: гигиена
непривычный: непривычны
настоящий: настоящие
нагружать: нагружать
особенность: особенностей
вероятность: вероятностью вероятность
цыплёнок: цыплят
фермерство: фермерство
возрастной: возрастных
типичный: типичны
жильё: жилье
вакансия: вакансии
характеризоваться: характеризуется
полезно: полезно
привыкать: привыкает
семейный: семейные
постройка: постройка
вовремя: вовремя
мускулистый: мускулистая
изжить: изжили
скрываться: скрывается
книзу: книзу
ноздря: ноздрями
быть: будут
отпор: отпор
оценка: оценке
полоса: полосы
лишь: лишь
что-то: что-то
уничтожать: уничтожавших
подарить: подаривших
трата: тратам
поле: полях
экстерьер: экстерьер
поколение: поколение
встречаться: встречается
сосредоточить: сосредоточено
постоянно: постоянно
форум: форум форуме
бонус: бонус
территория: территорию
связь: связь
хрящ: хрящи
сваливаться: сваливается
разведение: разведения
дальнейший: дальнейшем
ставка: ставка
огородить: огороженный
выделение: выделений
разрушительный: разрушительное
обустроить: обустроить
таковой: таковой
грудной: грудная
правило: правило правила
маленький: меньше
выражаться: выражается
жёсткий: жесткую
четвероногий: четвероногий четвероногого
карим: карим
образовать: образуя
ветер: ветра
зубной: зубной
диморфизм: диморфизмом
разумеется: разумеется
вместе: вместе
неделя: недель неделю
жизненно: жизненно
налёт: налет
скоро: скоро
столетие: столетия
приучение: приучение
запретить: запрещены запрещено
основный: основное
пока: пока
позиционироваться: позиционировалась
коричневый: коричневого
выгул: выгулов
глубокий: глубокая
корм: корма
старый: старой
профессиональный: профессиональных
состояние: состоянии состояния
энергия: энергией
обнимашка: обнимашек
растянуто: растянуто
выставка: выставке
один: одна одного
описание: описание
природный: природная
породный: породных породные
переучить: переучить
упражнение: упражнениями
неспециалист: неспециалист
ставить: ставят
стоимость: стоимость
рейтинг: рейтинг
выясниться: выяснилось
чувствительный: чувствительным
начало: начало
приобрести: приобрести
послушание: послушанием
коренастый: коренастее коренастым
тревожный: тревожным
дважды: дважды
жила: жилы
особенно: особенно
развитой: развит
длина: длину длины
подписываться: подписывайтесь
серьёзный: серьезный серьезным
покинуть: покинувшего
песочница: песочницу
богатый: богаче
середина: середине
рука: рука
чемпион: чемпион
универсальный: универсальных универсальная
заниматься: заниматься занимающихся
собачий: собачьих
самостоятельно: самостоятельно
длинный: длинный
однако: однако
принятие: принятию
достаточно: достаточно
конечность: конечность конечности
использовать: использовать
ранчо: ранчо
незнакомый: незнакомое
обязательно: обязательно
кинолог: кинологом
сужаться: сужающейся
топ: топе
экспресс-линька: экспресс-линьки
двухцветной: двухцветные
обитать: обитает
становиться: становится
затягиваться: затягивается
промежуток: промежутках
узкоспециализированный: узкоспециализированные
очень: очень
особь: особей особи
поэтому: поэтому
живность: живность
стена: стенами
забегать: забегал
интересовать: интересует
смотреть: см
прикусить: прикусить
копирование: копирование
редко: редко
еда: едой
возраст: возраста
нагрузка: нагрузки нагрузках
способность: способности
методичный: методичный
фотография: фотографии
активность: активность активности
второе: второе
федерация: федерации
заслужить: заслужить
зоомагазин: зоомагазина
гиперактивный: гиперактивным
дружелюбность: дружелюбность
современный: современные
незнакомец: незнакомцам
смотреться: смотрятся
инстинкт: инстинкт
проводиться: проводятся
разуметься: разумеющееся
избежать: избежать
плавно: плавно
кличка: клички
умеренный-подозрительный: умеренно-подозрителен
форма: формы
довольно: довольно
борьба: борьбу
последний: последнего
соединить: соединенные
несмотря: несмотря
исключительный: исключительных
высокий: высокая
обитатель: обитателя
купить: купить
величина: величиной
часто: часто
кошка: кошки
коттедж: коттеджа
играть: играло
ресурс: ресурс
глаз: глаза
расходовать: расходовать
ненавязчивый: ненавязчиво
переработка: переработки
самый: самый самые
исчезнуть: исчезла
окрасить: окрашена
шум: шум
передвигаться: передвигаться
постав: поставом
пожилой: пожилых
часть: части
лидер: лидера
проект: проекте
свозить: свозить
число: числе
сквозняк: сквозняков
составить: составленный
зуб: зубов
загнутый: загнутый
распоясаться: распоясавшемуся
грань: гранью
голова: голова
партнёр: партнера партнер
просторный: просторный
случай: случаях случай
колли: колли
салон: салон
кг: кг
аджилить: аджилити
смена: смену смены
трехцветной: трехцветные
недостаток: недостатки
актуально: актуально
хозяйка: хозяйкой
краткий: краткая
делаться: делалась
назад: назад
святой: святая
полустоячий: полустоячем
среднее: среднего
ухо: уши ушей
отставать: отстающий
оставить: оставив
отношение: отношение
кость: кости
сеть: сети
рацион: рацион
тормозить: тормозить
мочь: могут можете
присмотреть: присмотреть
оказаться: оказались
делать: делает
эксперт: экспертов
физраствор: физраствором
регистрировать: регистрирующий
трудоголик: трудоголика
фактурный: фактурно
округлый: округлый
покусывание: покусывании
тепло: теплом
другой: другими
сарай: сарае
благополучие: благополучие
важный: важный
малыш: малышами
доверить: доверить
вконтакте: вконтакте
постоянный: постоянной
свет: свет
злоумышленник: злоумышленников
сустав: суставов
целое: целом
объявление: объявления
уверенность: уверенность
определить: определит
частное: частного
вечный: вечную
причём: причем
перепутать: перепутает
основной: основные
создать: создать
взбираться: взбираться
любимец: любимцев
тазобедренный: тазобедренных
разновидность: разновидности
интеллект: интеллект
охранный: охранные
кверху: кверху
четверолапый: четверолапый
роль: роль
далеко: далеко
открывать: открывать
средство: средств
вес: вес
уважение: уважение
одноклассник: одноклассники
внушительный: внушительным
энергичный: энергичный
именитость: именитость
кормление: кормление
питание: питания
конец: конец
узкий: узкими
выведение: выведении
линять: линяют
твёрдый: твердая
аллергик: аллергикам
сша: сша
противопоказанный: противопоказана
плотный: плотнее
позитивный: позитивные позитивным
результат: результаты
выбор: выборе
готовиться: готовиться
вопрос: вопросах
выбрать: выбрать
причина: причине
уметь: умеющая
любознательный: любознательный
именно: именно
рогатый: рогатого
пыль: пыли
свисать: свисает
приучать: приучают
случайный: случайные
гораздо: гораздо
движение: движении
невозможность: невозможность
жить: живущих
основать: основана
соплеменник: соплеменников
хотя: хотя
злоупотреблять: злоупотреблять
лекарственный: лекарственные
продолжительность: продолжительность
старание: старании
волнистый: волнистый
впадать: впадая
процент: процент
х: х
кот: коту
реальный: реальный
диван: диване
осмотр: осмотр
внутренний: внутренний
