радость: радостью
туалет: туалет
просторный: просторная
процесс: процессе
ребёнок: ребенок дети
завозиться: завозилась
тело: тела
наблюдение: наблюдениям
шампунь: шампуней
средний: средняя среднее средний
масштабный: масштабному
фу: фу
натаска: натаской натаска
глава: главы
агрессия: агрессия агрессии
пищеварение: пищеварения
активный: активные активное
профессиональный: профессиональном
участвовать: участвовать
чёрный: черный
красный: красный
сколько: сколько
ветеринарный: ветеринарного ветеринарных
подавать: подающих
американский: американскому американский американские американского
душа: души
название: название названия названии
протиснуться: протиснуться
собака: собаку собаками собак собака собакам собаке собаки
примерно: примерно
интенсивность: интенсивности
обсуждение: обсуждения
сочленение: сочленений
английский: английских английским английскому английскими английский английские английского
цена: цена цену
сказать: скажите
непродуктивный: непродуктивно
скопиться: скопившихся
любимый: любимых
выстрел: выстрелы выстрелам выстрел
запах: запахом запаху запах
материал: материалов
природа: природы
удовольствие: удовольствием
кокер: кокер кокерам кокера кокеров кокеру
неутомимый: неутомимый
вещь: вещи
натаскивать: натаскивать натаскивают
бекас: бекаса
туманный: туманного
владелец: владельцам владельцев владельцу владельцы
кабинет: кабинета
дословно: дословно
любовь: любовь
здравие: здравии
сторона: стороны
заинтересовать: заинтересовать
дисквалифицировать: дисквалифицирующие
инстинкт: инстинкты инстинктом
игра: игру играх игры
больший: большим большая большие
толстый: толстое
семейство: семейства
субпродукт: субпродукты
побегать: побегать
всмятку: всмятку
зато: зато
россия: россия россию
неугомонный: неугомонный
обратный: обратная
размеренность: размеренность
великобритания: великобритании великобритания
начинать: начинают начинать начинает начиная начинайте
серный: серные
радужка: радужки
представитель: представителей представителями
ежечасно: ежечасно
компаньон: компаньонов
живчик: живчики
команда: команду командам команды команда
шея: шея шеей
волос: волосом волоса
сводить: сводить
лосьон: лосьона
пачкаться: пачкаться
ходимвсе: ходимвсе
шерсть: шерсть шерсти шерстью
нагружать: нагружая
низкий: низкий
исключительный: исключительное
документ: документы документа
водоплавающий: водоплавающей водоплавающими
аденокарцинома: аденокарцинома
вводить: вводить
специально: специально
одиночество: одиночества одиночеству
коровий: коровий
кальций: кальция
выразить: выражены
запретить: запрещена запрещенные запрещено
привыкать: привыкают
челюсть: челюсти
заводчик: заводчиками заводчиков заводчика заводчики
сохранять: сохраняющих
должный: должны должен должна
самый: самая самый самых самые
воспитание: воспитания воспитание
потомство: потомства потомство
тип: тип типом типы
скелет: скелета
говядина: говядина
добрый: добром добрые
фрисби-диск: фрисби-диск
начать: начнет начали начнете
преследователь: преследователи
проход: проходе
сегодняшний: сегодняшних
сохранение: сохранения
снимать: снимает
питомец: питомцами питомцев питомец питомца
крыло: крыло
большой: большой
иметься: имеется имеются имеющегося
столь: столь
разносить: разносящий
учитывать: учитывайте учитывая
отличаться: отличается
утолстить: утолщенная
обои: обои
боровой: боровой
й: й
кардинальный: кардинальной
опоздание: опозданием
птичий: птичье
англичанин: англичанину англичанин англичан англичане англичанам англичанина
важно: важно
фоксхаунд: фоксхаунд
меланома: меланома
главный: главный главная
превышать: превышал
лидерский: лидерских
подружейный: подружейная
история: история
щенок: щенка щенков щенки щенок щенку щенкам
растительный: растительным
круг: круги
отвлекать: отвлекать
помешать: помешает
слышать: слышала
поле: полю
причислить: причислили
проявлять: проявляет
каждый: каждого каждый каждая
форма: форма форме формой
голова: голове головы голова
чувствовать: чувствуют
базовый: базовых базовым
живот: животы животе
даваться: дается
регулярный: регулярным регулярном регулярные
болотный: болотной болотную болотные
проделать: проделать
характеристика: характеристика
поблизости: поблизости
выставка: выставках выставки
летать: летают
обитатель: обитатель обитателей
руб: руб
усталость: усталость
помощь: помощью помощи
эмоция: эмоции
подсказка: подсказки
зарождение: зарождения
снять: сняты
гармоничный: гармоничное
купание: купания купание
ожирение: ожирение
публика: публику
кокер-спаниель: кокер-спаниелей кокер-спаниеля кокер-спаниели кокер-спаниелям кокер-спаниелями кокер-спаниелем кокер-спаниель
отточить: отточить
чудесный: чудесному
инициатива: инициативу
повод: поводу поводов повод
состоятельность: состоятельность
тяга: тяга
выстригание: выстриганию
отнюдь: отнюдь
цыплёнок: цыплятами
возможный: возможных возможны
систематически: систематически
быстро: быстро
птичка: птичками
квадратный: квадратная
игровой: игровой
основное: основном
еда: еду еда
подрасти: подрастут
вест-хайленд-уайт-терьер: вест-хайленд-уайт-терьер
видео: видео
помимо: помимо
выщипывание: выщипывание выщипыванием
звонко: звонко
дать: дала данная
презирать: презирающий
психический: психическое психического
внимание: внимания внимание
меню: меню
очередь: очередь
полностью: полностью
незапамятный: незапамятных
распасться: распался
июль: июля
молодой: молодого
месячный: месячного
улица: улицу
компания: компании
родственник: родственникам родственники родственником
макароны: макароны
каша: кашами
способный: способно
расстояние: расстояние
незнакомец: незнакомцами незнакомцев
такой: таких такая такого
древний: древних
лохматый: лохматого
рисовый: рисовой
выводка: выводок
привычка: привычка
ваш: вашу вашим ваш ваших ваша
полевой: полевых полевой полевыми
речь: речь
запрос: запросе
содержание: содержание содержания
триколорный: триколорные
опытный: опытного опытные
собственный: собственного собственным собственные собственной собственную собственное
моноокрас: моноокрасом
работа: работе
килограмм: килограмм
исполниться: исполнилось
приучать: приучать
замечательный: замечательно
проморозить: промороженными
ширина: ширину
слово: слово словом
резвый: резвых
заядлый: заядлый
типичный: типичны типичные
рекомендовать: рекомендуют рекомендует
родительский: родительские
жить: живет
реагировать: реагировать
массивный: массивный массивными массивные
поступление: поступление
утверждать: утверждают
ноздря: ноздрями
окрас: окраса окрас окрасов
гулять: гуляющих
давать: дает дают
схватить: схватить
воздух: воздуха
объект: объект
выработать: выработать
занимать: занимают
американец: американцев
кстати: кстати
связь: связь
непонимание: непонимания
освоение: освоение
точно: точно
исключать: исключающим
приближение: приближения
покрыть: покрыты
квалификация: квалификацию
смотреть: смотрящий см смотрите
рукихвост: рукихвост
автоматизм: автоматизма
понимание: понимание
вода: воде вода
предпоследний: предпоследнюю
поселить: поселив
внешность: внешность
подурачиться: подурачиться
добавить: добавить добавьте
естественный: естественная
отмечать: отмечает
характерный: характерного
минимум: минимуму
фон: фоне
здравствуйтесрочный: здравствуйтесрочно
снижение: снижения
грумера: грумера
морда: морду морда
любопытный: любопытных любопытный
развиваться: развивается
собачий: собачьего собачий собачьем
яйцо: яйца
бесцельно: бесцельно
пучок: пучок
перхоть: перхоть
дважды: дважды
структура: структуру
мир: мир
обувь: обувь
частенько: частенько
признание: признания
предмет: предметы предмета предметов
имитация: имитацию
мебель: мебель
плотно: плотно
снижать: снижает
ежедневный: ежедневном ежедневный
качество: качестве качества
отдыхать: отдыхают
способность: способности
фотография: фотографии
обзаводиться: обзаводитесь
потешно: потешно
развлечение: развлечений
кисломолочный: кисломолочной
невзирая: невзирая
буржуйский: буржуйских
работать: работать работающий работала
хороший: хорошие хороши
уход: уходе ухода уход
голубой: голубой
евгений: евгений
противник: противники
результат: результат результате
ряд: ряде
высокий: высокая
страдать: страдают
примагничивать: примагничивающих
питомник: питомники
лишать: лишают
сухофрукты: сухофрукты
глаз: глаза глаз глазах
ненавязчивый: ненавязчиво
прийтись: придется
птичь: птичью
авторитарный: авторитарный
позиция: позицию позиции
поддержать: поддержит
бечёвка: бечевку
повышенный: повышенного
шоколадный: шоколадный шоколадной
вкусняшка: вкусняшками вкусняшки
аттестат: аттестат
быт: быту
разделиться: разделились
лига: лигу
чёткий: четкое
век: века веке век
желтоватый: желтоватого
вести: вести
упругий: упругими упругий
наследовать: наследует
год: года лет год
продукция: продукцией продукция
буквально: буквально
желаемый: желаемое
стриппинг: стриппинг
поскольку: поскольку
охотничий: охотничьи охотничьих охотничьим охотничья
отработать: отработаны
разыгрывать: разыгрывать
краткий: краткая
весьма: весьма
гепатит: гепатит
врождённый: врожденная
свой: своими своему свои
отношение: отношение отношению
кухня: кухне
тусовщик: тусовщик
место: место месте
масса: массы масса
клумба: клумбах
малыш: малышей малыша
ступень: ступень
пищевой: пищевая пищевой
исключительно: исключительно
пятый: пятой
эксперт: экспертов
песчаный: песчаных
ранний: раннего раньше
пляж: пляж
домушник: домушника
факт: факт
слабый: слабым
обстоятельство: обстоятельствам
вконтакте: вконтакте
просмотр: просмотр просмотров просмотра
рядом: рядом
натаскивание: натаскиванию натаскивания
домочадец: домочадцам
физический: физическими физическая
лёгкий: легче
палка: палку
сплошной: сплошные
экономить: экономить
трофей: трофеи
ярко: ярко
выдержка: выдержки выдержку
роль: роль
хозяин: хозяин хозяином хозяину хозяина
обойтись: обойдутся
туловище: туловища туловище
ухудшить: ухудшит
транспорт: транспорта
животное: животных животным животного животные животное
соус: соус
задаваться: задаетесь
гурман: гурманы
сыр: сыром
счастливый: счастлив счастливые
адекватно: адекватно
характер: характером характер
перекрывать: перекрывающих
регламентироваться: регламентировался
ребята: ребята
выбрать: выбрать
паразит: паразитами
мнение: мнения мнение
общество: общества
желание: желании
птица: птица птицы птицей
изделие: изделия
счёт: счет
бабочка: бабочками
атопий: атопия
основать: основана
сустав: сустава суставов
шёрстный: шерстного
хотя: хотя
позволить: позвольте позволить позволят
превращение: превращению
х: х
запрыгнуть: запрыгнуть
теряться: теряются
искать: ищет ищем
надавить: надавить
сам: сами самой самих
перо: перьев
неприятный: неприятных
обладать: обладая обладает
выгуливать: выгуливать
спонж: спонжа
существенно: существенно
отрезок: отрезок
шалун: шалуны
звук: звукам
познакомиться: познакомиться познакомились
нарезать: нарезать
расчёска: расческу
середина: середины
мягкий: мягкую мягкая мягким
мама: мамы мамой
страсть: страсть
приключение: приключений
берег: берегах
тримминговочный: тримминговочным тримминговочные
квартира: квартире квартиру квартиры
размер: размеры размера
выражать: выражать
мера: меру мере
выпуклость: выпуклости
присутствовать: присутствуют
ограничение: ограничения
информация: информация
охотник: охотник охотники охотнику
печеночно-белый: печеночно-белый
расчёсывание: расчесывание
телосложение: телосложение
заразить: заразить
длинноухий: длинноухие
друг: друг друга другу
спаниель: спаниелей спаниеля спаниели спаниель
создание: создание
хотеть: хочет хотите хочу
любой: любую любые любой
чутьё: чутье чутьем
палец: пальцами
вьющийся: вьющаяся
преодолевать: преодолевать
прогулка: прогулку прогулки прогулках прогулок
сначала: сначала
подвергаться: подвергавшиеся
авторитет: авторитет
ниже: ниже
грациозно: грациозно
набивать: набивающих
крепкий: крепкие крепкое крепкой
правильный: правильного
польза: пользу
покидать: покидай
различный: различным различных
дом: дом дома
талант: таланты
кудрявый: кудрявой
подушечка: подушечками
кислый: кислая
официальный: официального официальная
колено: колени
гасить: гасить
открытый: открытое
длинный: длинные длинными длинной
считаться: считается считаются
заболотить: заболоченных
мыть: мыть
потерянный: потерянные
норма: нормы
стянуть: стянуть
распахнуть: распахнутыми
загрязнение: загрязнения загрязнений
плескание: плескания
дезориентировать: дезориентируйте
причинять: причинять
просто: просто
эсквайр: эсквайры
пройтись: пройтись
аллергия: аллергия
мало: мало
старофранцузский: старофранцузское
недостаточный: недостаточного
иванов: иванов
вальяжность: вальяжность
принудить: принудить
утёнок: утята
частый: частые чаще почаще
этикет: этикета
вид: видом виде вид видах
водить: водить
клиппервек: клиппервек
подпалина: подпалинами
собираться: собираетесь
знакомить: знакомить
дополнить: дополнить
находить: находить находит
разумный: разумными
час: часа
рыжий: рыжий
дископатия: дископатия
который: которое которой которая которым которые который
территория: территории территориях
считать: считают
парикмахерский: парикмахерские
мел: мел
пропорциональный: пропорциональная
подбросить: подбросите
определённый: определенное
чистка: чистка
умеренный: умеренная
происхождение: происхождения
зуб: зубьями зубов
заболевание: заболевания
лапка: лапки
игривый: игривых игривые
необходимо: необходимо
ловко: ловко
воспользоваться: воспользовавшись
перенести: перенесена
выявить: выявлены
феноменальный: феноменальным
приучивать: приучивать
встречать: встречают
редкий: реже пореже
гидроцефалия: гидроцефалия
отъявленный: отъявленные
лежание: лежанию
кобель: кобеля кобели
дрю: дрю
омлет: омлета
дрессировка: дрессировка дрессировки
время: время времен времени временем
пятнистый: пятнистые
сука: суки
создать: созданный
вальдшнеп: вальдшнепов вальдшнеп
приём: приемы
плохой: хуже плохой
агрессивность: агрессивность
ушной: ушной ушного ушном
заплата: заплаты
чрезмерный: чрезмерное чрезмерная
день: дней день дни
погода: погоду
деятельность: деятельности
урок: уроки
противный: противном
кость: костей кости
что-либо: чему-либо
другой: другие других
потерять: потеряет
традиционно: традиционно
тактика: тактики
взрослый: взрослого взрослые
грумерский: грумерские
использовать: используйте использовать
уступать: уступает
терпение: терпения терпение
волна: волна волной
променад: променадов
закрадываться: закрадывается
отдельный: отдельные
алина: алина
неуверенность: неуверенности
например: например
несколько: несколько нескольких
привязать: привязать
деликатес: деликатесами
называть: называемые
родина: родиной родине
рост: рост
ответ: ответа ответов ответ
метрика: метрикой
подобный: подобными подобные
куцый: куцым
к: ко
реклама: реклама
проказник: проказник
найти: найдут
полотно: полотна
ложиться: ложится
сместить: сместив
полагаться: полагается
конъюнктивит: конъюнктивит
окд: окд
дистихиаз: дистихиаз
процедура: процедуру процедура
стихийный: стихийному
рекомендоваться: рекомендуется
болезнь: болезнь болезни
мочка: мочки мочка
спокойно: спокойно
получиться: получится
скрещивание: скрещиванию
филд-спаниель: филд-спаниели филд-спаниелей
внутрь: внутрь
наверстать: наверстать
авто: авто
один: одно одну
закрепиться: закрепиться
пёсик: песики
дичь: дичи дичь дичью
правильно: правильно
воспитанный: воспитанные
жаловать: жалуют
бережно: бережно
метис: метисы
сайт: сайту
задний: задних заднем
свободный: свободного свободными
бывать: бывает
родословная: родословной
глист: глистами
следствие: следствие
занять: занять
картофель: картофель
схема: схеме
пища: пищей
быть: будут
этот: эта
лишь: лишь
пытаться: пытается
вариант: вариант вариантом
стрижка: стрижка стрижки
поймать: поймать
выводить: выводить
заворотвыворот: заворотвыворот
решаться: решается
форум: форум форуме
расчёт: расчета
натаскать: натаскать
стоп: стопом
конец: конце конец концов
резинка: резинкой
истеричный: истеричное
требовать: требуют
боль: боль
перегнуть: перегнуть
тяжело: тяжело
наш: нашей
рельефный: рельефным
манипуляция: манипуляции
внешне: внешне
скоро: скоро
обработка: обработки
здравствуйтеу: здравствуйтеу
ситуация: ситуацией
стресс: стресс
эпоха: эпоху
этап: этапе
выводиться: выводилась
уступка: уступка
значительно: значительно
морской: морской
описание: описание
упражнение: упражнениями
начало: начало
добыча: добычу добычи добычей
стандарт: стандартом
соревнование: соревнований
испанский: испанская
загородный: загородных
оттенок: оттенки оттенка
посадить: посаженные
попугай: попугаями
подчиняться: подчиняться
психолог: психологи
амбре: амбре
запретительный: запретительную
серьёзный: серьезный
округлый: округлые
второй: вторую
пропажа: пропажу
карий: карего
комнатный: комнатным
гребень: гребень
однако: однако
коллектив: коллектив
искренне: искренне
речной: речной
имидж: имиджа
обитать: обитает обитавших
играть: играть играют играет
смотреться: смотрится
поэтому: поэтому
предлагать: предлагают предлагайте
случай: случаев случае
копирование: копирование
нужда: нужду
короткий: короткий короткие короткой
активность: активность активности
подверженный: подвержены
существовать: существует
пуходерк: пуходерку
основание: основания
равнодушие: равнодушие
продукт: продукта продукты
дружелюбность: дружелюбность
провислость: провислость
уважение: уважении
одноцветный: одноцветные
сквозняк: сквозняк
плавно: плавно
спортивный: спортивных
отзыв: отзывах отзывы
укорачивать: укорачивая
переходить: переходить
нога: ноги ногах
сужаться: сужающаяся
настоящий: настоящая настоящие
кошка: кошки кошек
белоусов: белоусова
способ: способ способы
нереально: нереально
выделение: выделения
отсутствие: отсутствии отсутствие
животный: животному
оценка: оценки оценке
шум: шум шуму
расслоение: расслоению
натуральный: натуральное
очки: очки
бурный: бурного
поиск: поиску поиск поиска
ванная: ванной
висячий: висячие висячий
пристрастие: пристрастия
стимулировать: стимулирующих
особь: особи особям особей
докатиться: докатиться
наблюдать: наблюдать
уровень: уровня
пах: паха
прямой: прямая прямые
вкусовой: вкусовые
экскаватор: экскаватора
допустимый: допустимо
окно: окно
аксессуар: аксессуар
планировать: планирующим
назад: назад
опериться: оперятся
пожалуйста: пожалуйста
запрет: запреты
почему: почему
апгрейд: апгрейду
ужин: ужин
припадок: припадкам
отдать: отдам
интерес: интерес
мочь: могут
специальный: специального
соблазн: соблазном
порода: породы пород порода
приобрести: приобретете приобрести
кузен: кузену
смена: смены
крупный: крупнее крупные
депигментировать: депигментированные
ухо: ушей уши
ножницы: ножницами ножницы
целое: целом
прививать: прививать
объявление: объявления
несостоятельность: несостоятельности
белый: белым
сложный: сложный сложнее
основной: основные
лужа: луже
хлебобулочный: хлебобулочные
тёртый: тертый
диплом: дипломами дипломы диплом
мячик: мячик
какой: каким
интеллект: интеллект интеллектом
охранный: охранные
многие: многие
конечность: конечностей конечности
культура: культуры
вес: вес
спина: спину спины спина
гречневый: гречневой
степень: степени
мина: мина
пернатый: пернатой пернатую
тренировать: тренируйте
попытаться: попытается
обличие: обличье
ритуал: ритуал
чемпион: чемпионов
голос: голос
произойти: произошли
нос: носа носом нос
рада: рады
разведение: разведение
намеренно: намеренно
блендинга: блендинг
именно: именно
серьёзно: серьезно
ореховый: ореховые
чуждый: чужды
конкурировать: конкурировать
перианальный: перианальная
отклонение: отклонения
писать: писает
попытка: попытках
продолжительность: продолжительность
ангельский: ангельского
диван: диване
привыкание: привыкания
горка: горках
заправить: заправленной
привыкнуть: привыкнет привыкшие
пёс: пес
горло: горле
вряд: вряд
прятать: прячут
кишечный: кишечными
бобовый: бобовые
подвергнуться: подверглись
командный: командных
британский: британские
зависимость: зависимости
вещество: веществ
повседневный: повседневном
обыватель: обывателей
учиться: учиться
принимать: принимать
обязанность: обязанность
тот: те та той
здравствуйте: здравствуйте
сокращать: сокращают сокращает
закармливать: закармливайте
вестись: ведитесь
фото: фото
сталкиваться: сталкивался
понюхать: понюхать
м: м
прирождённый: прирожденные
жаловаться: жалуются
розовый: розовая розовые
будущий: будущий будущему
яндекс: яндекс
дефект: дефект дефекты дефектами
обожать: обожают
обед: обед
избегать: избегайте избегать
нюх: нюхом
покупаться: покупается
режим: режим
участие: участие
остальной: остальным
нестись: несется
путешествие: путешествиям
череп: череп
жевать: жевать
социализация: социализации
техника: техника техник
лапа: лапы
фрисби: фрисби
холка: холке
смочь: смогли
вредный: вреден
относить: относят
дружелюбный: дружелюбным дружелюбного дружелюбный
склонный: склонно
обязательный: обязательных обязательны обязательной
журнал: журнал
программа: программой
психотропный: психотропных
высота: высота
укатить: укатить
томатный: томатный
месяц: месяца месяцев
стиль: стиль
гонять: гонять
делать: делать делает
тд: тд
страна: стране стран страна
постав: постав
стараться: старались
выдержать: выдержанных
изуродовать: изуродованную
песочек: песочке
первый: первое первый первую первых
голодный: голодного
кокеры: кокеры
золотистый: золотистый
неопытный: неопытные
кормление: кормлением кормление
наркотик: наркотиков
отыскивать: отыскивать
чрезмерно: чрезмерно
запросто: запросто
контролировать: контролировать
метод: метода
вынести: вынести
либо: либо
поиграть: поиграть
ценный: ценные
тёплый: теплое
минута: минут
оптимальный: оптимальной оптимальный оптимальное
сопровождать: сопровождавших
упрямство: упрямство
образ: образом
человек: человека
охота: охоте охота охоты охотой охоту
доказывать: доказывать
бронзовый: бронзового
жест: жест
формирование: формирование
обеспечивать: обеспечивают
радуга: радугу
мясистый: мясистой
проситься: просятся
эмоциональный: эмоциональные
отделение: отделения
дешёвый: дешевле
умолчание: умолчанию
поддаваться: поддавайтесь поддаются
корпус: корпуса корпус
жилистый: жилистая
кто: кому
глухота: глухота
движение: движения движении
подъём: подъема
тушка: тушку
дождаться: дождитесь
подойти: подойти подойдут подойдете
условие: условиях
заметно: заметно
притворщик: притворщика
передвигаться: передвигающимся
компактный: компактного
гладко: гладко
дело: дело дела
немой: нем
заяц: зайца
родиться: род
являться: являются является
перейти: перейти
рвать: рвут
разный: разные
плакинг: плакинг
широкий: широкими
овощ: овощами
коготь: когтей
маленький: маленькие меньше
чёрно-белый: черно-белого черно-белый
менее: менее
развалиться: развалившись
складка: складок
временной: временной
собрат: собратьями
надежда: надежду
знающий: знающие
выставочный: выставочным
мимишный: мимишную
вопрос: вопросе вопросу
вытянутый: вытянутые
оставлять: оставляя
обучать: обучайте
палочка: палочку
во-вторых: во-вторых
рыбка: рыбкой
грудь: груди грудь
отдаление: отдалении
цель: целью
любимец: любимцу любимца
флегматичный: флегматичным
массовик-затейник: массовика-затейника
слишком: слишком
любознательный: любознательные
внести: внесите
никто: никого
умудряться: умудряясь
альбион: альбиона
кой: коем
мордочка: мордочка
нарезка: нарезки
перепел: перепелами
покупка: покупок
гигиена: гигиена
неистощимый: неистощим
субординация: субординацию
выйти: вышедший
участник: участников
взять: возьми
печёночный: печеночный
замашка: замашек
вольер: вольере
колтунорез: колтунорез
выгул: выгулом выгуле выгула
ощущение: ощущения ощущений
покров: покрова
спровоцировать: спровоцировать
рубль: рублей
требование: требованиям требований
автобус: автобус
чистокровный: чистокровной чистокровных
ценить: ценить
чей: чей
укусить: укусят
иерархический: иерархической
правило: правило правила
жёсткий: жесткую
вышагивать: вышагивающему
выдумка: выдумки
испытывать: испытывает испытывают
крылышко: крылышко
варьироваться: варьируется
прикус: прикуса
общение: общение
идти: идет
заходить: заходил
глубокий: глубокая
необычный: необычным
купированна: купированне
иметь: имеет имеющие
промежуток: промежуток
сюсюканье: сюсюканье
стоимость: стоимость
наклонность: наклонностями
искатель: искатель
последний: последнее последнего
рябчик: рябчиков
особенно: особенно
неважно: неважно
новый: новым
плембрак: плембрак
аккуратный: аккуратны
желательно: желательно
иноходь: иноходью
домашний: домашнего
строго: строго
тормозить: тормозят тормозило
доставать: достает
обычный: обычная
машинка: машинкой
длина: длина
достаточно: достаточно
обязательно: обязательно
продолжительный: продолжительном
примыкать: примыкающими
предпочитать: предпочитали
ход: ходе
коротать: коротает
обязать: обязан
отряхнуться: отряхнется
полениться: поленитесь
постигать: постигают
редко: редко
возраст: возраста возрасте
угощать: угощать угощайте
тренировка: тренировки
путёвка: путевку
неделя: неделю
переживать: переживают
истерический: истерическим
груминг: груминге груминг
разрешать: разрешайте
поводок: поводке поводок поводка
точнее: точнее
англия: англии
понимать: понимать
несмотря: несмотря
неплохой: неплохой неплохие
ходить: ходить
купить: купить купила
часто: часто
дупель: дупелями дупелей
подпал: подпалом
летпо: летпо
авторитетный: авторитетными
живой: живое
противоглистный: противоглистное
выступать: выступают
оказаться: оказаться
прижиться: прижились
масло: маслом
маршрутный: маршрутный
овальный: овальные
проходить: проходит
стричь: стригут
вывести: выведенная
что: чему
период: периоды период
предок: предки предков предками
задача: задача
бедный: бедным
слушаться: слушаться
выбирать: выбирать
вызвать: вызвала
накопиться: накопившийся
привлекать: привлекают
накрывать: накрывает
услышать: услышать
дополнительный: дополнительная дополнительными
курс: курсу
недостаток: недостаткам
кто-то: кто-то
отправить: отправить
подношение: подношение
расстройство: расстройство
подставить: подставив
спортсмен: спортсмен
берухо: берушами
недоумевать: недоумевать
агрессивный: агрессивным
нагрузка: нагрузками нагрузка
чистый: чистой
поднимать: поднимать
угол: углы
крупа: круп
сантиметр-друга: сантиметр-другой
нэнси: нэнси
курочка: курочки
племя: племени
вероятность: вероятность
гордость: гордости
флэтвек: флэтвек
навсегда: навсегда
одноклассник: одноклассники
посещать: посещайте
дисплазия: дисплазия
хозяйский: хозяйские
подселять: подселять
скорость: скорость
проблема: проблема
заканчивать: заканчивая
сварить: сваренными
случайный: случайные
сильный: сильной сильным
канарейка: канарейками
чётко: четко
навык: навыки навык
кроме: кроме
мясо: мясо
порядок: порядке
гламурный: гламурному
перчатка: перчатку
разница: разницы
щипка: щипка
выбыть: выбыть
среднее: среднем среднего
малоопытный: малоопытного
чувство: чувство
доминанта: доминанта
нечего: нечего
тащить: тащить
фрукт: фруктам
курчавошерстный: курчавошерстный
эксперимент: экспериментах
получить: получить
взгляд: взгляды
упустить: упущенное
привести: привело
тазобедренный: тазобедренного
вообще: вообще
уживчивый: уживчивы
волосок: волосков
есть: ест
монотонно: монотонно
включать: включает
скакательный: скакательного скакательных
потребоваться: потребуется
себя: собой
белые: белые
стать: станет
комбинировать: комбинировать
отбор: отбора
учить: учить
купировать: купированный
прогиб: прогибом
покопаться: покопаться
прелесть: прелесть
легковесный: легковесными
раскопка: раскопки
заставить: заставить
производиться: производятся
направление: направлении
неизвестный: неизвестном
нормальный: нормального нормальный
спустить: спустите
сделать: сделано
незначительный: незначительными
пассивный: пассивному
потребность: потребность
смесь: смесь
восторг: восторга
порок: пороки
заметить: заметило
средство: средство
расклад: расклада
доказательство: доказательства
жизнь: жизни жизнь
предпочесть: предпочтет
современный: современных
справить: справила
присмотреться: присмотреться
они: ними
ждать: ждите
удивлённый: удивленное
вешалка: вешалкой
зольный: зольных
право: право
отказаться: отказаться
благодаря: благодаря
сопрячь: сопряженные
подопечный: подопечному
небольшой: небольшой
сыщик: сыщиков
рука: рукой
плечо: плечи
чеснок: чеснока
виноградов: виноградова
отвлечь: отвлечет
ожить: оживший
нож: ножа ножом
лечить: лечат
крапчатый: крапчатые
намёк: намека
разговорчивость: разговорчивость
волнистый: волнистая
рассеянность: рассеянностью
пирамида: пирамиде
крайность: крайностей
зрение: зрением
комфортный: комфортнее
шоу: шоу
нужно: нужно
мимимишность: мимимишности
также: также
толчок: толчок
экстерьер: экстерьера
укромный: укромном
умный: умная
русско-европейский: русско-европейская
повторяться: повторяющимися
водоём: водоема
идеальный: идеальным идеальная
превосходный: превосходным
момент: моменты
ретривер: ретривер
сюда: сюда
внутри: внутри
возможно: возможно
человеческий: человеческого
ушастый: ушастых
роан: роан
эталонный: эталонным
дачный: дачном
мария: мария
зов: зов
таня: таня
сквозь: сквозь
двигательный: двигательной
кончик: кончику
резкий: резким
лаять: лаять
вволю: вволю
манипулировать: манипулировать
бочкообразность: бочкообразности
растянутый: растянутый
баранина: баранина
умеренно: умеренно
дискомфорт: дискомфорт
исключение: исключения
отличный: отличных отличным отличные
оставить: оставленный
обжорство: обжорству
средиземноморский: средиземноморское
впоследствии: впоследствии
отварный: отварном
лакомство: лакомства
крипторхизм: крипторхизм
крайне: крайне
область: области
стоить: стоит
это: это
эпилепсия: эпилепсия
преподносить: преподносимые
укоротить: укоротить
провоцировать: провоцируют
лайк: лайка
протестировать: протестировать
разводить: разводить
показатель: показатели
вполне: вполне
портить: портят
обиход: обиходе
страдалец: страдальца
выносить: выносят
равновесие: равновесия
попадание: попадания
окончательный: окончательного
поглощать: поглощать
любить: любят
щётка: щетки
страх: страх
умение: умения
подлежать: подлежит
стол: стола
сидение: сиденье
общий: общему
частный: частных
отит: отит
подлинный: подлиннее
клан: клана
использование: использование
позволять: позволяйте
легко: легко
вымах: вымах
уточнить: уточнить
лента: ленту
удаление: удалением
здоровье: здоровье
обильный: обильная
сочетание: сочетании
включиться: включится
пора: порах
основательно: основательно
приводить: приводя
острый: острым
произвести: произвести
кондитерский: кондитерские
выглядеть: выглядит
естьсоответствовать: естьсоответствующие
приветствовать: приветствую
умелый: умелую
длиться: длиться
во-первых: во-первых
справиться: справится
ркф: ркф
подмешивать: подмешивать
вакансия: вакансии
специалист: специалисты
ошибка: ошибка
настойчиво: настойчиво
маринец-дейнеко: маринец-дейнеко
передний: передних
примерять: примерять
знакомство: знакомство
мочекаменный: мочекаменная
начинаться: начинается
постоянно: постоянно
ветер: ветру
всплеск: всплески
удостовериться: удостоверьтесь
железный: железной
классический: классическим
выше: выше
определение: определение
очёс: очесы
занятие: занятия
палевый: палевый
большинство: большинстве большинство
мускулистый: мускулистой
длительный: длительного
фантастический: фантастическая
порох: пороха
погоняться: погоняться
затылок: затылке
проделка: проделках
сократить: сокращенной
управляться: управляющийся
катаракт: катаракта
рейтинг: рейтинг
спаниелья: спаниельей
подстригать: подстригая
подписываться: подписывайтесь
ленивый: ленивое
искупаться: искупается
менять: меняют
купироваться: купируется
металлический: металлический
самостоятельность: самостоятельности
уйти: уйдет
самостоятельно: самостоятельно
побережье: побережье
соблюдать: соблюдать
хвост: хвоста хвост
источник: источником
превращаться: превращаясь
очень: очень
обычно: обычно
поделать: поделаешь
исполнительность: исполнительность
всевозможный: всевозможные
горбатый: горбатую
семейный: семейным
просить: просящие
лактат: лактата
таблетка: таблетки
пеленкено: пеленкено
ультракороткий: ультракороткая
наоборот: наоборот
постепенно: постепенно
буксир: буксире
кличка: клички
давление: давлением
частность: частности
зубчик: зубчик
отыскать: отыскать
список: список
шустрик: шустрики
безопасный: безопасном
готовиться: готовьтесь
повернуть: повернуты
возможность: возможность
касаться: касается
весело: весело
одновременно: одновременно
изюм: изюм
ласковый: ласковая
проект: проекте
сразу: сразу
житель: жители
темно-карий: темно-карего
надевать: надевать
гурманский: гурманскими
завтрак: завтрак
сводиться: сводится
бодрый: бодрых
кг: кг
необходимость: необходимости
заметный: заметной
блюдо: блюда
темперамент: темперамента
сей: сих
риск: риск
линька: линька
прилегать: прилегающая
ошейник: ошейник
рацион: рацион
шелковистый: шелковистым
низко: низко
стрелок: стрелком
колбасный: колбасная
пройти: пройденный
банный: банные
нервозность: нервозность
важный: важный
наедине: наедине
воровать: воруют
посадка: посадка
этакий: этакие
справляться: справлялись
причём: причем
полноценно: полноценно
стерилизованапрививка: стерилизованапрививки
согнутый: согнутые
поощрительный: поощрительного
плюсна: плюсны
домик: домиках
папа: папы
хвастаться: хвастающегося
родитель: родителей
тетеревиный: тетеревиный
малолюдный: малолюдном
закрепить: закреплено
обеспечиваться: обеспечивается
учёный: ученые
губа: губы
миролюбивый: миролюбивы
первичный: первичные
основный: основных
гораздо: гораздо
г: г
встречаться: встречаются
тетерев: тетерева
брокколи: брокколи
уделить: уделить
подёргать: подергать
воронка: воронке
казаться: казалось
