травма: травм
заметить: заметили заметите заметив
процесс: процессе процесс
обусловить: обусловлено
повод: поводом повод
отличать: отличают отличает
ситуация: ситуациях
использовать: используя используйте использовать
тело: тела
средний: средняя среднее
защита: защиту защита
параллельный: параллельные
опыт: опыт опыта
агрессия: агрессия агрессию
ясный: ясные
активный: активные активным активных активными
классический: классических классические классический
продолжаться: продолжалась продолжается
чёрный: черный черные черная черными
посторонний: посторонних
сколько: сколько
провоцировать: провоцируя
название: название названием названии
наделить: наделена
роль: роли
прошлое: прошлое
примерно: примерно
собака: собаку собакой собак собака собакам собаке собаки
путаться: путаться
четверть: четверти
ноздря: ноздри
физический: физических физическое физические
обсуждение: обсуждения
зависимость: зависимость зависимости
полотенце: полотенца
оставаться: оставаться оставалось
ваш: вашему вашу вашей ваш вашего вашем ваших ваша
оно: оно
цена: цена
зачастую: зачастую
десятилетие: десятилетия
сантиметр: сантиметра
пятый: пятые пятой
подушечка: подушечки подушечками
мастиф: мастифы
материал: материалов
природа: природы природой
подшёрсток: подшерстком подшерсток подшерстка
быть: будучи
питомец: питомце питомцев питомец питомца питомцем
предотвратить: предотвратить
расчёска: расческой
гладить: гладя
обратить: обратите обратят
слабохарактерный: слабохарактерным
широкий: широкого широкий широкая широкое
оберегать: оберегают
качество: качествами качество качества
стоять: стоят
японский: японской японская японский японские японских
категорический: категорический
сторона: стороны
заинтересовать: заинтересовать
допуск: допуском
дисквалифицировать: дисквалифицирующие
обучаться: обучаются
закруглить: закругленные
пятно: пятнами пятна пятно
потенциально: потенциально
город: городах
холка: холку холке
зато: зато
россия: россия россии
живот: живот живота
морда: морде морды морда
обратный: обратная
наш: нашему
синдром: синдромом
размер: размеров размеры размером размера
поведение: поведении поведение
воздержаться: воздержаться
представитель: представителей представителя представителем представитель представителями представители
контроль: контролем
команда: команду команде команд команды команда
воспринять: воспринять
охранный: охранных охранные
игрушка: игрушкой
шея: шея шеи
волос: волосом
пример: пример
пагля: пагль
овчарка: овчарки
шерсть: шерсть шерсти шерстью
избыток: избытка
победитель: победитель победителями
авторитетный: авторитетен
серений: серению
специально: специально
лицо: лицах
влажный: влажные
один: одним одного одной одних одном одну
насыщенный: насыщенными
загнутый: загнут
метод: метод
должный: должны должен должно должна должном
самый: самая самое самых
воспитание: воспитания воспитание воспитании воспитанием
проверять: проверяя
небольшой: небольшого небольшими
тип: тип типа
главный: главной главным главная
оправиться: оправиться
взгляд: взгляд взгляде
посадить: посажен посаженные
ослабить: ослабил
здоровый: здоровом здоровыми здорового
начать: начнет
человек: людям людей человеку человек человеком
обстоятельство: обстоятельство
американский: американской американскую американским американские американская американскими
относиться: относится
месяц: месяц месяцев
большой: большой большое
иметься: имеется
сверху: сверху
общение: общения
некоторый: некоторых некоторые
назвать: назвать
спустя: спустя
равно: равно
погоня: погоне
элемент: элементами
победительница: победительницу
плечо: плечам плечи
включая: включая
отличаться: отличается отличаются отличаться
выраженный: выражен выраженными выраженные
дежурить: дежурить
верный: верный верным
важно: важно
упругий: упругие упругими упругая
держать: держите держать
превратиться: превратится превратиться
повиноваться: повиноваться
история: история истории
брать: брать берите
созревание: созревания
щенок: щенка щенков щенки щенок
вывод: вывод
пространство: пространстве
нанести: нанесенного нанесет
раздражитель: раздражители
проявлять: проявляет проявляют
круглый: круглой круглые
интересный: интересными
рутина: рутина
тяжёлый: тяжелую
взрослый: взрослый взрослой взрослые взрослых
форма: форма формы
особый: особое
юный: юного
голова: голове головы голову голова
семья: семьи
половой: полового
нередко: нередко
выпуклый: выпуклые
характеристика: характеристика характеристики
стоп: стоп
выставка: выставках выставок выставке
получить: получивший получила
такой: таком таких такое такие такая такого таким такими
руб: руб
чужой: чужих
возможность: возможностями возможности
нос: носу носа нос
заводчик: заводчик заводчиков заводчики
около: около
треть: треть
зарождение: зарождения
лгкий: лгкой лгкий
акита-ин: акита-ину
война: войны войне война
камень: камня
придавить: придавите
походка: походки
свидетельствовать: свидетельствовать
заворот: заворот заворотом
пытаться: пытались пытаться
порода: породе породы пород породами порода породой
миссия: миссии
стать: стала стали станете ставших стать станет ставшие
синий: синий
обладать: обладать обладают обладает
появление: появление
вывернуть: вывернуты вывернутые вывернутыми
маска: маска маской маски
палец: пальцы палец
возможный: возможных возможные возможное возможную
считать: считает
пёс: псу псов пес
быстро: быстро
предпринять: предприняли
чистый: чистых чистые
территория: территория территорию территории
делать: делаем делать делали
вест-хайленд-уайт-терьер: вест-хайленд-уайт-терьер
раз: раза
видео: видео
помимо: помимо
статья: статьи
манипуляция: манипуляций
подойти: подойдет
полноценный: полноценного полноценной
психический: психическое
полностью: полностью
очередь: очередь
рисковать: рискуйте рискуете
условие: условии
смелость: смелость
расстояние: расстояние расстоянием
свободолюбивый: свободолюбивый
незнакомец: незнакомцами
сомневаться: сомневаться
владелец: владельца владельцев владельцы
распределить: распределены
рацион: рациона рацион
охотник: охотника охотниками охотник
коленный: коленные
называть: называют называемые называемый
речь: речь
интернет: интернете
содержание: содержание содержания
ген: гены
присутствовать: присутствовать присутствует
мелкий: мелких
сера: серы
постель: постели
стресс: стресса
движение: движение движения движении
достойно: достойно
слово: слово
мощный: мощный мощное мощная мощными
гипофиз: гипофизом
составлять: составляет
разлука: разлуки
характеризоваться: характеризуется характеризуются
настоящий: настоящим настоящие
поставить: поставила
храниться: хранится
обнаружить: обнаружить
массивный: массивный массивная
окрас: окраса окрас окрасу
нечто: нечто
подобрать: подобранный
ветеринар: ветеринару
допускать: допускает
открыть: открыты
подвес: подвес подвеса подвесом
переносица: переносицей
масло: масло
различаться: различаются
американец: американцев американец американцу
подчиняться: подчиняется
толк: толку
он: нему
национальный: национальной
связь: связь
уделять: уделять
переносить: переносит
доверять: доверять доверяет
точно: точно
обладательница: обладательницу
трещина: трещин
клуб: клуб клубом клубы
красный: красные
внешность: внешность внешностью внешности
единственный: единственный
мягкий: мягкой мягкий мягким
срок: сроки
лоб: лба лбу
длина: длине длины длина
откать: отки
лидер: лидером
предрасположенный: предрасположены
токио: токио
бедро: бедра
пока: пока
фон: фоне
фантазия: фантазию
осмотр: осмотру осмотре осмотр
от: ото
заиметь: заиметь
сводистый: сводистые
состояние: состоянии состояние
внешний: внешние
потерять: потерять
перестать: перестанет
прямой: прямыми прямая прямое прямой
наружу: наружу
почувствовать: почувствовать
удачный: удачное
гипотиреоз: гипотиреозом
растительный: растительное
благородный: благородной
клещ: клещ
дважды: дважды
возраст: возрасту возраста
хороший: лучшей хорошие лучшего хороший хорошей
выполнение: выполнения выполнении
член: члена членам членов
становиться: становясь
стремиться: стремились
заниматься: заниматься
лидерство: лидерство
зрелый: зрелой
плотно: плотно
причина: причина причине причин
дорожить: дорожащий
ухаживать: ухаживает ухаживать
аллергический: аллергическими
смотреть: см смотрите смотреть
иммунитет: иммунитетом
превышать: превышает
лёгкий: легкий
заокеанский: заокеанская заокеанской заокеанским
доверие: доверие
фотография: фотографии
завезти: завезенными
помогать: помогает
семь: семь
уход: уходе уход
заболевание: заболевании заболевания заболевание
страдать: страдать
высокий: высокая
питомник: питомники
гладкий: гладких
находиться: находиться находится
выбирать: выбирайте
глаз: глаза глаз глазах глазами
квадратный: квадратной квадратных
высыпка: высыпка
нетрудно: нетрудно
серьёзный: серьезным
карточка: карточкой карточка
прийтись: придется
целый: целые
заложить: заложенной заложенное
обильный: обильное обильный обильная
проблемный: проблемное
человеческий: человеческой человеческому
толстой: толстая
поздний: позже
век: века век веков
смысл: смысле
конечность: конечностях конечностей конечности
наследовать: наследует
год: года лет год году
покровный: покровным
доброжелательный: доброжелательна
называться: назывались называлась называется
фундаментальный: фундаментальных
бесплодие: бесплодие
поскольку: поскольку
обучение: обучения
охотничий: охотничьи охотничьих охотничьими
покупать: покупать покупали
формула: формула
простой: простой
краткий: краткая
весьма: весьма
недостаточный: недостаточная
язык: язык
компаньон: компаньона
любой: любого любые любых
вовнутрь: вовнутрь
отношение: отношение отношению
обижаться: обижается
место: место местах месте
пилочка: пилочкой
незаурядный: незаурядным
уха: ухе
класс: классом классов
край: края
тёмный: темной темного
нести: несет
профессионал: профессионалы
эксперт: экспертов
драка: драки
навязчивость: навязчивость
вконтакте: вконтакте
старый: старый
рядом: рядом
визитный: визитной визитная
наклонить: наклонены
сочетать: сочетает
агрессивный: агрессивны
переход: переход
прогрессировать: прогрессирующая
разновидность: разновидности
поддержать: поддержать
обращение: обращения
твёрдый: твердую
хозяин: хозяин хозяином хозяину хозяев хозяина
молодой: молодая
признавать: признавали признавая
кинологический: кинологической
японец: японцев японцам японцами
мать: мать
сша: сша
договориться: договориться
характер: характером характер
выгода: выгодой
выбрать: выбрать выбранный выбрав
добавиться: добавилось
причм: причм
акитой: акитой
пс: пс
открытый: открытый
оба: обеих
основать: основана
сустав: сустава суставы суставов
хотя: хотя
кушинга: кушинга
тугодум: тугодумом
охранник: охранника
предпочтительный: предпочтительнее
плоскость: плоскости
общий: общее общей
выгуливать: выгуливать
красавица: красавица
потенциальный: потенциальный
склонный: склонной
больший: большая больших
непослушание: непослушания
ворс: ворса
воспитанник: воспитанника
обречь: обреченным
опытный: опытный опытных
доставлять: доставлять
проблема: проблемы проблема
контролировать: контролируемой контролировать
нянька: нянька няньку нянькой
собственно: собственно
чувствовать: чувствовать чувствует
собаководство: собаководства
окружность: окружности
точка: точки точку
мешать: мешающим
квартира: квартире
вид: видов
информация: информация информацию
подходить: подходит подходят
капитуляция: капитуляция
друг: друг другом друга
долгий: долгой
послушный: послушного
наклоняться: наклоняться
масса: масса
ссора: ссоры
зуб: зуба зубы
будущее: будущем будущего будущее
треугольник: треугольник
проводить: проводить
сначала: сначала
похвала: похвалой
ребро: ребра
бест: бестах
остальной: остальных остальной
ниже: ниже
гармонировать: гармонирует
обитатель: обитателей
неприятность: неприятности
ежедневный: ежедневный
крепкий: крепкие крепким крепкий крепкая крепкими крепких
воспринимать: воспринимать
вплоть: вплоть
шалость: шалостях
совершенство: совершенству
ребёнок: детям детей ребенком детьми
подростковый: подросткового
кончик: кончик кончика
ощупь: ощупь
сравнительно: сравнительно
дом: дом доме
обращаться: обращайтесь
спать: спать
умный: умна умной умная
серый: серые
веко: веки
комната: комнату
колено: колени
вскоре: вскоре
новый: новых новой новое
объявить: объявили объявленных
мыть: мыть
холодильник: холодильнике
развитой: развитыми развитой развиты
хатико: хатико
обилие: обилие
пол: полу
полный: полной
создать: создан
затылочный: затылочного
тандем: тандемом
просто: просто
собрат: собрат собратьев
аллергия: аллергия
наблюдаться: наблюдаться наблюдается
уловка: уловки
красота: красоту
видимость: видимости
позиция: позиции
найти: найдет найти
конец: конца конец концы концах
водить: водить
принять: принято принять
час: часа
рыжий: рыжий
вожак: вожак вожака вожаком
угроза: угрозы угрозу
проходить: проходила проходит
независимый: независимый
величественный: величественных
мировой: мировой
низкий: низкая низкое
лес: лесу
несправедливый: несправедливо
психика: психике психикой
мотивация: мотивация
екатерина: екатерина
контакт: контакт
локоть: локтей локти
добавить: добавьте
сильный: сильного сильнее сильные
прогулка: прогулки прогулках прогулок прогулке
вычёсывать: вычесывать
предрасположенность: предрасположенность
нарушение: нарушений
начальный: начальном
умеренный: умеренная умеренное умеренный
происхождение: происхождения происхождении
необходимо: необходимо
развиться: развиться
третий: третьим
крестец: крестце
частично: частично
свой: своем своим свой свое своего своей своих своему свои
первоначальный: первоначальные
соотношение: соотношение соотношении
проявляться: проявляться
задний: задние задних
редкий: реже
черта: черты чертам
адренокортикотропный: адренокортикотропного
недорого: недорого
дрессировка: дрессировка дрессировки дрессировкой
время: время временем
сука: суки сук
плохой: хуже
агрессивность: агрессивность
остров: острова островах
шприц: шприца
ушной: ушной
смазываться: смазываться
великолепный: великолепные
устойчивый: устойчивой
нм: нм
день: дней день
смутить: смутить
наказание: наказания
животное: животным животного
превращать: превращайте
противный: противном
пясть: пясти
скрещивание: скрещивание
они: ими ними
применять: применяйте
тронуть: тронувшей
сила: сила
просмотр: просмотров
тщательный: тщательному
взять: возьмите взять
параллельно: параллельно
отдать: отданную отдали отдам
классика: классика
избежание: избежание
мера: мере мера меры
толстый: толстые
ожидать: ожидает ожидая
позвонок: позвонком
например: например
несколько: несколько
сетчатка: сетчатки
присваивать: присваивают
чрный: чрные
худой: худой
постоянный: постоянный постоянные
рост: рост
веский: веская веских
тупой: тупой
потомство: потомство
мл: мл
рубеж: рубеже
обидеть: обидеть
использоваться: использовавшиеся
правильный: правильном правильный правильной
очсова: очсов
резко: резко
реклама: реклама
соответственно: соответственно
плоский: плоский
мотив: мотивам
неплохой: неплохим
итальянец: итальянца
завораживать: завораживающее
япония: японию япония японией японии
наклон: наклон
мускулатура: мускулатурой мускулатура
грубый: грубая грубой
немедленно: немедленно
насадка: насадкой
ум: умом
процедура: процедуру процедуры
преданность: преданностью преданность
выпуклость: выпуклостью
оказаться: оказавшись окажется оказаться
рекомендоваться: рекомендуется
часть: частью
пигментация: пигментация
напоминать: напоминает
мочка: мочки мочка
спокойно: спокойно
ножницевидный: ножницевидный
характерный: характерны характерной
внутрь: внутрь
явно: явно
сохранять: сохраняя
работа: работы работу
малыш: малыш малыша
правильно: правильно
хватка: хватку
сам: самой самом
показывать: показывают
кобелиный: кобелиного
сайт: сайту
сухой: сухие
бывать: бывает
длинный: длиннее длинная
родословная: родословной
сколоть: сколов
следствие: следствие
мочь: могущие могут можете
специалист: специалисту специалист
занять: занять
крупный: крупная крупных крупнее крупной крупнейших крупными крупным
чайный: чайной
видеть: видим видели
кожа: кожа кожи
этот: эта этих
лишь: лишь
читаться: читаются
вариант: вариант варианты
нелёгкий: нелегкий
убираться: убираются
репутация: репутацией
треугольный: треугольной треугольная
труд: труд
иметь: имеющий имеет имел имеющие имеют
форум: форум форуме
лидировать: лидируют
внутренний: внутреннего
сторож: сторожем
достаться: доставшиеся
хотеть: хотят
тяжело: тяжело
приступ: приступы
нечистокровный: нечистокровную
темп: темпами
узник: узника
двойной: двойной двойное
комочек: комочки
распространение: распространения
этап: этапе
шоу-класс: шоу-класса
признак: признак
описание: описание
начало: начало
доставить: доставит доставить
присущий: присущи
вероятность: вероятности
ричард: ричардом
взаимодействие: взаимодействие
здоровье: здоровьем здоровье
капризуля: капризулю
белый: белых белого белая белый белом
запереть: запертой
владение: владения
зубной: зубного зубная
себорейный: себорейным
стоячий: стоячие
сглаживаться: сглаживаются
собачий: собачьих
глубоко: глубоко
посмотреть: посмотрите
однако: однако
сопрячь: сопряжена
фильм: фильм
соприкосновение: соприкосновения
соотноситься: соотносится
молоссами: молоссами
поэтому: поэтому
идти: шла
глубина: глубина
синхронизировать: синхронизировали
копирование: копирование
короткий: короткий короткая короткой
метр: метров
трудно: трудно
активность: активность
селекционер: селекционерам
подверженный: подвержены подвержен
развиваться: развиваться развивалась
пуходерк: пуходерку
федерация: федерации
осматривать: осматривайте
дружелюбность: дружелюбность
мама: мамой
иить: иили
плавно: плавно
направление: направление
отзыв: отзывах отзывы
втирать: втирать
кошка: кошки кошку кошек кошкам
хрящ: хрящах
следовать: следует
способ: способ способы
неприятный: неприятный
свободный: свободные
шум: шум
подавлять: подавлять
иной: иному ином иные
висячий: висячие
пожилой: пожилых
наказать: наказать
они-то: они-то
грянуть: грянула
внушительный: внушительных
уровень: уровня уровне
особо: особо
нетерпимость: нетерпимость
отличие: отличие
опека: опека
семенник: семенниками
подпасть: подпало
смена: смену
значение: значение
акит: акита акиту аките акиты
назад: назад
известный: известен
кортизола: кортизола
цвет: цвет цвета
решить: решили решит
сердце: сердца
гормональный: гормональных
игра: играх игры
недоброжелатель: недоброжелатель
минимум: минимум
вывозить: вывозить
другой: других другим
известность: известность
заусенец: заусенцев
целое: целом
объявление: объявления
сделать: сделать сделано
основной: основные
полова: половой
элементарно: элементарно
важный: важна
интеллект: интеллект
скрещивать: скрещивали
средне: средне
протирать: протирайте
вес: вес
показаться: показаться
степень: степени
потомок: потомка
помочь: помогут
питание: питания
сучий: сучьего
голос: голос
действенный: действенные
ежедневно: ежедневно
профилактический: профилактическая
морщина: морщины
именно: именно
миллион: миллионов
доля: долей
чрезвычайно: чрезвычайно
отклонение: отклонения отклонений
унаследовать: унаследовала
верхний: верхнего верхняя
отсутствовать: отсутствуют отсутствующая
ограниченный: ограниченными
расчсывать: расчсывать
какой-либо: каких-либо
продолжительность: продолжительность
случаться: случаются
острый: острые
позволять: позволяли
остановить: остановили
линия: линия линий
полустоячий: полустоячие
достат: достат
второй: вторая
последующий: последующем
доходить: доходит
обеспечить: обеспечить
паста: пасту
короче: короче
положение: положении
расположить: расположены
бросаться: бросаться бросается
два: двумя
маленький: маленькими маленькие маленьких
развитие: развития
нужда: нужды
результат: результате
осень: осенью
подход: подход
цель: целях цели
запоминать: запоминает
слегка: слегка
тот: те тех тому
посягнуть: посягнул
сдать: сдали
фото: фото
замечательный: замечательной
показать: показать
правительство: правительства
дерматит: дерматитами
допускаться: допускается
кушать: кушать
м: м
вы: вами
нехитрый: нехитрая
регулярный: регулярном регулярных
будущий: будущий будущую
яндекс: яндекс
продолжительный: продолжительных
коллега: коллегами
выглядеть: выглядеть выглядят
нечаянно: нечаянно
вперёд: вперед
кто: кого
череп: черепа череп
ухо: уха ушах уши
пустяк: пустякам
неудобство: неудобства
нрав: нрав нравом
сравнение: сравнении
пугливость: пугливость
визуальный: визуальный
лапа: лапы лап
спина: спиной спины спина
угол: углами
зазнайство: зазнайства
желать: желает
журнал: журнал
весь: всей всем
высота: высота высоты высоту
загривок: загривок загривка
отец: отец
нога: ногами
градус: градусов
нуждаться: нуждаются нуждается
насилие: насилие
гулять: гулять гуляет
определить: определить
признанный: признанный
первый: первое первый
безграничный: безграничной
обычный: обычной
стихия: стихия
покров: покров
болезнь: болезни
золотистый: золотистый
слезиться: слезящиеся
реакция: реакциями реакций
сливаться: сливается
загородный: загородном
прекрасный: прекрасными прекрасный
развернутость: развернутости
малый: меньшей
совершенно: совершенно
либо: либо
денежный: денежной
прописаться: прописалась
гир: гиром
ограничиться: ограничиться
штат: штатах
поводырь: поводыря
кошачий: кошачьи кошачьего
обозревать: обозревает
подсказать: подскажет
перегружать: перегружать
накричать: накричать
признание: признание
нос-бабочка: нос-бабочка
дисквалификация: дисквалификации
продавец: продавце
самолечение: самолечение
мощь: мощь
прилегать: прилегает прилегают
проявить: проявить
охрана: охраной
предать: преданного преданный
поддаваться: поддавайтесь
прямонаправленный: прямонаправленные
корпус: корпуса корпусом корпус
кобель: кобели кобелей
ущерб: ущерб
перекус: перекус
прочитать: прочитать
взросление: взросления
нужный: нужен
медвежий: медвежьего
являться: являются является
перейти: перейти
закрытый: закрытой
каждый: каждом каждый
проверить: проверенных
из-за: из-за
красивый: красивый красивого
регулярно: регулярно
быстрый: быстрыми
кан-корсо: кане-корсо
коготь: когтей когтями
который: которая которым которые которому который
броситься: бросится
фурминатор: фурминатор
начинать: начинает
рынок: рынке
ухудшаться: ухудшаться
уголок: уголках
безусловный: безусловным
родина: родину родина
менее: менее
складка: складок складки
заманить: заманили
возвращаться: возвращаясь
эндокринный: эндокринной
особенный: особенным
обманывать: обманывать
оставлять: оставляя
принадлежность: принадлежности
подходящий: подходящего
грудь: груди
спускать: спускайте
клетка: клетка
вместо: вместо
надпочечник: надпочечниками
собаководческий: собаководческие
костяк: костяк
отсутствие: отсутствие
ткань: тканью
слишком: слишком
одиночество: одиночеству одиночество
содержать: содержа
дружелюбие: дружелюбие
выпад: выпад
уступать: уступать
запрет: запрет
стандарт: стандарта стандарт
кой: коем
посредством: посредством
сзади: сзади
атрофия: атрофия
понимание: пониманию
недоступный: недоступное
опасный: опасна
экономия: экономия
терпеть: терпит
младший: младших
сваливание: сваливанию
закисание: закисание
пузырчатка: пузырчаткой
печёночный: печеночный
холодный: холодна
мускулистый: мускулистая
какой-то: какие-то какое-то
проточина: проточина
густой: густой
спровоцировать: спровоцировать
оценка: оценке
нагрузка: нагрузок
бой: боях
поведенческий: поведенческие
рубль: рублей
невольно: невольно
исключить: исключить исключена
консистенция: консистенция
разведение: разведения разведению
уверенный: уверенным уверенными
сбалансированный: сбалансированный
полость: полости
собственность: собственность
приглянуться: приглянувшихся
внимание: внимание
грубость: грубости
наличие: наличии наличие
блестящий: блестящей
варьироваться: варьируется
предназначение: предназначение
сбить: сбить
основный: основное
терпимость: терпимость
угнетённость: угнетенности
гиперадренокортицизм: гиперадренокортицизм
глубокий: глубокая
ассоциация: ассоциация
фронт: фронта
коснуться: коснуться
завоёвывать: завоевывать
переживать: переживать
шуба: шубой
стоимость: стоимость стоимостью
удалять: удалять
приобрести: приобрести
спокойный: спокойная спокойном
иначе: иначе
причинить: причинен
особенно: особенно
бок: бока
щётка: щетку
подавать: подавать
инфекция: инфекциям
воля: волю
пегий: пегими
строго: строго
возле: возле
включать: включать
металлический: металлической
страна: стран странах страна
достаточно: достаточно
обязательно: обязательно
международный: международной
задирать: задирать
доминировать: доминировать
жалоба: жалоб
успеть: успели
расположение: расположение
мошонка: мошонку
когтереза: когтерез
обладатель: обладателем
объёмный: объемная
кольцо: кольцо
миролюбие: миролюбие
неделя: неделю
заскучать: заскучать
орган: органы
получиться: получилось
опасность: опасности
несмотря: несмотря
купить: купить
плотный: плотный
часто: часто
аденит: аденитом
опустить: опущенными
неглубокий: неглубокая
бороздка: бороздка
завысить: завышенных
минимальный: минимальным минимальная
регистрация: регистрацию
осуществляться: осуществляется
разводить: разводили
расширяться: расширяется
случай: случаях случае
охранять: охранял охранять
основание: основание оснований
контур: контуры
галочка: галочки
система: системы
выворот: выворот
рассчитывать: рассчитывать
тщетно: тщетно
верность: верность
жадность: жадностью
бугор: бугра
домочадец: домочадцев
двор: двором
чёткий: четкие
понять: поняла
гордость: гордости
конкурс: конкурсы
далеко: далеко
стопа: стопы
трусость: трусость
одноклассник: одноклассники
палево-белый: палево-белый
путём: путем
вс: вс
челюсть: челюстей челюстями
дисплазия: дисплазия
чистить: чистить
кал: кал
случайный: случайные
гормон: гормона
передний: передние передних
навык: навыки
ведт: ведт
кроме: кроме
компонент: компоненты
чм: чм
позволить: позволит
сдержать: сдержанной
частый: чаще
эффективный: эффективен
поиск: поиск
равняться: равняется
слышный: слышно
тазобедренный: тазобедренного
предмет: предметом
опускаться: опускается
поражать: поражает
вялость: вялость
раздумывать: раздумывая
заедать: заедать
прародитель: прародителями
солнце: солнца
несвойственный: несвойственно
эффектный: эффектному
себя: собой
образовать: образует
официальный: официальное
общительный: общительный
период: период
навязываться: навязываться
воротник: воротника
тут-то: тут-то
подвижный: подвижными
ротовой: ротовой
газета: газет
тигровый: тигровый
светлый: светлые
сбоку: сбоку
попросту: попросту
сигнал: сигналом
особенность: особенностям особенности
лакомство: лакомством
присмотреться: присмотритесь
гигиенический: гигиенические
колтун: колтуны
потребность: потребность
порок: пороки пороками
генетический: генетическую
предок: предков предками
недокус: недокус
личный: личном личного
вовсе: вовсе
линька: линьки линьке линька
заходить: заходит
жизнь: жизни
упрямиться: упрямится
абсолютно: абсолютно
жить: живущую
шанс: шансов
рука: руку
приятный: приятной
скакательный: скакательных
мир: мире мира
лишний: лишний
говорить: говорить говоря
благодаря: благодаря
восходить: восходящего
подобно: подобно
запах: запах
группа: группы
снятой: снят
вертикаль: вертикали
переходить: переходит
адаптироваться: адаптироваться
просторный: просторным
проживание: проживания
желудок: желудка
различный: различные
трусливый: трусливы
вязка: вязкам
относительно: относительно
нужно: нужно
мимимишность: мимимишности
пятнистый: пятнистыми
караулить: караулить
животик: животик
действие: действиями
также: также
толчок: толчок
сопротивление: сопротивление
идеал: идеале
достаточный: достаточной
покупка: покупки
шёрстный: шерстный
момент: моменты
ретривер: ретривер
последний: последним
облегчнный: облегчнный
совместный: совместного
весна: весной
риск: риском
беспричинный: беспричинных
опасаться: опасаться
повышать: повышайте
поясница: поясница
превосходный: превосходного
умеренно: умеренно
обрезка: обрезки
стоить: стоить стоит
публикация: публикации
изначально: изначально
высоко: высоко
возникновение: возникновении
великолепно: великолепно
военнослужащий: военнослужащие
знакомство: знакомства
продуцирование: продуцирования
это: это
сторожевой: сторожевые
воспитанный: воспитанная воспитанной
вытягивание: вытягивании
разный: разных
эпилепсия: эпилепсия
перепутать: перепутать
клиника: клинике
любить: любит любят
прибылой: прибылые
отличный: отличным отличные
титуловать: титулованных
новообразованный: новообразованной
сведение: сведению
пригодиться: пригодилось
рм: рм
стараться: стараться
тибетский: тибетский
недуг: недуги
покрывать: покрывая
невозможно: невозможно
способный: способен
своевременно: своевременно
неумный: неумной
участок: участках
нелишний: нелишним
плюшевый: плюшевой
увечье: увечье
отит: отит
легко: легко
многий: многих
лента: ленту
непереносимость: непереносимостью
выгул: выгула
слепить: слепить
свыше: свыше
столетие: столетий
вверх: вверх
известно: известно
счтить: счту
возникать: возникает
исключение: исключением
остевой: остевая
лидерский: лидерские
ванная: ванную
разделение: разделение
покрыть: покрыт
подумать: подумает
половина: половине
лай: лай
тмно-коричневый: тмно-коричневый
многое: многом
объмный: объмная
безопасность: безопасности
неправильный: неправильного
сдержанность: сдержанность
вой: вой
замахнуться: замахнулись
вакансия: вакансии
настойчиво: настойчиво
возвращение: возвращения
прикус: прикус
продать: продам
встречаться: встречается
постоянно: постоянно
план: плане
генетически: генетически
демократичный: демократичен
общество: общество
выше: выше
грудной: грудная
ранний: раннем
самурай: самураи
высокопородный: высокопородную
обойтись: обойтись
большинство: большинстве
вместе: вместе
пройти: прошла
прижать: прижмите
оказывать: оказывать
ещ: ещ
надёжный: надежной
матаги-акита: матаги-акита
сосед: соседям
вздутие: вздутие
практически: практически
рейтинг: рейтинг
пропорция: пропорции
токийский: токийских
вернуть: вернуть
популярный: популярными
теряться: теряться
подписываться: подписывайтесь
двигаться: движется
знаменитый: знаменитый
уходить: уходят
равномерно: равномерно
океан: океаном
серповидный: серповидной
памятник: памятниками
бесстрашно: бесстрашно
постановка: постановка
хвост: хвоста хвост
источник: источником
запретить: запрещено
очень: очень
особь: особей
обычно: обычно
ладить: ладит
лояльность: лояльность
поводок: поводка
розовый: розового
умерший: умершего
произойти: произошло
выполнять: выполнять
второе: второе
покраснение: покраснение
наоборот: наоборот
постепенно: постепенно
кличка: клички
правило: правила
довольно: довольно
прежде: прежде
отыскать: отыскать
усовершенствовать: усовершенствовать
касаться: касается
стремительный: стремительными
выставочный: выставочных
необходимый: необходимые
избыточный: избыточного
обижать: обижайте
дело: деле
подлежать: подлежат
красноречивый: красноречиво
выигрывать: выигрывая
ласковый: ласковая
назойливость: назойливость
проект: проекте
число: числе
недопустимо: недопустимо
спаниель: спаниель
кг: кг
насколько: насколько
городской: городской
уравновесить: уравновешенная
злобность: злобность
среднее: среднего
слезовыделение: слезовыделения
стрижка: стрижке
ответ: ответ
существование: существованию
дверь: двери
пинто: пинто
вздутый: вздутый
указание: указанию
вета: вет
толкнуть: толкнет
наедине: наедине
лаять: лает
память: памятью
плюсна: плюсны
давно: давно
удар: удара
наркоз: наркоза
родитель: родителей
ложка: ложки
титул: титулов
красавец: красавцев
ожидание: ожидании
утвердить: утвердила
вследствие: вследствие
скрытый: скрытые
губа: губы
принимать: принимают
оснастить: оснащены
она: ею
донести: донести
демонстрировать: демонстрировать
пет-класс: пет-класса
беспрекословно: беспрекословно
