ясно: ясно
туалет: туалет туалетом
иметь: имели имеет имеющая имеют
прогуливаться: прогуливайтесь
процесс: процессе
кое-какой: кое-какие
овощ: овощи
противник: противника
тело: тела тело
широко: широко
средний: средняя средней средний
скот: скота
подарить: подарили
активный: активные активный
следить: следить
удар: удар
посторонний: посторонних
ответственный: ответственные
сколько: сколько
уэльс: уэльса
название: название
домой: домой
собака: собаку собаками собак собака собаке собаки
вывести: вывести выведена
пошалить: пошалить
обсуждение: обсуждения
отношение: отношениях отношение
наследственность: наследственностью
торг: торг
оптимально: оптимально
цена: цена цены
сказать: скажите
кустик: кустики
зачастую: зачастую
рельефный: рельефные
преподноситься: преподносится
чувствительный: чувствительные
любой: любая любого любой
материал: материалов
природа: природы
удовольствие: удовольствием
казаться: кажется
сторожить: сторожат
размер: размерам
послабление: послабления
тренировка: тренировками тренировка
сторона: стороны
очень-то: очень-то
долгий: дольше долгое
дисквалифицировать: дисквалифицирующие
полёт: полет
пемброк: пемброкам пемброком пемброк пемброков пемброки пемброка
инстинкт: инстинкты
близкий: ближайшие ближайшую
уэльский: уэльского уэльской
характеристика: характеристиках характеристика
кередигион: кередигион кередигиона
побегать: побегать
положить: положенного
зато: зато
россия: россия россии
набор: набор
миска: миска
обратный: обратная
корпус: корпусе корпусом корпус
радужка: радужки радужка
попонка-дождевик: попонку-дождевик
представитель: представителей представителям представителя представители
предложение: предложение
умышленно: умышленно
грань: грани
фактор: фактором
шея: шея
волос: волосом волос
пример: пример
овчарка: овчарки овчарок овчарке овчарку овчарка
привилегия: привилегией
стричь: стричь
шерсть: шерсть шерсти шерстью
поверхность: поверхности
вынудить: вынужден
неопытный: неопытного
специально: специально
крупа: крупа крупы
обстоять: обстоят
служебный: служебной
качество: качеств качестве качества
собака-работяга: собаки-работяги
розовый: розовый
один: одним одного одно одни
объявиться: объявились
челюсть: челюсти челюстей
фейри: фейри
перерасти: переросло
должный: должны должен должно должна
тип: тип
пародонтоз: пародонтоз
аллергия: аллергией аллергии
факт: факта факт
забрасываться: забрасываться
содержать: содержать
взгляд: взгляд
артистичный: артистичный
повязать: повязать
уступать: уступают
сегодняшний: сегодняшних сегодняшние
вельша-корги: вельш-корги
пастуший: пастушья пастушью
месяц: месяц месяца месяцев
питомец: питомцами питомцу питомца
поселить: поселить
домик: домик
смеяться: смеетесь
слабый: слабых
великобритания: великобритания
сверх: сверх
спустя: спустя
включая: включая
учитывать: учитывайте
важно: важно
тень: тени
скандинавский: скандинавскими
насчёт: насчет
история: история
индивидуальный: индивидуальным
вылезать: вылезает
пышный: пышный пышному
брать: брать
заручиться: заручившись
продажипокупка: продажипокупки
диковинка: диковинки
щенок: щенка щенков щенки щенок
ножка: ножками
томат: томаты
проявляться: проявляется
выгул: выгул выгула
действие: действиям действия
попросить: попросите
сбалансированный: сбалансированного
расчёска: расчесок
прилегать: прилегающие
подбирать: подбирать
принять: примите принято
взрослый: взрослый
цирковой: цирковых цирковым
каждый: каждого
называть: называет
положительный: положительной
приятно: приятно
снять: сняло
баклажан: баклажаны
минимальный: минимальный
семья: семьи
определение: определению
род: рода
ассоциация: ассоциации ассоциациями
этот: этими эта этому
специалист: специалистами специалиста специалисты
недоразумение: недоразумение
выставка: выставках выставок
руб: руб
несколько: несколькими несколько
выставочный: выставочные выставочная выставочными
помощь: помощью помощь
причина: причинам
монотонность: монотонностью
лисий: лисьему
коротколапый: коротколапые
около: около
нет-нуть: нет-нет
миниатюрный: миниатюрными миниатюрная
фристайл: фристайлом
оснастить: оснащенной
пятно: пятна
импульсивный: импульсивных
зоомагазин: зоомагазинах
месячный: месячный месячном месячного
сергей: сергей
еда: еды
объедаться: объедаются
коготь: когти
голубовато-пятнистый: голубовато-пятнистый
значит: значит
утратить: утративший утратили
где-то: где-то
появление: появление появления
вывернуть: вывернуты
требовательный: требовательны
быстро: быстро
выторговать: выторговать
перенести: перенес
руководствоваться: руководствоваться
первый: первой первый первых
игровой: игровой
основное: основном
чисто: чисто
раз: раза
видео: видео
помимо: помимо
исчезновение: исчезновения
начать: начать
манный: манная
доверчивый: доверчивы
недостойный: недостойное
полностью: полностью
меню: меню
забавный: забавные
условие: условии условиях
обида: обиде
улица: улицу
компания: компании
кеннел-клуб: кеннел-клуб
макароны: макароны
каша: кашами
чувство: чувству чувство
владелец: владельца владельцев
самостоятельный: самостоятельных
нужный: нужна нужной
бесконечно: бесконечно
рацион: рациона рацион
образ: образ
благоустроенный: благоустроенной
содержание: содержание содержания
ген: гены
укорачивать: укорачивали
собственный: собственного собственные
немного: немного
килограмм: килограмм
предать: предан
живой: живом живой
волкодав: волкодава
жить: живет
недавний: недавнего
численность: численность
окрас: окраса окрас окрасом окрасу окрасы
предел: пределы
обоснование: обоснование
корж: коржей
масло: масло
выручить: выручить
территория: территорию
связь: связь
подобный: подобным
матрас-лежанка: матрас-лежанка
тестирование: тестирования
провислость: провислости
внешность: внешность внешностью внешности
мягкий: мягкой мягкий
флегматичность: флегматичностью
гладкий: гладкие гладкая гладкой
недостаток: недостатком
зажигать: зажигали
пока: пока
фон: фоне
жильё: жилья
ошейник: ошейнику
состояние: состоянии состояние
приземистый: приземистые
солнце: солнцем
обладать: обладают обладает
наружу: наружу
хвост: хвосту хвосты хвост
растительный: растительное
давать: давать
среднестатистический: среднестатистический среднестатистической
обувь: обувь
выдающийся: выдающийся
кардиган: кардиганов кардигана кардиган кардиганам кардиганы
частенько: частенько
просмотр: просмотром просмотров просмотра
чемпион: чемпион
спортивный: спортивные
предмет: предметы предметов
заниматься: заниматься занимающихся
малоприятный: малоприятную
плотно: плотно
тесный: тесных
сказочный: сказочные
внешний: внешнее внешнего
поводок: поводку
ежедневный: ежедневного ежедневными
домысел: домыслов
смотреть: см
друг: друзья друзей
способность: способности способностей
фотография: фотографии
потешно: потешно
невзирая: невзирая
мерль: мерль
агрессивный: агрессивная агрессивный
расти: растут
посоветовать: посоветовал
уход: уходе ухода уход
современный: современные
голубой: голубой голубая
исполнение: исполнение
знать: знать
стартовать: стартуют
создание: создания создание
обожать: обожающие
социализировать: социализировать
сократить: сократили
чёрный: черная черного
помнить: помните
высокий: высокая
питомник: питомники питомниках питомников
анатомический: анатомические
череп: черепом
глаз: глаза глаз глазам
район: районе
самый: самый самых
работать: работая
поднимание: поднимание
грязь: грязь
прийтись: придется пришлось
обезжиренный: обезжиренные
бежать: бегущие
кинолог: кинолог
корм: корм
трудовой: трудовых
сметана: сметана
семейство: семействами
вниз: вниз
поздний: позже
беловеда: беловед
валлиец: валлийцы валлийцами
форма: форме
вести: вести
малыш: малышу малышей малышами малыши малыша
год: года лет год годов году
мир: миром
ветеринарный: ветеринарным
поскольку: поскольку
контактный: контактны
проявлять: проявляют
пользоваться: пользуются пользовавшиеся пользоваться
краткий: краткая
уроженец: уроженцы уроженец уроженцев
невоспитанность: невоспитанности
миловидный: миловидные
грибеникнуть: грибеник
свой: своими свой свое своего своих
обаяшка: обаяшки
место: место местах места мест
кередигионский: кередигионских
масса: массы масса
снизить: снизило
отказаться: отказались
плавный: плавная
ветвь: ветви ветвь
преобладать: преобладающие преобладают
исключительно: исключительно
проморозить: промороженным
присмотреть: присмотреть
пшённый: пшенная
эксперт: экспертов
крупяной: крупяными
стремление: стремление
окрепнуть: окрепла
вконтакте: вконтакте
свет: свет
человек: людьми человеком
вальхунд: вальхундов
рядом: рядом
впечатление: впечатление
лёгкий: легче легкой легкое
наклонить: наклонены
дать: дать дало дали
разновидность: разновидности
особь: особями особей
тазобедренный: тазобедренных
разведение: разведением разведение
ярко: ярко
мес: мес
короткий: коротким короткий короткие короткими
шубка: шубки
продажа: продажу продаже
симпатяга: симпатяги симпатяга симпатягам
явление: явлению
жидкий: жидкими
поддержка: поддержкой
животное: животных животным животные
кинологический: кинологической кинологическими кинологические
реакция: реакцией
договориться: договориться
пикировать: пикировать
счастливый: счастлив
выигрывать: выигрывают
бег: беге
верх: верх верха
характер: характером характер
непринуждённый: непринужденном непринужденной
длина: длины
выбрать: выбрать
настоящий: настоящей
общество: общества
изделие: изделия
находиться: находящаяся находящейся
основать: основана
толстый: толстым
хотя: хотя
разбираться: разбираюсь
ассортимент: ассортимент
перевозить: перевозя
мраморный: мраморного
х: х
серьёзный: серьезные
запереть: заперты
предпочтительный: предпочтительнее
изменение: изменением
век: веке веками
корова: коров корову корова
встреча: встречи
который: которую которое которой которая которых которые который
существенно: существенно
осмотр: осмотре
хорошенько: хорошенько
бронзовый: бронзовом
квартира: квартире
раздражать: раздражало
мера: меру мере меры
мясной: мясном
выпуклость: выпуклости
информация: информация
умеренно-живой: умеренно-живого
акробатический: акробатическим
наклоняться: наклоняться
максимально: максимально
проводить: проводить
генетический: генетической генетических
мытьё: мытья
ниже: ниже
такой: такое такие такую
кататься: катаясь
крепкий: крепкие крепкими
сухой: сухой
блю: блю
потасовка: потасовки
габарит: габариты габаритам
перебарщивать: перебарщивать
небольшой: небольшая
тенистый: тенистое
подушечка: подушечками
проницательный: проницательные
это: этим это
официальный: официального
шелковистый: шелковистой
рощица: рощицу
по-крупному: по-крупному
считаться: считается
межсезонье: межсезонья
отклониться: отклонившегося
кто: кем
рабочий: рабочих рабочие
потомок: потомками
тревожный: тревожный
игрушечный: игрушечных
предпочитать: предпочитавших предпочитая
просто: просто
забывать: забывать забывайте
щелчок: щелчком
британский: британских
вельш-корги-кардиган: вельш-корги-кардигана
знакомить: знакомить
успешный: успешного
предназначить: предназначена
объяснить: объясните
покладистый: покладисты
проследить: проследите
хитрый: хитрые
скапливаться: скапливающаяся
составление: составлением
вывих: вывих
считать: считают считать
четырехлапый: четырехлапых четырехлапое
окружающие: окружающим
контакт: контакт
пропорциональный: пропорциональная
добавить: добавьте
чистка: чистка
прогулка: прогулки прогулок прогулке
предрасположенность: предрасположенность
шерстепад: шерстепад
умный: умен умные умная
происхождение: происхождения
заболевание: заболевания
лапка: лапки лапками лапкам
противостояние: противостояние
наследовать: наследуют
охотный: охотнее
кобель: кобеля кобели
дрессировка: дрессировка дрессировки
время: время времени
ватный: ватными
отдельно: отдельно
сука: суки суку
приблизительно: приблизительно
фанат: фанатов фанаты
агрессивность: агрессивность
интеллектуальный: интеллектуальных
кисломолочный: кисломолочная
досадный: досадное
деятельность: деятельности деятельностью
скрещивание: скрещивание скрещивания
другой: другие другими другая
хозяин: хозяином хозяину хозяина
традиционно: традиционно
кусаться: кусаться
солнцепёк: солнцепеке
поставить: поставить
например: например
шведский: шведских
рост: рост
облаять: облаять
прививка: прививки прививками
гриб: грибы грибами
лимит: лимит
умеренный: умеренное
резко: резко
реклама: реклама
силуэт: силуэта
соответственно: соответственно
мясо: мясом
лосьон: лосьоном
вещь: вещам
легенда: легенд
организм: организм
короткохвостый: короткохвостых
доходчиво: доходчиво
плохой: плохой
полагаться: полагается
процедура: процедуру
парк: парк
рекомендоваться: рекомендуется
проблема: проблемами проблема
воспитание: воспитание
учиться: учатся
безусловно: безусловно
привыкнуть: привыкнуть
дефектный: дефектной
старание: стараниями
правильно: правильно
воспитанный: воспитанные
сам: самой сама самом
стать: стало
сайт: сайту
выращивание: выращивание
длинный: длиннее длинным длинными
родословная: родословной
следствие: следствие
щенок-подросток: щенка-подростка
пища: пищей
недуг: недугов
крупный: крупная крупнее крупного крупные
быть: будут
образовать: образованы
многолетний: многолетнее
вариант: вариант
долго: долго
уважать: уважающие
будни: будней
домашний: домашними домашним
выносливость: выносливости
опытный: опытные
некрупный: некрупных
форум: форум форуме
заметить: заметить
расчёт: расчета
конец: конце конец
кормить: кормите
страница: страницах
планета: планете
заводить: заводить
советовать: советуют
внешне: внешне
приучение: приучение
повод: повода
желудок: желудок
отлтом: отлтом
кончик: кончиками
земля: земли
снимать: снимаете
натуральный: натуральной
описание: описание
виноград: виноград
начало: начало начале
жорович: жорович
стандарт: стандартом стандарты
гипотеза: гипотез
посадить: посаженные посаженный
практиковать: практикующих
доброжелательный: доброжелательным
округлый: округлые
воображение: воображении
шок: шока
белый: белых белый
стоячий: стоячие
гребень: гребень
гречневый: гречневая
изнеможение: изнеможения
однако: однако
промахиваться: промахивалась
жёсткий: жестких жестким жесткой жесткая
играть: играть
устраивать: устраивать устраивайте
поэтому: поэтому
являться: являлись
предлагать: предлагают
копирование: копирование
дружелюбный: дружелюбная
попытаться: попытаются попытается
неконфликтный: неконфликтный
активность: активность
вооружиться: вооружившись
развиваться: развиваться
равнодушие: равнодушие
продукт: продукта продуктом продукты
дружелюбность: дружелюбность
незнакомец: незнакомцам
приподнять: приподнят
подвижный: подвижные подвижная
отзыв: отзывах отзывы
разрешать: разрешают
нога: ноги ногу
кошка: кошки кошками
неудивительный: неудивительно
демонстрировать: демонстрировал демонстрировать
животный: животному
поясница: поясницы
шум: шум
висячий: висячие
феликс: феликс
трюкач: трюкачи
копыто: копытом
кельт: кельтам
уровень: уровня
гибкий: гибкие
отличие: отличие отличий отличия
популярность: популярностью популярность
подсказать: подскажите
ортопедический: ортопедической
похлёбка: похлебки
породный: породные
назад: назад
пожалуйста: пожалуйста
лето: летом
почему: почему
универсальный: универсальная
соблазнительно: соблазнительно
цвет: цвет цвета
слой: слоем
гиперактивный: гиперактивны
кость: кости
интерес: интерес
осторожно: осторожно
пастушеский: пастушеской
дом: дома доме
мочь: могут могла
хороший: лучшие
н: н
удобство: удобства
оставаться: оставались
возраст: возрастом возраст возраста возрасте
заключаться: заключалась
порода: породы пород породами породу порода породой
возрасти: возросла
творог: творог
объявление: объявления
подразумевать: подразумевающим
сделать: сделать сделано
основной: основные
дополнительный: дополнительным
интеллект: интеллект
охранный: охранные охранной
скрещивать: скрещивали
энтузиаст: энтузиастов
вес: вес
спина: спину
притворяться: притворяться
потратиться: потратиться
непритязательный: непритязательную
линять: линяют линять
ежедневно: ежедневно
результат: результаты
долгожданный: долгожданную
кератит: кератит
сухарик: сухариками
французский: французский
именовать: именуя
л: л
серьёзно: серьезно
чрезвычайно: чрезвычайно
злоупотреблять: злоупотреблять
парочка: парочка
добродушный: добродушный
продолжительность: продолжительность
идентифицировать: идентифицировать
перемещение: перемещениями
подопечный: подопечный подопечных подопечного
диван: диване
нормальный: нормальной
фермер: фермеры
член: членов члены
шпиц: шпица
конфликтовать: конфликтуют
линия: линия линией
страна: страны страна
неизменно: неизменно
юмор: юмора
короче: короче
переселенец: переселенцами
оттенок: оттенок оттенком
длиннотелый: длиннотелые
два: двумя две
джентльмен: джентльмены
бедный: бедный
шампунь: шампунь
лишаться: лишаться
основный: основным основных
доминирование: доминированию
опустить: опущенные опущенный
кавказский: кавказская
правило: правилами правила
вещество: веществ
продавец: продавца
способ: способом
цель: целях
слегка: слегка
тот: те та тех тому
здравствуйте: здравствуйте
поглощать: поглощают
пухлый: пухлыми
остров: островах
фото: фото
переходящий: переходящая
сходить: сходить
прирождённый: прирожденные
заодно: заодно
десятилетие: десятилетий
будущий: будущий
яндекс: яндекс
ротвейлер: ротвейлер
магазинный: магазинную
уголок: уголок
спокойствие: спокойствие
здоровый: здоров
страдать: страдает
вперёд: вперед
хотеть: хотите хочу
проникнуть: проникли
мой: моем
различный: различного
экспонироваться: экспонироваться
рад: рад
получить: получила
лапа: лапы
покусывание: покусывание
холка: холке
угол: углами
окрасить: окрашенная
журнал: журнал
высота: высота
глаукома: глаукома
делать: делать делают
морковь: морковь
пароль: пароль
скучать: скучает
ст: ст
выгулять: выгуляли
серьёзность: серьезностью
кишечник: кишечником
э: э
больший: большие
обычный: обычной
уживаться: уживаются
покров: покров
прочее: прочего
болезнь: болезни
уступка: уступки
резервирование: резервированию
заводчик: заводчиков заводчика заводчики
клеймо: клеймом
лоток: лоток
совершенно: совершенно
морда: мордой
либо: либо
начинать: начинать начинайте
терять: теряют
стадо: стада
минута: минут
простой: проще
серый: серых
невозмутимый: невозмутимым
костистый: костистее
достигать: достигать
телёнок: теленка
жиреть: жиреют
обеспечивать: обеспечивают
парень: парень
экстерьер: экстерьере
внимательно: внимательно
бдительно: бдительно
обезопасить: обезопасить
доминировать: доминировали
пусть: пусть
исполнительный: исполнительны
допустимый: допустимы
ущерб: ущерб
диплом: дипломы
ревность: ревность
заметно: заметно
отличить: отличить
пищевой: пищевой
зубец: зубцами
дело: дело дела деле
темп: темпе
пенька: пеньке
перейти: перейти
относить: относит
сутки: сутки
статус: статус
физический: физические
возбудить: возбужденной
из-за: из-за
главное: главное
хозяйский: хозяйских
загородный: загородного загородное
запрет: запретом
достоверный: достоверного
гулять: гуляет
чистить: чистят
распиаренность: распиаренности
менее: менее
арсенал: арсенал
навязчивость: навязчивостью
сигнал: сигнал
решить: решено
идти: идут идет
укусить: укусив
навязчивый: навязчивы
горизонтальный: горизонтальным горизонтальные
рекомендовать: рекомендуем
площадка: площадке
распрощаться: распрощались
таксообразный: таксообразными
команда: командам команд команда
лужайка: лужайкой
клетка: клетка клетках
слишком: слишком
одиночество: одиночеству
корги: корги
разграничивать: разграничивающим
ши-тец: ши-тцу
подшёрсток: подшерсток подшерстка
купирование: купирования
мордочка: мордочка
работа: работа
день: день дни
портить: портить
отличаться: отличался отличались
гигиена: гигиена
внутренний: внутренняя
птичий: птичьи
перепутать: перепутаны
закруглить: закругленными
ваш: ваш вашем
пуходерка-грабельки: пуходерка-грабельки
мускулистый: мускулистая
густой: густой
воспитать: воспитаны
снова: снова
оценка: оценке
рубль: рублей
родина: родине
появиться: появились появилась
спереди: спереди
сложный: сложнее
мочка: мочка
неплохо: неплохо
старый: старым
пастьба: пастьбой пастьбы
сильный: сильное сильные
слабо: слабо
доводить: доводите
переусердствовать: переусердствуйте
неделя: недель неделю
выйти: вышедшего
граница: границ границы
регулировать: регулируемой
весить: весит
скромный: скромный скромной
выбирать: выбирая
племенной: племенных
одёжка: одежек
разнообразить: разнообразить
верить: верят
спасибо: спасибо
повергать: повергающий
стоимость: стоимость стоимости
особенно: особенно
любопытный: любопытный
использовать: использовали
строго: строго
полугодовалый: полугодовалых
необходимый: необходимыми необходимые необходим
настороженный: настороженной
достаточно: достаточно
обязательно: обязательно
ответ: ответов ответ
рисковать: рискуете
оба: обоими
спасииибо: спасииибо
какой-то: какое-то
различать: различать
развлекательный: развлекательной
круглый: круглые
пара: пару
успеть: успели
полениться: поленитесь
редко: редко
кабачок: кабачок
кардиганшир: кардиганшир
производить: производят
граничить: граничащее
прикус: прикусом
проработать: проработать
европа: европы
добрый: добрым
анонсирование: анонсирования
функция: функциями
охотно: охотно
англия: англии
понимать: понимать
несмотря: несмотря
неплохой: неплохой
сладость: сладости
купить: купить
часто: часто
такса: таксы
помочь: помогите
остаться: останется
мистический: мистическое
именоваться: именуется
энергичный: энергичны энергичная
издревле: издревле
путь: пути
свежий: свежем
сдерживать: сдерживают
голова: голова
бульдог: бульдог
случай: случаях случае
дёшево: дешево
предок: предки предков
аджилить: аджилити
водоотталкивающий: водоотталкивающей
подставка: подставкой
слушаться: слушаться
карди: карди
ухо: уши ушам
подстраховаться: подстрахуйтесь
клуб: клубы
яблоко: яблоки
связывать: связывать
кто-то: кто-то
лоб: лоб
массажный: массажная
следующий: следующий
поощрение: поощрение
наличие: наличие
усвоить: усвоить
дисплазия: дисплазию
низкий: низкой низкое
входить: входить
взять: взял
отменный: отменное
английский: английский
требование: требований
сложиться: сложилось
обман: обман
одноклассник: одноклассники
просить: просить
послушание: послушания
забираться: забираться
приобретать: приобретает
узнать: узнать
масштаб: масштабами
правда: правда
подержать: подержать
таскать: таскать
пембрукшир: пембрукшира
сходство: сходство
сушка: сушку
сварить: сваренными
любознательный: любознательный
овечка: овечек
случайный: случайные
передний: передние
кроме: кроме
последовательность: последовательности
трагедия: трагедии
живот: животе
востребованность: востребованности
частый: чаще почаще
поиск: поиск
направление: направлению
зависимый: зависимы
умудряться: умудряющийся
оптимальный: оптимальный
зуб: зубы зубов
вообще: вообще
очертить: очерченной
полететь: полетел
поражать: поражает
парка: парку
пожитки: пожитки
прародитель: прародителями
травоядный: травоядного
бесхвостый: бесхвостыми
себя: собой
отпуск: отпуске
белые: белые
период: период
ильяс: ильяс
учить: учить
противопоказанный: противопоказано
раскручивание: раскручиванием
амбициозность: амбициозность
лежать: лежать
орех: орехи
правильный: правильный
тигровый: тигровый
независимость: независимость
нос: нос
игра: игры
набивать: набивать
потребность: потребность
обжорк: обжорки
порок: пороки
действовать: действует
пелёнка: пеленка
существующий: существующей
жизнь: жизни жизнь
предпочесть: предпочтет
выход: выхода
гряз: грязе
абсолютно: абсолютно
присмотреться: присмотреться
вытянутый: вытянутым вытянутой
сузить: суженным
воспринимать: воспринимает
пугаться: пугаться
сильно: сильно
приятный: приятной
продукция: продукция
право: право
ребёнок: детьми
роскошный: роскошный
полноценный: полноценными
плечо: плечи
тупой: тупое
отечественный: отечественные
воспитывать: воспитывать
добродушие: добродушие
установление: установление
обучение: обучение
экзема: экземам
эффектный: эффектного
нужно: нужно
массивный: массивная
мимимишность: мимимишности
толчок: толчок
также: также
узкоспециализированный: узкоспециализированная
достаточный: достаточной
настроение: настроение
планировать: планируют
покупка: покупки
шёрстный: шерстный
приличный: приличной
момент: моменты
караться: карается
обаяние: обаяния
уважительный: уважительным
тестировать: тестируют
желание: желания
бульон: бульоне
далёкий: дальше
тарелка: тарелку
дозволить: дозволенного
стоить: стоить стоит
говорить: говоря
доверять: доверяют
изначально: изначально
посадка: посадкой
конкретно: конкретно
смелый: смелые
тёмный: темный
подходить: подходят подходите
поваляться: поваляться
зарабатывать: зарабатывавший
рыбный: рыбным
крайне: крайне
великое: великое
существо: существа
житель: жителям
требовать: требуйте
филе: филе
шуметь: шумят
коротконожка: коротконожка коротконожки
выбор: выбору выборе
жирный: жирная
бегать: бегают
сведение: сведению
заканчиваться: заканчиваются
вполне: вполне
излишний: излишней
стараться: стараться
дневный: дневных
выставлять: выставлять
ряженка: ряженка
занятие: занятие занятия
убрать: убрать
прыжок: прыжки
сила: силой силу
отметить: отмечена
мешать: мешают
батарейка: батарейка
отдельный: отдельных
прочь: прочь
успокоительный: успокоительные
представлять: представляет
полный: полное
легко: легко
склонный: склонна
отметина: отметин
база: базой
лента: ленту
здоровье: здоровье
переходный: переходного
сворачиваться: сворачиваться
столетие: столетий столетия
заговорить: заговорили
подстроиться: подстроиться
пахнуть: пахнущих
котироваться: котировались
интенсивно: интенсивно
добавка: добавки
выглядеть: выглядит
проволока: проволока
ванная: ванную
интернет-форум: интернет-форумов
отличный: отличные
лай: лай
экперт: экперт
обмен: обмен
воздух: воздухе
расчёсывать: расчесывать
отварный: отварной
сдержанность: сдержанность
вырисовываться: вырисовывающимися
сшить: сшейте
субпродукт: субпродуктами
флаффи: флаффи
вакансия: вакансии
недооценить: недооцененной
лошадка: лошадок
покой: покоя
горе-специалист: горе-специалисты
разглядеть: разглядеть
знакомство: знакомство
приписывать: приписывают
план: плане
непонимайка: непонимайкой
ножницеобразный: ножницеобразным
сей: сей сих
достоинство: достоинства
выше: выше
грудной: грудная
маленький: меньше
выстраиваться: выстраивается
единственный: единственное
деревенский: деревенский
вместе: вместе
свойственный: свойственна
разделить: разделить
постный: постным
рисовый: рисовая
большинство: большинство
главный: главная
практически: практически
катаракт: катаракта
рейтинг: рейтинг
сериал: сериала
весь: всеми
дефект: дефекты
палочка: палочками
подписываться: подписывайтесь
компанейский: компанейский
последний: последнюю
самостоятельность: самостоятельности
европейский: европейские
учёба: учебе
запретить: запрещено
очень: очень
обычно: обычно
особый: особой
особенность: особенности особенность
плотный: плотной
купание: купаниями
нагрузка: нагрузки
номер: номерам
умение: умение
конфликт: конфликта
неравномерно: неравномерно
широковатый: широковатым
прятаться: прятавшейся
ответный: ответной
бродячий: бродячих
отмечаться: отмечается
кличка: клички
отреагировать: отреагировать
щётка: щетка
частность: частности
купировать: купировать
развести: разведены
выпечка: выпечка
возможность: возможность
знакомый: знакомо
касаться: касается
слоиться: слоятся
экстремально: экстремально
двушка: двушке
проект: проекте
блеск: блеску
напомнить: напомнят
смешанный: смешанная
отбиться: отбиться
родственник: родственника
труппа: трупп
кг: кг
бок: бок
необходимость: необходимости
населять: населявшим
блестящий: блестящие
кефир: кефир
сидеть: сидеть
темперамент: темперамента
среднее: среднего
изогнутый: изогнутые
хрусталик: хрусталика
линька: линька
бублик: бублик
определять: определяющие
туловище: туловище
графство: графства
низко: низко
исландский: исландских
сказаться: сказалось
колбасный: колбасные
банный: банные
сустав: суставов
обустраивать: обустраивая
забрасывать: забрасывать
ждать: ждет
перегреваться: перегреваться
родитель: родителей
чип: чипом
впечатлять: впечатляет
кормление: кормление
конечность: конечности
ой: ой
устаканиться: устаканится
выводиться: выводившиеся
хлебный: хлебными
миролюбивый: миролюбивы
курочка: курочкой
кавказец: кавказца
местный: местные
рогатый: рогатого
гораздо: гораздо
яйцо: яйцом
г: г
траектория: траектории
юморист: юмористы
диана: диана
