овощ: овощи
раскрытый: раскрытыми
тело: тела тело
разный: разный
средний: средняя среднее
чёрный: черный черная черным
использоваться: используются
сколько: сколько
мужской: мужская
название: название названия
собака: собаку собаками собакой собак собака собакам собаке собаки
процесс: процессом процесс
документ: документами
источник: источник
хороший: лучшим хорошим хороший хорошем хорошее
обсуждение: обсуждения
обитать: обитали обитать
цена: цена
подушечка: подушечки
материал: материалов
самодостаточный: самодостаточным
поголовье: поголовья
чужак: чужаками
перекус: перекусом
сливочный: сливочного
раздражающий: раздражающего
натаска: натаска
миниатюрный: миниатюрные
стоять: стоят
морской: морская
внимательность: внимательность
дисквалифицировать: дисквалифицирующие
остановить: остановить
зато: зато
россия: россия россии
живот: живот животе
миска: миска
обратный: обратная
нюхач: нюхачом
рост: ростом рост
длительный: длительные
размер: размеров
представитель: представителей представителям представители
показатель: показателем показателям
предложение: предложение
шея: шея
параллельный: параллельный
петербургский: петербургская
шерсть: шерсть шерсти шерстью
родственный: родственная
финн: финнов
провести: провести
кинолог: кинологи
рыба: рыба
зверь: зверь зверю зверя зверем зверей
карело-финский: карело-финской
челюсть: челюсти
выступ: выступа
несложно: несложно
воспитание: воспитания воспитание воспитанием
должный: должны должно должна
самый: самая самый самым
тип: тип
вкусный: вкусными
губа: губами губы
питомец: питомцами питомцы питомца питомцем
большой: большой
охотничий: охотничью охотничьих охотничьими
живодёр: живодеров
сохатый: сохатый
нога: ног ноги ногах
выраженный: выражен выраженно
важно: важно
превратиться: превратится
сужение: сужением
жёлтый: желтая
тесный: тесные
способствовать: способствует
больший: большем большая больших
история: история
брать: брать
щенок: щенка щенков щенки щенке
растительный: растительным
поощрять: поощрять
действие: действиям действиями
мыть: моют
настолько: настолько
принять: примите принято
голова: голове голова
тесно: тесно
нередко: нередко
характеристика: характеристика
стоп: стоп
рабочий: рабочая рабочим рабочую
физически: физически
ветеринар: ветеринаром
нос: носу
произойти: произошел
отметка: отметку
подсказка: подсказки
зарождение: зарождения
навык: навыков
порез: порезов
война: войны
повод: поводу повода
испытание: испытаний
яркий: яркой
еда: еды еду едой
оптимальный: оптимальных
подозрительный: подозрительного
порода: породе породы пород породу порода породой
спина: спине спины
дозировать: дозируйте
родоначальник: родоначальником
первый: первой первую первых
чисто: чисто
удаться: удалось
видео: видео
трудоголик: трудоголиком
полноценный: полноценного полноценной
данный: данном данный
разрешаться: разрешается
внимание: внимания
меню: меню
полностью: полностью
находиться: находясь
домашний: домашних домашними домашнего
каждый: каждой
владелец: владельца владельцев
зырянский: зырянскую
соплеменник: соплеменникам соплеменников
древний: древних
нужный: нужна нужны
рацион: рациона
подчинить: подчинить
охотник: охотника охотник охотников охотнику
содержание: содержание содержания
работа: работе работы работа работу
пытаться: пытающихся пытаясь
немного: немного
исполниться: исполнилось исполнится
приучать: приучать приучает
основа: основой основу основа
рекомендовать: рекомендуют
изжить: изжили
окрас: окраса окрас
орхидея: орхидея
кстати: кстати
связь: связь
уделять: уделять
точно: точно
различие: различий
квалификация: квалификацию
граница: границу границ
вода: воде
производитель: производителя производителей производители
медвежий: медвежьей медвежьи медвежью медвежья медвежьим медвежьих
прогулка: прогулкам прогулки прогулках
пока: пока
породный: породном
жильё: жилья жилью
собачий: собачьего
собака-лидер: собак-лидеров
невысокий: невысокая
дважды: дважды
преобладание: преобладание
возможность: возможностей возможности возможность
давать: давать
присуждение: присуждения
удалённый: удаленными удаленные
распространяться: распространяться
лидерство: лидерство
причина: причина причине
внешний: внешнее внешний
приём: приемов
подтон: подтоном
бывать: бывают
смотреть: см смотрят
смысл: смысла
фотография: фотографии
карельский: карельской карельские карельских карельским карельская карельскую
агрессивный: агрессивная
работать: работать работающих
уход: уходе уход
бюджет: бюджете
помнить: помните
вариант: вариантов
страдать: страдать
высокий: высокая высокое
тестирование: тестирование
питомник: питомники питомнике
пара: пары пар
собака-охотник: собак-охотников
ориентировочный: ориентировочных
глаз: глаза
обзаводиться: обзаводиться
прийтись: придется пришлось
морда: морды морда
часть: части часть
девочка: девочку
вести: вести
год: года год годов году
предмет: предмет
лайк: лайки лайке лайками лайка лайку
поскольку: поскольку
краткий: краткая
уроженец: уроженцы
радужка: радужка
свой: своими своей
сильный: сильная сильного сильнейшие сильной сильный
любой: любого любые
лайка: лайкой лаек
соседство: соседства
отношение: отношение отношения
жировой: жировую
служба: службами
сородич: сородичей
локация: локации
корсет: корсет
эксперт: экспертов
купать: купать
ранний: раннего
японский: японский
отказываться: отказывайтесь
вконтакте: вконтакте
финляндия: финляндии финляндия
создать: создать
особь: особями особи особей
разведение: разведением
потребовать: потребует
среда: среде
отличительный: отличительная
молодой: молодая
типичный: типичная
ценник: ценник
харизма: харизмой
животное: животных животным животного животное
занимать: занимает
сша: сша
сыр: сыром сыр
характер: характером характер
преследование: преследования
шпиц: шпиц
выбрать: выбрать
кусочек: кусочки
скула: скулы
облик: облик
оба: обеих оба
основать: основана
хотя: хотя
нижний: нижняя
мягкий: мягкое
порядок: порядок
х: х
серьёзный: серьезные
теряться: теряются
менять: менять
конкурент: конкурентами
собственно: собственно
метка: меток
мероприятие: мероприятиях
бедро: бедрах
доминанта: доминанты доминант
опыт: опыта
архангельский: архангельских
мясной: мясном
информация: информация
обладать: обладает обладали
подходить: подходит
друг: друг другом другу
оттенок: оттенков
защитный: защитную
максимально: максимально
карьяланкархукойра: карьяланкархукойра
чутьё: чутье чутьем
сустав: суставы суставов
проводить: проводить
недоверие: недоверие
ребро: ребра
остальной: остальных
выбор: выбор
ниже: ниже
негативно: негативно
лайчатник: лайчатника лайчатники
половина: половины
метод: методы
такой: такое такие такого таким
сложный: сложных
крепкий: крепкие крепкий крепкой
трещинка: трещинки
взаимный: взаимном
польза: пользу пользы
классический: классический
кончик: кончик кончиком
среди: среди
дуга: дуги
это: этим это
колено: колени
посмотреть: посмотреть
подружиться: подружиться
считаться: считается
близкий: близкого
загривок: загривке
подготовка: подготовка
загрязнение: загрязнения
полный: полной
иметь: имейте иметь имеющие имеющих имеют
карелов: карелов
просто: просто
бедренный: бедренная
развитый: развитый
ежедневный: ежедневное
новый: новом
снижать: снижают
фрукт: фрукты
массово: массово
лось: лося
лес: лесу
территория: территории территориях
мощный: мощном
контакт: контакт контакты
добавить: добавьте
волос: волоса
холка: холка холке
вой: воя
происхождение: происхождения
готовый: готовы
пожалуй: пожалуй
задний: задние задней
вид: вида виду виде вид
тщательно: тщательно
дрессировка: дрессировка дрессировки
стандартный: стандартный
время: время
сука: суки сук
плохой: хуже
агрессивность: агрессивность
устроить: устроить
нехватка: нехватка
погром: погромов
выносливый: выносливые
погода: погоду
начать: начали
кость: костей кости костями
другой: другие другими
сила: сила
задолго: задолго
предпочитать: предпочитает
подкормка: подкормки
мера: мере мера
отдельный: отдельные
например: например
несколько: несколько
шустрый: шустрым
разброс: разброс
накладывать: накладывает
потомство: потомство
статья: статья
решение: решений
заниматься: занимайтесь занимаются
учуять: учуять
русско-европейский: русско-европейских русско-европейскими
реклама: реклама
заводчик: заводчиком заводчики
чёрно-белый: черно-белыми
нюанс: нюанс
грызун: грызуны
стоячий: стоячим
весовой: весовых
неукротимый: неукротимое
продавец: продавец
второй: второй
ягода: ягоды
оказаться: оказавшись
получиться: получится
характерный: характерны характерным характерный характерен
нервотрёпка: нервотрепки
обладание: обладание
предоставлять: предоставляет
грубость: грубость
проводиться: проводится
малыш: малыш малышами
интонационный: интонационно
дичь: дичи
выводить: выводили
который: которыми которой которого которая которых которым которые которому который
счистить: счистить
незаметно: незаметно
сайт: сайту
длинный: длиннее длинную
выпуклый: выпуклым
позволять: позволяет
активный: активный
добыча: добыче добычи
решить: решите
полезно: полезно
хвостатый: хвостатые
крупный: крупная крупных крупного крупной крупные
лайфхак: лайфхак
быть: будут
этот: эта
лишь: лишь
медведь: медведей медведя
бескомпромиссный: бескомпромиссный
прилагать: прилагать
опытный: опытные опытных
погоня: погоней
сбегать: сбегают
попрощаться: попрощайтесь
экстерьер: экстерьер экстерьера
оболочка: оболочка
адаптировать: адаптировать
форум: форум форуме
наблюдение: наблюдение
печень: печень
специализация: специализацию
конец: конце конец
стесняться: стесняйтесь
подобраться: подобраться
требовать: требуют
увлечь: увлечен увлеченный
лайкам: лайкам
положение: положение
поощрение: поощрении
чёткий: четкую
повседневный: повседневную
описание: описание
начало: начало
заметный: заметным
присущий: присущи
ускорить: ускорить
человеческий: человеческому
скандинавия: скандинавии
приступать: приступать
лопатка: лопатки
свернуть: свернут
белый: белых белого
прогулочный: прогулочные
использовать: используют
карий: карего
однако: однако
кошка: кошках кошки
отличаться: отличаются
закрываться: закрываются
поэтому: поэтому
нежирный: нежирной нежирное
прорисовать: прорисована
копирование: копирование
дружелюбный: дружелюбная
предлагаться: предлагаются
активность: активность
сосредоточить: сосредоточена
нападать: нападать
воспитывать: воспитывайте
осматривать: осматривайте
дружелюбность: дружелюбность
нарушение: нарушении
побаловать: побаловать
отзыв: отзывах отзывы
переходить: переходить
карелия: карелии
масса: массе массой
шум: шум
отчётливый: отчетливые
широкий: широкий широкая широком
висячий: висячие
упрямый: упрямым упрямых
конфликтный: конфликтны
поиск: поиску поиск поиска
взгляд: взгляду
кисломолочка: кисломолочкой
посоветоваться: посоветоваться
допустимый: допустимо
учиться: учится
щенок-мальчик: щенков-мальчиков
назад: назад
почему: почему
выследить: выследить
сеть: сети
трубчатый: трубчатая
дом: дома доме
отпугивание: отпугивания
мочь: могут мог можете
локоть: локти
влияние: влияния
клещ: клещей
сарай: сарае
особый: особого особый
воссоздать: воссозданных
видеть: видеть
рел: рел
объявление: объявления
делать: делайте делать
голубой: голубые
основной: основные основной
жёсткость: жесткость
действовать: действовать
элементарно: элементарно
какой: каким
интеллект: интеллект
охранный: охранные
вес: вес
сторожевой: сторожевой
пошутить: пошутить
берлога: берлог
простой: попроще
именно: именно
плотный: плотными
разводить: разводят разводить
закруглить: закругленный
влажный: влажной
подопечный: подопечный
составлять: составлять
затискивание: затискивание
питаться: питающимся
линия: линия
полустоячий: полустоячие
страна: страны странах страна
пёс: пес
стать: стать
сезон: сезонами сезон
приостановить: приостановить
цвет: цвета
витаминно-минеральный: витаминно-минеральные
маршрут: маршруты
полотно: полотно полотном
натаскивать: натаскивайте
зависимость: зависимости
опустить: опущенные
кура: куры
вещество: веществ
подход: подход
система: системе
принимать: принимать
дополнять: дополняют
слегка: слегка
опасный: опасных
закрытый: закрытом
шпицеподобный: шпицеподобный
посторонний: посторонним
внутренний: внутренние
фото: фото
питание: питание
бобовый: бобовых
маленький: маленького маленькие
крепыш: крепыш
потреблять: потреблять
искать: ищете ищите
заноза: заноз
два: две
будущий: будущий
яндекс: яндекс
техника: техники техника
угроза: угрозами
указываться: указывается
вперёд: вперед
хотеть: хотите
тактильный: тактильный
крупногабаритный: крупногабаритной
череп: череп
объёмный: объемную
дикий: диким
лапа: лапы лап
боков: боков
угол: углами
журнал: журнал
бурый: бурым
высота: высота
спутать: спутать
состояние: состоянию
ветреный: ветреную
постав: постав
стараться: старались
спинка: спинкой
нянька: няньки
болезнь: болезни
четвероногий: четвероногим четвероногий
крутость: крутости
угодный: угодно
обоняние: обоняние
помогать: помогают
либо: либо
активно: активно
сырой: сырыми сырых
охота: охоте охота охоты охотой охоту
объятие: объятиях
поверхностный: поверхностные
вольерно-подсадный: вольерно-подсадной
дисквалификация: дисквалификации
условие: условиям условиях
пусть: пусть
слушаться: слушаются
парнокопытный: парнокопытное
кобель: кобели кобелей кобель
скакательный: скакательные
диплом: дипломы
взросление: взросления
помета: помете помета
этап: этап
перейти: перейти
карел: карелами карелам
реально: реально
из-за: из-за
регулярно: регулярно
главное: главное
тянуться: тянуться
тазобедренный: тазобедренная
максимум: максимум
надёжный: надежный
фурминатор: фурминатор
кабан: кабаном кабана кабану
начинать: начинает начиная
прохождение: прохождение
менее: менее
звучать: звучит
заселение: заселения
обрабатывать: обрабатывайте
успешный: успешна
косточка: косточкой
испачкать: испачканные
отменять: отменял
грудь: груди грудь
отдаление: отдалении
цель: целью цели цель
цепь: цепи
ровный: ровной
съедобный: съедобного
увы: увы
слишком: слишком
одиночество: одиночеству
никто: никто
требоваться: требуется
подрасти: подросшими
развить: развита
отучить: отучить
собранный: собранные
подшёрсток: подшерсток подшерстка
крапчатость: крапчатость
кой: коем
день: день
ровно: ровно
гигиена: гигиена
увлечённость: увлеченность
вольер: вольере
относиться: относятся
самолюбивый: самолюбивы самолюбивым
мускулистый: мускулистая
выиграть: выиграть
передний: передней передних
оценка: оценке
родина: родине
команда: команд команда
мочка: мочка
вычёсывание: вычесывание
работоспособность: работоспособность
отрабатывать: отрабатывать
смыкаться: смыкаясь
слабо: слабо
социализация: социализацией
идти: идет
выйти: выйдет
здоровый: здоровые
компенсироваться: компенсируется
количество: количестве
затянутый: затянутый
стоимость: стоимость
ткань: ткань
особенно: особенно
долгий: долгим
отметина: отметины
аккуратный: аккуратны
желательно: желательно
участие: участию
убрать: уберет
увеличить: увеличенных
выход: выходы
симметрично: симметрично
предельно: предельно
достаточно: достаточно
обязательно: обязательно
современный: современный
мягкость: мягкостью
любить: любите
хозяин: хозяина
ополоснуть: ополоснуть
клетка: клетке
способность: способностей
возраст: возраста
угощать: угощать
кольцо: кольцо
неделя: неделю
куча: кучу
европа: европы
доверие: доверии
орган: органы
двор: двора
популярность: популярность
называть: называемому
понимать: понимать
самосохранение: самосохранения
племенной: племенном
несмотря: несмотря
ходить: ходить
купить: купить
часто: часто
стандарт: стандарте стандарт
склонность: склонность
мечта: мечтой
сверхэнергичный: сверхэнергичная
масло: маслом масла
профиль: профилем
допускаться: допускаются
финский: финских финском
тонкий: тонкими
вывести: выведенная
период: периоды
предать: преданный
интерьер: интерьера
пёсик: песика
предок: предки
задача: задача
попросить: попросить
можно-нельзя: можно-нельзя
яичный: яичный
привлекать: привлекают
ухо: уши
обильный: обильный
категория: категориях
порция: порциях
болевой: болевых
рассчитывать: рассчитывать
искусственно: искусственно
следующий: следующий
дразнить: дразните
сердце: сердце
тест: тест
обработка: обработку
выстрел: выстрел
сфера: сфера
бить: бейте
природный: природную
одноклассник: одноклассники
безжалостный: безжалостный
трата: траты
дисплазия: дисплазия
задиристый: задиристый
правда: правда
привычка: привычку
сходство: сходство
мнение: мнение
свести: свести
случайный: случайные
чётко: четко
кроме: кроме
мясо: мясо
почка: почки
пушистость: пушистостью
исключительный: исключительная
облаивание: облаиванием
покровный: покровного
поразительный: поразительное поразительную
обязательство: обязательства
получить: получить
захват: захватом
зуб: зубы зубов
важный: важные важный
вообще: вообще
крик: криками
полезный: полезны
некоторый: некоторые
мышечный: мышечная мышечный
основный: основная
белые: белые
ваш: вашем ваша
одёжка: одежками
учить: учить
ушной: ушным ушное
калория: калорий
явление: явление
короткий: короткая
сторож: сторожа
обманывать: обманывайте
сделать: сделано
натаскивание: натаскивания
присмотреться: присмотритесь
потребность: потребность
периодически: периодически
влиять: влияет
порок: пороки
главный: главными главная
играть: играющих
уметь: умеет
дипломировать: дипломированных
хвост: хвостами хвоста хвост
птичий: птичья
расход: расходов
заканчиваться: заканчивается
овчарка: овчарка
они: ними
стандартизация: стандартизацию
сильно: сильно
едва: едва
ребёнок: детьми
план: планах
постоянный: постоянные постоянное постоянная
уменьшить: уменьшить
затем: затем
пространство: пространства
азартный: азартный
запах: запаха
российский: российских
выдающийся: выдающихся
изгиб: изгибом
обучение: обучение
задержать: задержать
относительно: относительно
нужно: нужно
мимимишность: мимимишности
неприхотливый: неприхотливые
также: также
пригодиться: пригодятся
умный: умная
помочь: поможет помочь
момент: моменты
кмс: кмс
мини-зверинец: мини-зверинец
свидетельствовать: свидетельствует
востребованность: востребованность
нередкий: нередкое
прошлое: прошлого
бульон: бульоне
считать: считать
корпус: корпус
поясница: поясница
смазка: смазку
маремма-абруццкий: маремма-абруццкая
заводить: заводят
умеренно: умеренно
огородить: огороженного
лёгкий: легкие
изначально: изначально
высоко: высоко
выставочный: выставочную
ранее: ранее
путь: путей
отварный: отварном
пернатый: пернатые
крайне: крайне
выстраиваться: выстраиваться
стоить: стоит
экспортироваться: экспортировались
естественный: естественной
женщина-хозяйка: женщин-хозяек
ласка: ласку лаской
северный: северной
загородный: загородное
ножницеобразный: ножницеобразный
квартирный: квартирного
квартира: квартиры
вполне: вполне
разделять: разделять
добычливый: добычлива
нуждаться: нуждается
недолго: недолго
невозможно: невозможно
чутьистый: чутьистого
верхний: верхняя
свежий: свежие
своевременно: своевременно
умение: умения
качество: качества
участок: участках
обнаружить: обнаружит
различаться: различаться
потенциал: потенциале
каша: каши
сохраняться: сохранялась
набор: набором
клан: клана
использование: использование
легко: легко
хрящ: хрящей
отвести: отведены
немецкий: немецкая
лента: ленту
здоровье: здоровье
тряпка: тряпкой
выходить: выходите выходить
решительный: решительным
встреча: встреч
пора: порах пор
руководство: руководство
деструктивный: деструктивно
произвести: произвести
подобрать: подобрана
недокус: недокусом
выглядеть: выглядит
ходовой: ходовому
слушайте: слушайте
наклонный: наклонные
отличный: отличные
желток: желток
лай: лай
вестись: ведется
обмен: обмен
справиться: справится
разновидность: разновидность
возможный: возможна
избегать: избегать
регулярный: регулярная
вакансия: вакансии
выезжать: выезжать
уничтожать: уничтожать
осознанно: осознанно
прикус: прикус
незнакомец: незнакомцев
достаточный: достаточного
управлять: управляйте
покусывание: покусыванием
начинаться: начинается
постоянно: постоянно
верховодить: верховодить
путать: путать
русско-финский: русско-финской
выше: выше
единственный: единственное
природоохранный: природоохранными
экспрессия: экспрессия
изучать: изучать
столетие: столетия
простить: простит
воля: воле
пройти: пройти
большинство: большинство большинства
тёплый: теплой
практически: практически
рейтинг: рейтинг
антисептик: антисептиками
дефект: дефекты
знак: знак
смахивать: смахивают
подписываться: подписывайтесь
ранка: ранки
проблема: проблемой
соответствующий: соответствующего
присутствие: присутствие
свод: сводом
дополнение: дополнение
сверхразвитой: сверхразвитым
прибегать: прибегают
расстояние: расстояния
запретить: запрещено
млекопитающее: млекопитающих
очень: очень
обычно: обычно
ставиться: ставится
прохладный: прохладную
наиболее: наиболее
бонус: бонусам
инстинкт: инстинкт
происходить: происходит
кличка: клички
черта: черта
правило: правила
довольно: довольно
держать: держать
крем: кремом
надбровный: надбровные
касаться: касается
уведомлять: уведомляющий
официальный: официальным
взрослый: взрослых
передвигаться: передвигаться
лидер: лидера
проект: проекте
сразу: сразу
круп: крупе
родословный: родословных
сидеть: сидит
кг: кг
злобность: злобность
полгода: полгода
предел: пределе
сей: сих
среднее: среднего
изогнутый: изогнутые
линька: линька
действительно: действительно
низко: низко
плечевой: плечевые
прямой: прямой
отрыв: отрыве
радужный: радужная
развитие: развитию
особенность: особенность
ситуация: ситуации
усилие: усилий
полноценно: полноценно
давно: давно
кормление: кормление
конечность: конечности
свободный: свободное
натуралка: натуралкой
жизнь: жизнь
являться: является
территориальный: территориальных
питательный: питательным
случай: случае
продуктивный: продуктивным
необыкновенно: необыкновенно
встречаться: встречаются
гон: гону
