ясно: ясно
спокойный: спокойного
заметить: заметили
процесс: процессе
овощ: овощи
гарантия: гарантия
формула: формуле
отличать: отличают
дисквалификация: дисквалификация
ситуация: ситуациях ситуацию
тело: тела тело
широко: широко
средний: средняя среднее средних
опыт: опыт
агрессия: агрессия агрессию
здоровый: здоровых
активный: активные активное
выделяться: выделяется
улица: улицам
сколько: сколько
открытый: открытую
энтропия: энтропия
экстерьерный: экстерьерными
название: название названия
роль: роли
застраховать: застраховать застрахованы
прошлое: прошлое
собака: собаку собакой собак собака собаке собаки
примерно: примерно
горный: горной
сухой: сухого сухая
состоять: состоит
хороший: лучшим хорошие хорошими хорошей
справляться: справляются
обсуждение: обсуждения
наследственность: наследственностью
миска: миску
дальнейший: дальнейшую дальнейшем
цена: цена цене
блеск: блеска
генетический: генетические
материал: материалов
удовольствие: удовольствием удовольствие
поголовье: поголовья
бесконечный: бесконечное бесконечные
вредность: вредностями
организация: организации
дыхание: дыхание
альпийский: альпийской
владелец: владельцам владельца владельцев
вымыть: вымыть
пылевой: пылевые
тренировка: тренировками
массаж: массажа
стоять: стоят
морской: морская
дисквалифицировать: дисквалифицирующие
пятно: пятнами пятна пятно
больший: большим
остановить: остановить
холка: холку холке
зато: зато
россия: россия
спортсмен: спортсмены
обратный: обратная
черно-бело-рыжий: черно-бело-рыжим
следующий: следующих
самоочищаться: самоочищаются
представитель: представителей представителя представитель представители
отвлечь: отвлечь
охранник: охранник
занятие: занятий
шея: шея шеи
пример: пример
параллельный: параллельный
стричь: стричь стригут
положительный: положительные
фокстерьер: фокстерьер
раствор: растворами раствором
шерсть: шерсть шерсти шерстью
поверхность: поверхности
относиться: относилась относится относятся
влажный: влажные влажной влажную
крупа: крупа
рыба: рыба
третий: третий
челюсть: челюсти челюстей
помешать: помешают
моляр: моляров
должный: должны должен должно должна
несложно: несложно
воспитание: воспитания воспитание
клубный: клубную
тип: тип типов типом типу типа
говядина: говядина
клуб: клубе клуб
исключение: исключение
энергия: энергию
чёрный: черные черная черного черных черным черной
большой: большой большому
собственный: собственный собственного собственным собственными собственные
тенденция: тенденцией
вальяжно: вальяжно
некоторый: некоторых
часами: часами
равно: равно
спустя: спустя
масть: масти масть
включая: включая
напоминать: напоминавшей
учитывать: учитывайте учитывать
важно: важно
сытость: сытости
пытаться: пытайтесь
обильный: обильного обильная
история: история
брать: брать
созревание: созревания
щенок: щенка щенков щенки щенком щенок
приходить: приходит
век: веках
борозда: борозда
лужайка: лужайка
согревать: согревающая
ринг: ринг
питомец: питомцев питомцу питомец питомцы питомца питомцем
взрослый: взрослый взрослого взрослых
форма: форма форме форму
юный: юного
базовый: базовых
половой: полового
характеристика: характеристика характеристикам
разговорчивый: разговорчивая
поблизости: поблизости
начинающий: начинающим
коррекция: коррекции
выставочный: выставочные выставочных
физически: физически
растворить: растворят
соответствие: соответствии
заводчик: заводчик заводчиков заводчикам
навык: навыков
акита-ин: акита-ину
война: войны
пегий: пегая
кормление: кормлении кормлений кормления кормление
убрать: уберут убрать
коготь: когти
внушительный: внушительный
порода: породе породам породы пород породу порода породой
стать: стала стать
утвердить: утвердили утвержденный
быстро: быстро
сайт: сайте сайту
раз: раза
видео: видео
физический: физическую
настроить: настроен
исчезновение: исчезновения
свисать: свисают свисающий
меню: меню
полностью: полностью
вода: воды воду водой
никакой: никаких
имитация: имитацией
оказывать: оказывают
месячный: месячного
быть: будьте будут
требование: требованию
зоомагазин: зоомагазине
разрешить: разрешенные
интересовать: интересующую
ваш: вашу ваше вашими
аппенцеллер: аппенцеллеров аппенцеллерам аппенцеллер аппенцеллера
содержание: содержание содержания
чужак: чужак
регистрация: регистрация
возрастной: возрастных
составлять: составляет
рубец: рубец
реагировать: реагировать
аппеновый: аппенов
окрас: окраса окрас окрасом
нечто: нечто
услуга: услуги услугами
давать: дает давать дают
аппена: аппен аппена аппены аппенами
указать: указанным
кстати: кстати
он: нему
связь: связь
приподниматься: приподнимаются
посторожить: посторожит
бояться: боятся
приобретение: приобретения
чип: чип
система: система систему
сужение: сужению
данные: данными
разрушительный: разрушительные
домашний: домашние домашней
лоб: лба
открытие: открытий
расслабляться: расслабляться
письменный: письменное
налёт: налет
бедро: бедра
пока: пока
чувство: чувства чувство
от: ото
сводистый: сводистые
полный: полная
выставка: выставок выставки выставке выставкой
грумера: грумера
состояние: состоянии
общество: обществу
белый: белыми белого белой
территория: территорией территории
рвение: рвением
дважды: дважды
тёмно-коричневый: темно-коричневые темно-коричневым темно-коричневая
коричневый: коричневой коричневых коричневого
незнакомый: незнакомых
спортивный: спортивные
предмет: предметы
расчесать: расчесать
заниматься: заниматься занимается
сохранение: сохранение
подтянутый: подтянута
плотно: плотно
он-то: он-то
горло: горло горлом
поле: поле
крупный: крупный
смотреть: см
фотография: фотографии
слёзный: слезные
агрессивный: агрессивная
современный: современные
уход: уходе уход
воспользоваться: воспользуйтесь
период: периода периоды период
знать: знать знаете
общественный: общественный
обладание: обладания
помнить: помните
дать: данной данные
высокий: высокая высоким высокий
питомник: питомники питомников
глаз: глаза глаз
стремиться: стремится
лосьон: лосьоны
район: районе
серьёзный: серьезным
прийтись: придется
наказывать: наказывать
рычание: рычания
недостаток: недостатков недостаток
корм: корм корма
самый: самым самых самые
незначительно: незначительно
приемлемый: приемлемо
серный: серный
сказать: сказать
обожать: обожает обожают
поскольку: поскольку
обучение: обучения обучение
правило: правилам правило правила правил
неизбежный: неизбежны
существо: существо
уплощённый: уплощенный
краткий: краткая
воспринять: воспринят
радужка: радужка
сильный: сильная сильный сильные
отношение: отношение отношений
место: место
сбор: сбора
малыш: малышей малыша
исключительно: исключительно
звено: звено
пшённый: пшенная
расход: расходы
тёмный: темной
сушка: сушкой сушку
эксперт: экспертов
взбивать: взбивать
итоговый: итоговую
шерстинка: шерстинок
выделить: выделено
вконтакте: вконтакте
чуть-чуть: чуть-чуть
рядом: рядом
консервы: консервы
создать: создать
палка: палку
принимать: принимаемых
ярко: ярко
хозяин: хозяин хозяину хозяина
отличный: отличную
короткий: коротким короткие короткая
развитие: развитие
обычный: обычным
размер: размерах
животное: животных животным животного животные животное
работа: работой работы работу
выяснять: выяснять
появление: появления
сыр: сыром
адекватно: адекватно
превосходящий: превосходящий
продемонстрировать: продемонстрирует
выбрать: выбрать
основать: основана
брюки: брюки
хотя: хотя
х: х
обрызгать: обрызгать
внутренний: внутренний
двигаться: движущейся
небольшой: небольшому небольшой
пателла: пателла
закапать: закапайте
смыть: смоют
самостоятельность: самостоятельность
внешний: внешних внешним
менять: менять
выгуливать: выгуливать
везде: везде
который: которую которой которого которая которые
существенно: существенно
эктропий: эктропия
проблема: проблемы проблем
чувствовать: чувствовать
двойной: двойная двойной
швейцарский: швейцарских швейцарским швейцарскому швейцарский
соблюдать: соблюдайте
вид: видов виде
наконец-то: наконец-то
информация: информация информацию
друг: друг другом другу
масса: масса
максимально: максимально
заполнить: заполнит
сустав: суставы суставов
треугольник: треугольник
прогулка: прогулку прогулки прогулках
остальной: остальных остальное
мытьё: мытья
интеллект: интеллекте интеллект интеллектом
похвалить: похвалить
родословный: родословную
окружающий: окружающие
зенненхунд: зенненхунда зенненхундам зенненхунды зенненхунду зенненхунд зенненхундами зенненхундов зенненхундом
поясничный: поясничной
польза: пользу
классический: классический классическое
кончик: кончик кончиком
среди: среди
дом: дом дома доме
племенной: племенной
салфетка: салфетками
лапа: лапах лапы
категорически: категорически
считаться: считается считаются
мыть: мыть
кинологический: кинологическому
любимый: любимой любимым
находиться: находится находился
загрязнение: загрязнения
квартирный: квартирное
трёпка: трепкой
просто: просто
мало: мало
человек: людей людях
развитый: развитый
выливаться: выливаются
игнорировать: игнорирующих
дополнить: дополнены
низкий: низкая низких низком
угостить: угостить
мячик: мячиков
заменить: заменить
являться: являетесь
бернский: бернскому
добавить: добавьте
волос: волоса
альпы: альпах
промежуточный: промежуточное
пастуший: пастушьим пастушье пастушьей пастушью
описать: описан
вырождаться: вырождаться
начальный: начальном
происхождение: происхождения
трепать: трепать
заболевание: заболевания
необходимо: необходимо
невозможность: невозможности
готовый: готовы
первый: первые первое первую первых
исторически: исторически
солидно: солидно
щенячий: щенячью
проявляться: проявляться
подобный: подобное подобными
кобель: кобеля кобели
гончий: гончая
деятельность: деятельность деятельности
дрессировка: дрессировку дрессировка дрессировке дрессировки
терпеть: терпеть
нервный: нервную нервного
время: время времени
недешёвый: недешевое
сука: суки
подозрительный: подозрительное
укладываться: укладывается
агрессивность: агрессивность
добавляться: добавляются
ушной: ушной
день: дней день
достоверный: достоверных
местность: местности
урок: уроки
беспроблемный: беспроблемных
показывать: показывает
переключить: переключив
другой: другие других другими
догадка: догадок
найти: найдете найти
взять: возьмите возьмет
настой: настой
русло: русло
квалификация: квалификаций
променад: променадов
кролик: кролик
характерный: характерна
мера: мере
фирменный: фирменным
пищевой: пищевые
несколько: несколько
сетчатка: сетчатки
энергетический: энергетического
грозить: грозит
личность: личность
называть: называемые
рост: рост
мл: мл
редкость: редкость
производитель: производителями производителей производители
добавочный: добавочную
оценка: оценку оценке
совет: советы
присущий: присущие
прошлый: прошлом
рыжий: рыжего
реклама: реклама
исполниться: исполнится
временной: временное
кардиомиопатия: кардиомиопатии
нюанс: нюанс
вещь: вещам
выкладываться: выкладываются
продавец: продавец
плохой: плохой плохая
полагаться: полагается
выразить: выражена
огородить: огороженной
корочка: корочки
получиться: получится
направить: направить
внутрь: внутрь
привыкнуть: привыкнуть
год: лет год году
куриный: куриные куриное
курица: курица
жаловать: жалуют
утеплить: утепленные
черепной: черепной
округлый: округлым
центр: центрам
победить: победить
дополнительный: дополнительных
понять: понять
полезно: полезно
подсыпать: подсыпайте
экскурсия: экскурсии
социализация: социализация социализации
просвечивать: просвечивать
лишь: лишь
морозов: морозов
вариант: вариант
швейцария: швейцария швейцарии
форум: форум форуме
печень: печень
угроза: угроза угрозой
кормить: кормите кормят
специальный: специальными специальные
атрофия: атрофии
действие: действия
ость: ость
хендлера: хендлера
серый: серого
капля: капли
положение: положение
заводить: заводить
такой: такие такую
внешне: внешне
сезонный: сезонная
гавана: гавана
повод: повода
комочек: комочки
компенсировать: компенсировать
этап: этапе этапах
одна-два: одна-две
один: одна одном
описание: описание
начало: начало
любознательность: любознательность
пространство: пространство
миттельшнауцер: миттельшнауцер
стандарт: стандартом стандарте стандарт
гипотеза: гипотез
лопатка: лопатки
уступать: уступающий
габарит: габаритам габаритов
живность: живности
гречневый: гречневая
однако: однако
заломить: заломленный
искренне: искренне
миссия: миссией миссию
национальный: национальный
выложиться: выложится
поэтому: поэтому
метка: метками метки
копирование: копирование
дружелюбный: дружелюбная
активность: активность
многогранный: многогранная
основание: основания основанием
русский: русская
дружелюбность: дружелюбность
отзыв: отзывах отзыв отзывы
нога: ноги
заключаться: заключается
кошка: кошки кошку
очаровательный: очаровательный
нормальный: нормальным
комплект: комплектом
нереально: нереально
животный: животному
грызть: грызет
шум: шум
натуральный: натуральное
рекорд: рекорды
поиск: поиску поиск
разовый: разовый
принести: принесут
особь: особи особям
процедура: процедуры
официальный: официальном
внушительно: внушительно
прямой: прямая
совпадать: совпадающие
собака-компаньон: собак-компаньонов
лето: летом
почему: почему
решить: решили
кость: кости
работать: работают
настоящий: настоящий
интерес: интерес
сегодняшний: сегодняшний
мочь: могут можете
торговый: торговым
плавный: плавным
заливистый: заливистый
покупатель: покупателям
формат: формата
трение: трения
профессиональный: профессионального профессиональным
линия: линиях линия линий
объявление: объявления
учёба: учебу
медленно: медленно
располагаться: располагаются
густой: густого
сложный: сложный сложным сложная
основной: основные основной
охранный: охранные
многие: многие
средне: средне
вес: вес
относительный: относительную
конец: конец
купать: купают
возраст: возраст возраста
произойти: произошли
нос: носа
разведение: разведение
судья: судьи
желудочек: желудочки
серьёзно: серьезно
отклонение: отклонения
рот: рта
поворчать: поворчать
продолжительность: продолжительность
переводить: переводят
диван: диване
аксессуар: аксессуары
кантон: кантоне
отлично: отлично
излишний: излишняя
пёс: пес
затылочный: затылочный
облегчать: облегчает
выяснение: выяснение
надёжный: надежных
расположить: расположены
смычка: смычка
говорить: говорят
потратить: потрачено
цвет: цвета
расти: растущего
укромный: укромный
зависимость: зависимости
вокруг: вокруг
депигментировать: депигментированная
никак: никак
слегка: слегка
норма: нормам
фото: фото
полуворотник: полуворотника
переходящий: переходящая
сравнивать: сравнивать
идея: идея идеи
маленький: маленького меньше
воля: воли
заодно: заодно
сам: самого самом
яндекс: яндекс
количество: количество
первоклассный: первоклассный
уголок: уголок
обед: обед
обитать: обитают
дело: делом дело деле
свой: свой
вперёд: вперед
хотеть: хотите
побороться: побороться
череп: череп
отличаться: отличающийся
оценить: оценить
энтлебухер: энтлебухеров энтлебухером
журнал: журнал
неделя: недели неделю
четыре: четыре
высота: высота
жевательный: жевательных
делать: делать делают
цепь: цепей
страна: стране страна
клан: клан
разрушение: разрушений
благодарный: благодарен
постав: постав
таковой: таковых
вселенский: вселенское
тот: та тому той
ширина: ширины
покров: покров
болезнь: болезни
целиком: целиком
косо: косо
сэкономить: сэкономить
смешивать: смешивайте
светло-коричневый: светло-коричневая
ищущий: ищущих
отказаться: откажитесь
ухо: ушами уши
вывести: выведена
запросто: запросто
невыпуклый: невыпуклые
либо: либо
продукт: продуктах
начинать: начинать начинал начинайте
комбинезон: комбинезоны
минута: минут
упрямство: упрямство
чёткий: четкая
образ: образом
простой: простых
подопечный: подопечным
нкп: нкп
база: базе базой
исследование: исследования
полезный: полезный полезны полезное
обижать: обижают
скакательный: скакательные
перекус: перекус
прижиматься: прижимаясь
сумма: сумму
следовать: следуйте
жить: живущее
сворачиваться: сворачивается
родиться: род
перейти: перейти
счастие: счастью
необходимый: необходимых
сутки: сутки
разный: разные разных
из-за: из-за
быстрый: быстрее
регулярно: регулярно
кольцевидный: кольцевидная
поведение: поведение
иметься: иметься
пятнышко: пятнышки
прохожий: прохожих
ген: генов
обеспечить: обеспечена
дефект: дефектов дефекты дефектам
тест: тестов
порция: порцию
упаковка: упаковке
потенциал: потенциал потенциала
дорожка: дорожки
увы: увы
отсутствие: отсутствие
ткань: тканью
слишком: слишком
одиночество: одиночеству
дружелюбие: дружелюбие
телохранитель: телохранителя
подшёрсток: подшерсток подшерстка
облегать: облегающие
посадить: посаженным
запрет: запрет запретов
зарегистрировать: зарегистрированных
выдать: выдать
морда: морда
гигиена: гигиена
подросток: подростков
обитание: обитание
интеллектуал-зенненхунд: интеллектуала-зенненхунда
некрупный: некрупные
сдерживаться: сдерживаться
спинка: спинке
вольер: вольере
призыв: призывы
выгул: выгулом выгула
проточина: проточина
прямоугольный: прямоугольного
нагрузка: нагрузок
отводить: отводить
дорого: дорого
птица: птицы
книга: книге
мочка: мочка
воспитанник: воспитанник
значительный: значительную
неплохо: неплохо
разочарование: разочарования
обводка: обводкой
полость: полости
постный: постное
перевозка: перевозку
внимание: внимание
облегчить: облегчить
зубной: зубной
прикус: прикуса
разумеется: разумеется
каждый: каждый
срыв: срыва
глубокий: глубокая
часть: часть
часовой: часовую
стоимость: стоимость
допустимый: допустимый
подбородок: подбородка
сантиметр: сантиметров
телятина: телятина
иначе: иначе
занятый: занят
особенно: особенно
длинный: длинной
строго: строго
симметричный: симметричное
аппенцелля: аппенцелль
довести: довести
очертание: очертания
остеоартроз: остеоартроза
достаточно: достаточно
поддаваться: поддается
обязательно: обязательно
загривок: загривка
типичный: типичных
накануне: накануне
обязать: обязан
документ: документ документов
пара: пару
статус: статусе
группа: группе группы
индейка: индейка
ранний: ранняя
поводок: поводке поводка
охотно: охотно
несмотря: несмотря
купить: купить
любой: любой любом
подпал: подпалом
семья: семье
выступать: выступают
неплохой: неплохие
зона: зоной
позитивность: позитивность
аккумулятор: аккумулятор
переместить: переместить
спина: спина
упоминание: упоминание
предать: преданный
голова: голова
скула: скулам
хозяйка: хозяйкой
профилактический: профилактического
убирать: убирая
недоверчивость: недоверчивость
начать: начал
потребность: потребности потребность
промышленный: промышленный
прежний: прежних
подпасть: подпала
мероприятие: мероприятий
календарь: календарь
сердце: сердце
чистый: чистой
непрерывный: непрерывная
питьевой: питьевую
перечисленный: перечисленные
строгость: строгость
мнение: мнением мнение
одноклассник: одноклассники
скорее: скорее
объединять: объединять
дисплазия: дисплазия
правда: правда
овсяный: овсяная
возможность: возможности
здоровье: здоровья здоровье
коробка: коробки
разворачиваться: разворачиваются
подходить: подходить подходят
чистить: чистить
отдельный: отдельный
грудь: грудь
случайный: случайные
кроме: кроме
мясо: мясо
шоу-особь: шоу-особей
позволить: позволит
почка: почки
сплошной: сплошной
сторожевой: сторожевую сторожевым
приплюсовать: приплюсованы
частый: чаще
общий: общего
слышный: слышно
взгляд: взгляды взглядами
зуб: зубы зубов
густо: густо
смышлёный: смышленых
характер: характер
удалить: удалены
стандартный: стандартное
себя: собой
белые: белые
учить: учить
противопоказанный: противопоказано
шампунь: шампунем
помета: помета
заставить: заставить
многокилометровый: многокилометровые
подозрительность: подозрительность
нести: несу неси
щётка: щеткой
игривый: игривое
сделать: сделано
игра: игры
влиять: влияет
опушить: опушен
порок: пороки
действовать: действует
хвост: хвостами хвоста хвост
недокус: недокус
будка: будке
жизнь: жизни жизнь
занимать: занимать
заканчиваться: заканчивается
идеальный: идеальное
забывать: забывайте
сильно: сильно
полноценный: полноценной полноценным
яйцо: яйцо
ознакомиться: ознакомьтесь
красно-коричневый: красно-коричневым
ребёнок: детьми
право: право
взорвать: взорвать
предупреждающе: предупреждающе
затем: затем
установленный: установленного
собака-растрёпа: собаку-растрепу
российский: российских
премоляр: премоляров
успех: успехи
относительно: относительно
нужно: нужно
мимимишность: мимимишности
отапливать: отапливаемое
также: также
экстерьер: экстерьера
фермерский: фермерским
запросить: запросить
умный: умная
идеал: идеале
мама: мама
покупка: покупки покупке покупка
шёрстный: шерстный
строптивый: строптивым
глицерин: глицерина
цель: цели
момент: моменты
факт: факту фактов
повышенный: повышенная
нежирный: нежирные
бок: боку
удивительный: удивительным
прогуливаться: прогуливаться
гигиенический: гигиеническими
сквозь: сквозь
корпус: корпус
демонстрироваться: демонстрируется
живот: живота
приблизиться: приблизившийся
подыскивать: подыскиваете
обучить: обучить
пересушить: пересушенной
умеренно: умеренно
стоить: стоить стоит
привести: привести приведете
изначально: изначально
высоко: высоко
ранее: ранее
путь: путей
команда: команда
исключительный: исключительный
впоследствии: впоследствии
отварный: отварном
большинство: большинству
уживаться: уживается
клиновидный: клиновидные
крайне: крайне
это: это
калораж: калораж
остевой: остевого
жизненный: жизненное
одинаковый: одинаковую
межсезонье: межсезонье
внешность: внешности
ряженка: ряженка
сородич: сородич
стараться: старайтесь
говяжий: говяжий
качество: качества
различаться: различаться
определённый: определенным
каша: каши
упустить: упущенные
идеально: идеально
лента: ленту
блестящий: блестящего
сочетание: сочетании
последующий: последующий
выглядеть: выглядит
помещение: помещение
упорно: упорно
лай: лай
обследовать: обследованы
график: график
проявить: проявленное
что-либо: что-либо
результат: результата
наследственный: наследственная
заплатить: заплатить
сила: силу
вакансия: вакансии
специалист: специалисты
прыгучий: прыгуча
малый: меньшим
лобный: лобная
обойтись: обойдется
план: плане
тяжёлый: тяжелой
ножницеобразный: ножницеобразным
серповидный: серповидный
голень: голени
выше: выше
сочетаться: сочетаются
мускулистый: мускулистой
клеймо: клеймо
разрядить: разрядить
мускулистость: мускулистость
транспорт: транспорт
взволновать: взволнованной
новость: новость
базироваться: базироваться
распространить: распространенные
всевозможный: всевозможными
неострый: неострая
рисовый: рисовая
лесополоса: лесополоса
тёплый: теплой
главный: главная
практически: практически
рейтинг: рейтинг
отойти: отошли
ряд: ряд
длина: длину
подписываться: подписывайтесь
срываться: срываться
лакомство-зубочистка: лакомства-зубочистки
компактный: компактное
товарищ: товарищ
использовать: использовать
кинолог: кинологом
наскок: наскоки
запретить: запрещено
удалять: удаляйте
очень: очень
обычно: обычно
освежать: освежая
явление: явлением
плотный: плотной
оформление: оформление
исправить: исправить
иметь: имеющим имеющие имеющих имеют
размягчать: размягчающие
наоборот: наоборот
истечение: истечении
круп: крупом
кличка: клички кличку
генофонд: генофонда
довольно: довольно
прежде: прежде
остановка: остановка
список: список
съесть: съела
сельский: сельской
температура: температурах
знакомый: знакомы
касаться: касается
контур: контуру
одновременно: одновременно
преодоление: преодоление
остаться: останутся
сократить: сократить
непослушный: непослушных
важный: важны важный
трюк: трюкам
проект: проекте
сразу: сразу
чистка: чистку
кг: кг
необходимость: необходимости
франк: франков
кефир: кефир
ополаскиваться: ополаскивается
ученик: учеников
среднее: среднего
хождение: хождение
линька: линька
рацион: рацион
требоваться: требуются
рф: рф
плечевой: плечевые
участок: участке
меняться: меняется
особенность: особенность
причём: причем
усилие: усилий
осуществлять: осуществляла
кверху: кверху
бунт: бунта
карточка: карточку
поймать: поймал
бугор: бугор
конечность: конечности
комок: комке
расставить: расставлены
губа: губы
трусливость: трусливость
пожилое: пожилого
молодой: моложе
городской: городским
трехцветной: трехцветная
данный: данную
случай: случай
воронка: воронке
полоса: полоса
угрожать: угрожающий
поедание: поедании
