туалет: туалет
подача: подаче подачу подача
иметь: имели имеет имеющие имеют
процесс: процессе процессу процесса процесс
территориальный: территориальные
выражаться: выражающееся
отличать: отличают
отдавать: отдавайте
противоречить: противоречит
средний: средняя среднее средней
пылесос: пылесосом
пять: пяти
натаска: натаской натаска натаске
внеплановый: внеплановых
таковой: таковые
подбить: подбитой
участвовать: участвовать участвовавшие
сколько: сколько
уходить: уходит
массивность: массивности
миссия: миссия
название: название названия
домой: домой
примерно: примерно
сузить: суженный
собака: собаку собакой собак собака собаке собаки
добычливый: добычливых добычливее
тонкий: тонкое
готовность: готовность готовности
лимонно-белый: лимонно-белая лимонно-белого лимонно-белой
хороший: лучшим хорошим хорошие лучший
прилегание: прилегание
ноздря: ноздри
обсуждение: обсуждения
отношение: отношениях отношение
английский: английских английским английскому английский английские английского
цена: цена
сводистый: сводистыми
удаваться: удается
род: родом
подушечка: подушечки подушечками
плен: плен
материал: материалов
служебный: служебная
удовольствие: удовольствием
натаскивать: натаскивать
запечатлевать: запечатлевать
напрямую: напрямую
племенной: племенными племенных
частый: частом
приказ: приказу
передний: передняя передней
заслужить: заслуженным
собственный: собственных собственный собственного
морской: морская
сторона: стороны сторону
долгий: дольше
дисквалифицировать: дисквалифицирующие
инстинкт: инстинкты инстинкта
утеплить: утеплены
сиба-ин: сиба-ину
поголовье: поголовье
кофейно-пегий: кофейно-пегих
дикий: дикими
холка: холку холке
расчёсывание: расчесывании
россия: россия россии
обратный: обратная
продавать: продающий
получаться: получается
великобритания: великобритании великобритания
легавых-охотник: легавых-охотников
представитель: представителей представителям представитель представители
команда: команду командой команды команда
легавый: легавая легавым легавые легавых легавую легавой
шея: шея
навык: навыка навык
утратить: утратившие
короткий: короткого коротким короткий короткие короткая короткой короткими
компаньон: компаньон компаньона
гарантировать: гарантирует
шерсть: шерсть шерстью
получиться: получившейся
низкий: низкий низкая
вводить: вводить вводят
влажный: влажные
рыба: рыба
качество: качеств качество качества
обитать: обитала обитает
объявиться: объявились
челюсть: челюсти
инстинктивный: инстинктивном
должный: должны должен должно должна
несложно: несложно
потомство: потомства потомство
тип: тип типа
случайно: случайно
стойка: стойки стойке стойку стойкой
энергия: энергию
дупель: дупелю
вельша-корги: вельш-корги
человек: людям человеку человека человек
питомец: питомцами питомцев питомец питомцы питомцам питомца питомцем
крыло: крыло
сера: серу
погоня: погоне
тиран: тирана
масть: масти
нога: ног ноги
учитывать: учитывайте
боровой: боровой
обязательный: обязателен обязательный
важно: важно
лёгкость: легкости
бежать: бежать
пытаться: пытайтесь пытающиеся пытается пытаться
история: история
выполнение: выполнение
щенок: щенка щенков щенки
затмить: затмили
век: веках веке век веков
поощрять: поощряют
настолько: настолько
заворот: заворота
выжить: выжить
ринг: ринг
подстрелить: подстреленной
сообщество: сообществах
трёхмесячный: трехмесячного
голова: голове голову голова
обучение: обучении обучения
гипнотический: гипнотическое
семья: семьи семьей
сеттер: сеттеров
характеристика: характеристика характеристики характеристикам
быть: е будут
практика: практике
выставка: выставках
такой: таком таких такими
помощь: помощью
поздний: позднее поздней
выраженность: выраженности
ветеринар: ветеринаром ветеринары
переквалифицировать: переквалифицировать
гибкий: гибкое
заводчик: заводчик заводчиков заводчика заводчики
год: годы года лет годов
вправо: вправо
голень: голенями
сложиться: сложившегося
коготь: когти
разгар: разгар
порода: породе породы пород породу порода
значит: значит
шустрый: шустрее
спугнуть: спугнуть
осуществлять: осуществлять
двухмесячный: двухмесячного
вклад: вклад
сужаться: сужается
основное: основном
вызов: вызова
незнакомец: незнакомца
уникальный: уникальных
затягиваться: затягиваться
раз: раза
видео: видео
выкручивать: выкручивать
отход: отходами
мячик: мячики
подойти: подойдет подойти
защитить: защитить
данный: данном
разрешаться: разрешается
полностью: полностью
выдаваться: выдается
смысл: смысл
длинный: длинное длинные длинными
подопечный: подопечные подопечных
условие: условии условиях
домашний: домашних домашние домашней домашними домашняя
смелость: смелость
теплолюбивый: теплолюбива теплолюбивым
тело: телу тело
ловкий: ловкие
расстояние: расстояние расстоянии расстояния
обесценивать: обесценивает
владелец: владельца владельцев владельцы владельцами владельцем
площадь: площадь
рисовый: рисовой
привычка: привычка привычки привычку
охотник: охотника охотник охотником
называть: называют
полевой: полевых полевой полевые полевого
акцентировать: акцентируют
содержание: содержание содержания
ген: гены
уважение: уважением
стать: станут стать станет
чистый: чистыми чистой
триколорный: триколорные
мелкий: мелких
работа: работе работы работа работу
ложиться: ложиться
приучать: приучать
участь: участь
голод: голода
традиция: традиция
попытка: попытки
отпасть: отпадет
рекомендовать: рекомендуют
какой-то: какой-то
полуторачасовой: полуторачасовой
запах: запахов запах
путь: путь
окрас: окраса окрас окрасы
обнаружиться: обнаружившиеся
спарывание: спарывание
пруд: прудах
объект: объект
масло: масло маслом
судный: судна
облик: облика облик облику
отпуск: отпуск
американец: американцев
кстати: кстати
связь: связь связи
переносить: переносит переносят
джудить: джуди
подготовить: подготовленный
трусливый: трусливые
невоспитанный: невоспитанный
обостряться: обостряется
выраженный: выраженными
понимание: понимание
каждый: каждыми каждый
кура: кур куры
поведенческий: поведенческих
распространяться: распространяющийся
добавить: добавить добавило добавьте
обученный: обученного
единственный: единственный единственная
мягкий: мягкой мягкие
вредность: вредности
уметь: умеющий
переводиться: переводится
прослеживаться: прослеживается
мастерство: мастерство
пока: пока
шоу-карьера: шоу-карьеру
отлучка: отлучки
антисептик: антисептиком
рабочий: рабочий рабочим рабочих рабочие рабочего
мчаться: мчится
морда: морду морды морда
состояние: состоянии состояния состоянию
мясной: мясная мясными
прямой: прямыми прямой
член: член членов члены
битва: битву
растительный: растительное
лёгкий: легким легкий
дважды: дважды
вольер: вольерах вольер
изогнутый: изогнуты
плюсна: плюснами
завезти: завезли
коричневый: коричневой
эктопаразит: эктопаразитов
жилистый: жилистым
подтверждать: подтверждают
московский: московская московские
заниматься: заниматься занимается
быстрый: быстрый быстрее
кальциевый: кальциевые
старший: старше
плотно: плотно
промышлять: промышляли
приподнять: приподнятой приподняв
уплощённый: уплощенного
проверить: проверить
развивать: развивал
поле: поле поля полям
гигиенический: гигиеническом гигиенических
эффектный: эффектной эффектный
тупоугольный: тупоугольной
смотреть: см
фотография: фотографии
локация: локация
работать: работать работающие
уход: уходе уход
отменять: отменяет
период: периода
прошедшее: прошедшим
борт: борту
столько: столько
неугомонный: неугомонному
помнить: помните
высокий: высокая высокую высокий
питомник: питомники
невероятный: невероятный невероятным
верхний: верхнее верхним верхние
поладить: поладить
глаз: глаза глаз глазами
район: районе
прийтись: придется
самый: самым самыми самое самых самые
часть: части часть
форма: форме формы
остальной: остальными остальных
выложить: выложить
поскольку: поскольку
охотничий: охотничьи охотничьих охотничьим охотничье охотничьей охотничьего
пользоваться: пользуются
необходимость: необходимостью
кульминация: кульминация
краткий: краткая
общий: общую
сквайр: сквайров
сильный: сильная сильное сильным
плотный: плотная плотными плотное
место: место месте
поясница: поясницей поясницы
болотный: болотных
исключительно: исключительно
медаль: медалью
периодичность: периодичность
эксперт: экспертов
японский: японский
факт: факт
коммуницирование: коммуницирования
удаление: удаление
вконтакте: вконтакте
участок: участка
прут: прут прутом
сознание: сознания
пойнтер: пойнтера пойнтер пойнтером пойнтере пойнтерами пойнтеры пойнтеру пойнтеров пойнтерам
ремешок: ремешок
создать: создать
сплошной: сплошные
любимец: любимцев
переход: переход
ласковый: ласковы
тазобедренный: тазобедренных
заходить: заходить
полёт: полету
ярко: ярко
среда: среде
наградить: награждена
немаловажный: немаловажный
развитие: развитие
взяться: взялся
животное: животных животным животного животными животное
старый: старая
честной: честным
одинаково: одинаково
впускать: впускать
сша: сша
прыгать: прыгает
земля: земле
затылочный: затылочным
увеличить: увеличить
сыр: сыром
рождественский: рождественский
преследование: преследования
волос: волос
длина: длины длину
тон: тон
шутить: шутят
размахивание: размахивание
теплолюбивость: теплолюбивость
выбрать: выбрать
приоткрыть: приоткрывшего
кусочек: кусочки
российский: российские российских
грациозность: грациозности
птица: птица птицы
находиться: находящаяся находятся
реанимировать: реанимировать
шёрстный: шерстного
основать: основана
чутьистый: чутьистые
чёрно-белый: черно-белая
хотя: хотя
нижний: нижняя нижними
крепкий: крепкую крепкие крепче крепкая
натура: натуры
охранник: охранника
х: х
искать: ищет
дратхаар: дратхаара дратхаары
сам: сами самого само самом
перо: перьев
сказаться: сказаться
птицелов: птицелов
нависать: нависая
полный: полные
б: б
стимулирование: стимулирования
черпать: черпать
свободно: свободно
выдающийся: выдающееся выдающегося
болото: болото болотах болотам
достижение: достижения
квартира: квартире квартиры
след: следу
мера: меру
информация: информация
обладать: обладает
поимка: поимки
идеальный: идеальной идеальная
подходить: подходит
будка: будка будке будку
клещ: клеща клещей
друг: друг друга
поход: походов
проходить: проходят
максимально: максимально
жир: жир жиров
чутьё: чутье чутья чутьем
палец: пальцами
мочь: могли могут можете
проводить: проводить
спинка: спинка
лес: лес
ребро: ребра
авторитет: авторитет
ниже: ниже
специалист: специалистов специалисты
знать: знает
улететь: улететь
травмирование: травмирования
сдержать: сдержанного
обитание: обитания
конец: концу конца конце конец
перемещение: перемещении
воспринимать: воспринимать
подразумеваться: подразумевается
природный: природной природным
кончик: кончик кончика
предел: пределами
дом: дом дома
указанный: указанном
категорически: категорически
линия: линию линиям линии
это: этим это
пережить: пережила
зуб: зубах зубы
найденов: найденов
считаться: считается считаясь
задавить: задавили
гнат: гнат
кто: кем
развитой: развитые развитыми развиты
любить: любили любят
формально: формально
загрязнение: загрязнения
подвижный: подвижных
потомок: потомками потомка
проходиться: проходиться
просто: просто
забывать: забывать
распускать: распускать
обнаружить: обнаружив
некомфортно: некомфортно
час: часа часов
выход: выходом
сложность: сложность
беспроблемный: беспроблемная
трансформироваться: трансформироваться
выбраться: выбраться
гладкий: гладкий
самостоятельный: самостоятельная
лапа: лапой лапы лап
территория: территории
сука: суками суки сук
заменить: заменить
локоть: локтей
глазной: глазные
выражение: выражение
молодой: молодой молодых
британец: британцы
сторонка: сторонку
происхождение: происхождения
профессиональный: профессиональные профессиональный
необходимо: необходимо
готовый: готовы
первый: первые первую первых
формироваться: формировались формирующейся
феноменальный: феноменальным
удлинённый: удлиненная
задний: задние задних
дверь: дверь
кобель: кобеля кобели кобелей кобелями
подбираться: подбираться
пойнтерист: пойнтеристов пойнтеристы
хвостпрут: хвостпрут
лакомство: лакомство
дрессировка: дрессировка
предплечье: предплечья
стандартный: стандартный
голос: голосом
добавлять: добавляя
время: время времени временем
полагать: полагая
исследовать: исследует
подряд: подряд
агрессивность: агрессивность
остров: острова
юный: юные
день: дней день
наказание: наказания наказание
перемещаться: перемещаться
местность: местности местность
начать: начали
пясть: пясти
блюдо: блюдо
другой: другие других другим
хозяин: хозяином хозяину хозяина
взрослый: взрослого взрослые
ладить: ладить
использовать: используйте
умение: умений умение
приглушить: приглушенном
фенотип: фенотип
избежание: избежание
уверять: уверяют
например: например
несколько: несколько нескольких
сетчатка: сетчатки
превосходно: превосходно
выйти: вышла
рост: рост
отечественный: отечественных отечественные отечественной
вне: вне
прилить: прилили
пригрозить: пригрозить
зарваться: зарвавшихся
уплощаться: уплощаются
предпочитать: предпочитал предпочитают
реклама: реклама
силуэт: силуэта
мясо: мясом
наклон: наклоном
соответственно: соответственно
выписывать: выписывающего выписывавшие
сельский: сельскую
нюанс: нюанс
небольшой: небольшую небольшой
завораживать: завораживающее
своевременный: своевременное
задвигать: задвигать
полагаться: полагается
выносливость: выносливостью
рекомендоваться: рекомендуется
общительный: общительным
бродяжничество: бродяжничеством
воспитание: воспитание
тайм-аут: тайм-аут
контактировать: контактировать
указатель: указатель
перерыв: перерыва
важный: важнее важны важный
малыш: малыш малыши
элемент: элементов
дичь: дичи дичь дичью
шесть: шести
чау-чау: чау-чау
стеснённый: стесненных
располагаться: располагается располагаются располагаться
сайт: сайту
полезно: полезно
социализация: социализация
пульс: пульсе
прощупать: прощупать
кожа: кожа
лишь: лишь
долго: долго
борзая: борзых
вялый: вялый
выводить: выводить
гавкнуть: гавкнуть
роговица: роговицы роговице
очарование: очарование
оболочка: оболочка
форум: форум форуме
стоп: стопом
внутренний: внутреннего внутренняя
предпочтение: предпочтение
раз-другой: раз-другой
хотеть: хотят
подобраться: подобраться
сила: сил силах силу
хендлера: хендлера
тяжело: тяжело
внешне: внешне
внимательный: внимательна
вырываться: вырываться вырывается
балет: балетом
погода: погоды
приклеиться: приклеившиеся
желудок: желудок
подготовительный: подготовительный
ровный: ровные ровной
выезд: выезда выезд
лично: лично
этап: этапе этап
сигнализировать: сигнализировать
гладкошёрстный: гладкошерстных
описание: описание
убираться: убираться
будни: будни
начало: начало начале
добыча: добычу добычи добычей
способный: способным способна способен способны
приход: приход
скрестить: скрестили
отрастать: отрастают
расти: растущим
послушный: послушна послушны
выравнивать: выравнивая
подчиняться: подчиняться
неизбежность: неизбежность
лопатка: лопатки
жест: жестами
однако: однако
искренне: искренне
потяжкий: потяжка потяжки
имидж: имиджа
психика: психики
преданность: преданность
который: которой которого которая которых которым которые которому который
становиться: становится
влево: влево
устраивать: устраивать
пропускать: пропускать
узкоспециализированный: узкоспециализированные
поэтому: поэтому
четыре: четырех
предлагать: предлагают
спасение: спасение
копирование: копирование
дружелюбный: дружелюбная
метр: метров
активность: активность
основание: основания
дружелюбность: дружелюбность
выслеживание: выслеживания
конкурсант: конкурсантам
дальний: дальним
взаимодействовать: взаимодействующий
плавно: плавно
активный: активным
шип: шипов
отзыв: отзывах отзывы
переходить: переходить переходит
бугор: бугром
умный: умное
тримминг: тримминге
староиспанский: староиспанских
кошка: кошки
непромысловый: непромысловых
следовать: следует следовать
способ: способ способом
ценный: ценнее
пёс: псам пес пса
животный: животному
мимо: мимо
шум: шум
широкий: широкий широкая
лимб: лимбе
заметный: заметное
поиск: поиску поиском поиск
задать: заданном
особь: особи особям особей
составлять: составляют составлять
жизнь: жизней жизни
сохранить: сохранили
уровень: уровня уровне
куропатка: куропатка
оранжево-белый: оранжево-белая
отличие: отличие
диплом: диплома дипломы
рамка: рамки
заводной: заводного
допустимый: допустимо допустимый
импорт: импорт
испанский: испанских
породный: породные
нерешительность: нерешительности
назад: назад
международный: международные
зарубежный: зарубежные
импортировать: импортированными
интерес: интерес
костистый: костистые
минимум: минимум
игра: играх
делать: делал делать делает
движение: движением движения движении движению движений
плавный: плавным
возраст: возрастом возраста
сдержанный: сдержанным
отселять: отселять
звать: зову
утонченность: утонченности
полно: полно
видеть: видеть
творог: творог
трофей: трофеями трофей
целое: целом
объявление: объявления
сделать: сделать сделав сделали сделано сделает
постёгивать: постегивать
основной: основные
впадина: впадину
публика: публикой
интеллект: интеллект
охранный: охранные
многие: многие
средне: средне
негативный: негативное
вес: вес
спина: спину спины
охотиться: охотиться охотится
гречневый: гречневой
пернатый: пернатой пернатых
утка: утки уткой
потчевать: потчевать
никуда: никуда
приучить: приучить
указательный: указательными
гармоничный: гармоничный
по-настоящему: по-настоящему
тереться: трется
причина: причине
именно: именно
йод: йодом
котейка: котейку
грамотно: грамотно
улица: улице
пойнтер-флегматик: пойнтеры-флегматики
правильный: правильнее
продолжительность: продолжительность продолжительности
закруглить: закругленный
интеллигентный: интеллигентные
воспитывать: воспитывают воспитывающая
элегантность: элегантности
владение: владений
положение: положении
чёрный: черных
два: двумя двух
мышца: мышцами
британский: британские британского
пересекать: пересекая
конечный: конечного
полотно: полотно полотнах
зависимость: зависимости
осень: осенью
результат: результате результата
диагностировать: диагностируют
подход: подход
трудиться: трудиться
сук: сучьев
утром: утром
принимать: принимать принимает принимают
домочадец: домочадцами
слегка: слегка
никак: никак
тот: те та тому
заглядывать: заглядывая
печатный: печатных
размашистый: размашисто
полуторамесячный: полуторамесячный
фото: фото
экстерьерный: экстерьерных
толчок: толчком
ненавистный: ненавистной
сходить: сходить
питание: питание
поучаствовать: поучаствует
будущий: будущий
яндекс: яндекс
количество: количество
спокойный: спокойное
реагировать: реагирующие
экзекуция: экзекуцию
терпеливый: терпеливым терпеливы
ножницы: ножницы
свой: свой своего своих
вперёд: вперед
череп: череп
результативность: результативность
разный: разной
оценить: оценить
характерный: характерно характерен
обучать: обучают
сословие: сословия
сиюминутный: сиюминутных
навязать: навязать
стараться: стараются
журнал: журнал
эксперимент: экспериментов
нагонка: нагонки
гончий: гончей
популярный: популярное популярных
высота: высота
загривок: загривок
эстетика: эстетике
советский: советские советских
стиль: стиль
затопление: затопление
привязь: привязи
выносливый: выносливая
постав: постав
внешний: внешним
обработать: обработать обработав
кратковременный: кратковременными
упражнение: упражнение
порядок: порядка
пробегать: пробегающую
болезнь: болезни
джунгли: джунгли
изредка: изредка
здоровый: здоровым здоровую
кормить: кормят кормить
один: одной
крупно: крупно
четвероногий: четвероногим
неадекватно: неадекватно
веник: веником
либо: либо
штат: штатах
ряд: ряду
улавливать: улавливает
минута: минут
совет: совет
образ: образом
вода: воду водой
предстоящий: предстоящей
охота: охоте охота охоты охотой охоту
простой: проще
формирование: формирование
достигать: достигать
неоткуда: неоткуда
экстерьер: экстерьере
заплыв: заплывы
заработать: заработать
передышка: передышки
подвес: подвеса
применить: применить
разлука: разлуку
пусть: пусть
полезный: полезный
отрабатываться: отрабатывается
весь: всему
перекус: перекус
истинный: истинного
ограничивать: ограничивать
упрямство: упрямства
состязание: состязания
появиться: появится появились
выстричь: выстричь
робость: робости
контактность: контактность
немой: нем
нужный: нужен
родиться: род
исключить: исключит
перейти: перейти
неправильный: неправильное
сутки: сутки суток
из-за: из-за
кровососущий: кровососущее
хозяйский: хозяйских хозяйскому
сорваться: сорваться
горизонтальный: горизонтальную
поведение: поведение
тёмный: темная темный темном
начинать: начинает
прямиком: прямиком
флегматично: флегматично
менее: менее
укус: укуса
переслать: перешли
идти: идут идет идти
пемброк: пемброк
нежирный: нежирным нежирный
дефект: дефектов
белый: белая
вырабатываться: вырабатывается
насекомое: насекомое
откуда: откуда
сочетать: сочетая
шалить: шалит
воспаление: воспаление
требование: требования
организм: организма
легкоатлет: легкоатлетом
вместо: вместо
отказываться: отказывается отказывающиеся
мусор: мусора
обстановка: обстановке
англичанин: англичане
снижаться: снижается
подводка: подводка подводки подводку
европа: европе
одиночество: одиночеству одиночество
последний: последний
обход: обход
требоваться: требуется требовались
собранный: собранные
дикина: дикин
атрофия: атрофия
прогулка: прогулках прогулок
рука: рук руку
гигиена: гигиена
вычленить: вычленить
шаблон: шаблону
выступать: выступать
жильё: жилье
мускулистый: мускулистая мускулистые
стрелка: стрелка
покров: покрова
оценка: оценке
рубль: рублей
сложный: сложнее сложное
мочка: мочка
вечером: вечером
местонахождение: местонахождении
художник: художники
внимание: внимание
настигать: настигать
концентрироваться: концентрируется
прикус: прикуса
разумеется: разумеется
целенаправленно: целенаправленно
ветошь: ветошью
вытягивать: вытягивает
променад: променад
п: п
варить: варят
послушно: послушно
вздёрнутый: вздернутым
разборчивый: разборчив
холерический: холерического
стоимость: стоимость
издание: изданиях
приобрести: приобрести
пучок: пучки
иначе: иначе
особенно: особенно
любопытный: любопытный
жёсткий: жесткая жесткие
морковь: моркови
пол: полом
осмотреть: осмотреть
позывистость: позывистость
нравиться: нравится
достаточно: достаточно
дрессировать: дрессировать
мягко: мягко
каста: касту
повышенный: повышенное
понимать: понимает понимать
ноябрьский: ноябрьских
ход: ходе хода ход
фактор: факторов
белка: белке
предварительный: предварительную
обязать: обязан
пачкаться: пачкается
эталонный: эталонный
пара: пару
показатель: показателям
мышь: мышь
уязвимый: уязвимы
отличаться: отличались
неделя: неделю
возвращение: возвращении
отправляться: отправляясь
двор: двора двором
управление: управления
усиленный: усиленным
ошибаться: ошибается
охотно: охотно
англия: англии
вычленять: вычленяет
поставить: поставили поставленные
ходить: ходить
водоём: водоемов
голодный: голодный
купить: купить
носить: носить
часто: часто
любой: любой
старание: стараниям
тыква: тыквы
трудолюбие: трудолюбием
острый: острых
допускаться: допускаются
вертикально: вертикально
грудной: грудной
предать: преданный
склад: склада
случай: случаях
предок: предки
артистизм: артистизм
степень: степень
отрасти: отросшую
вылазка: вылазки
выбирать: выбирать
ухо: уши
корпус: корпусу корпус
задаток: задатками
испытание: испытания
солнечный: солнечными
сухой: сухих
отвлекать: отвлекающих
деликатес: деликатес
выпасть: выпавшие
гусь: гуси
ориентировать: ориентированы
верность: верность
живой: живой
отработать: отработать
следующий: следующий
наличие: наличие
оказаться: оказалось
потребность: потребностей потребность
клетка: клетки
усвоить: усвоить
обработка: обработку
подобрать: подобранные
успеть: успела
шерстинка: шерстинки
крупа: круп крупой
выстрел: выстрел
плыть: плыть
тянуть: тянуть
характеризовать: характеризуют
разделать: разделанная
одноклассник: одноклассники
кровь: кровь
печеночно-белый: печеночно-белая
даун: даун
попутно: попутно
совершить: совершить
нянька: няньку
экипаж: экипажа
дисплазия: дисплазия дисплазии
правда: правда
скорость: скорость
сходство: сходство
против: против
грудь: грудь
случайный: случайные
кроме: кроме
эффектно: эффектно
сингапур: сингапуре
уделять: уделяют
состоавлять: состоавляет
три: трех
карьер: карьером
держаться: держится
запястье: запястий
участие: участия
опускаться: опускается
подвиг: подвигов
вообще: вообще
известный: известным
куриный: куриное
выделяться: выделяющимися
жительство: жительства
хронический: хроническое
характер: характер
практиковать: практикуют
скучать: скучающий
некоторый: некоторые
оптимальный: оптимальное
отдельный: отдельную отдельных
постараться: постараться
ваш: вашем
эстет: эстетов
глянец: глянцем
продукт: продукт
прислушиваться: прислушиваются
приносить: приносить
ветаптека: ветаптеки
направление: направлении
лежать: лежать
луч: лучами
сторож: сторожа
общение: общении
щётка: щеткой
светло-карий: светло-карей
разнообразный: разнообразными
незначительный: незначительными
нос: нос
привнести: привнести
ранний: раньше
оговорка: оговорка
влиять: влияет
порок: пороки
ушной: ушное
единый: единую
сократиться: сократилось
практический: практической
подготовка: подготовку
позволять: позволяющую
опытный: опытных
бессистемный: бессистемный
платонов: платонов
сильно: сильно
полноценный: полноценной
травля: травлей
посередине: посередине
обивка: обивке
яйцо: яйцо
ребёнок: детьми
слабость: слабости
благодаря: благодаря
минутный: минутные
неутомимый: неутомимым
бракковы: бракков
затем: затем
вид: виде
апортировка: апортировке
обширный: обширным
группа: группы
азартный: азартный
помесить: помеси
проявляться: проявляющееся
снисходительный: снисходительны
успех: успехи
аристократ: аристократу
шоу: шоу
нужно: нужно
мимимишность: мимимишности
вызывать: вызывают
также: также
приусадебный: приусадебного
калачёв: калачев
аналогичный: аналогичным
идеал: идеале
достаточный: достаточной
дворянский: дворянского
момент: моменты момент
артрит: артриту
крупный: крупными крупные
выпуклый: выпуклой
отработка: отработку
овал: овала
ставка: ставку
пройти: пройден
бегать: бегать
желание: желания желаний
считать: считать
уличный: уличной
стандарт: стандарт
нежный: нежные
постоянный: постоянное
волноваться: волноваться
обучить: обучить
бензин: бензином
каша: каша
огородить: огороженного
определять: определять
ежедневный: ежедневных
смешивать: смешивать
встряхивание: встряхиванием
ранее: ранее
потенциальный: потенциальной
уравновешенность: уравновешенность
безоговорочно: безоговорочно
царапина: царапины
крайне: крайне
стоить: стоит
прицельный: прицельный
поднятие: поднятие
укоротить: укоротить
бедро: бедрами
бульдог: бульдогами
филе: филе
проверять: проверяют
щенячий: щенячьего
упоминаться: упоминается
скульптурный: скульптурную
аристократизм: аристократизма
сведение: сведению
элитарность: элитарности
агрессивный: агрессивные
излишний: излишней
челночный: челночного челночному
чумаков: чумаков
посягнуть: посягнет
вязка: вязок
внешность: внешности
бдительный: бдительную
нуждаться: нуждается
параллельный: параллельным
щедро: щедро
убрать: убрать
катер: катера
своевременно: своевременно
говяжий: говяжий
вымереть: вымерли
дерзость: дерзости
предпочесть: предпочесть
сезон: сезон сезона
обусловить: обусловлен
легко: легко
незавидный: незавидной
превратить: превратить
отвести: отведены
идеально: идеально
лента: ленту
свободный: свободными
здоровье: здоровье
содержать: содержали
исчерпываться: исчерпывается
вверх: вверх
сходу: сходу
пора: порах
грешить: грешат
выпускать: выпускать
основательно: основательно
добавка: добавки
прятаться: пряталась
вводиться: вводятся
исключение: исключением
угол: углу
повезти: повезло
выглядеть: выглядит
помещение: помещение
наклонный: наклонные
сидка: сидки
трапеза: трапеза
говорить: говорит
месяц: месяцев
щенок-подхалим: щенка-подхалима
тыльный: тыльной
ркф: ркф
субпродукт: субпродуктами
вакансия: вакансии
обратно: обратно
сторожевой: сторожевая
постоянно: постоянно
план: плане
корректировать: корректировать
португальский: португальских
подниматься: поднимаются
дальнейший: дальнейшем
лишить: лишена
сухожилие: сухожилиями
смазать: смазать
выше: выше
смочить: смоченной
удалять: удаляя
случаться: случается
сливочный: сливочное
вместе: вместе
важность: важности
течение: течение
длительный: длительного
столетие: столетия
кишечник: кишечника
повизгивать: повизгивает
повести: поведет
ощутимо: ощутимо
добыть: добыть
изгиб: изгиб
распространить: распространенные
редкий: редкие
воздух: воздуху
главный: главная
энергичный: энергичнее
цениться: ценится
катаракт: катаракта
полгода: полугода
рейтинг: рейтинг
вернуть: вернуть
мнение: мнению
производитель: производители
подписываться: подписывайтесь
великий: великой
двигаться: движется
произвести: произвел
равномерно: равномерно
уйти: уйдет
означать: означает
источник: источником
окружение: окружении
запретить: запрещено
превращаться: превращаясь
очень: очень
ступень: ступени
обычно: обычно
недаром: недаром
поводок: поводка
распределённый: распределенный
противостоять: противостоять
суперпрофессиональный: суперпрофессиональных
истреблять: истребляли
выполнять: выполнять
демонстрировать: демонстрировавших
мытьё: мытье
толстый: толстый
наоборот: наоборот
предмет: предметов
сотрудничать: сотрудничать
кличка: клички
описывать: описывая
правило: правила
предрасположенность: предрасположенностью
лосьон: лосьоне
фоксхаунд: фоксхаундами
довольно: довольно
держать: держать
исключительный: исключительных
хронометраж: хронометраж
средство: средствами
возможность: возможность
универсальный: универсального
буржуазия: буржуазии
касаться: касается
впереди: впереди
окрасить: окрашена
дело: деле
написать: написано
проект: проекте
добытчик: добытчика
недопустимо: недопустимо
коростель: коростелей
паннус: паннус
повадка: повадки
родословный: родословных родословными
кг: кг
несильно: несильно
городской: городской
блестящий: блестящие
удовлетворить: удовлетворить
задействовать: задействованы
темперамент: темперамента
среднее: среднего
минимальный: минимальная
соблазн: соблазн
линька: линька
ответ: ответ
рацион: рацион
совместный: совместных
параллель: параллелями
страна: страна
шелковистый: шелковистым
запасть: запавшая
безошибочно: безошибочно
радужный: радужная
сустав: суставов
утруждать: утруждать
соседский: соседские
кормление: кормления кормление
причём: причем
проситься: просится
выявлять: выявляют
мария: марии
косой: косые
кверху: кверху
просигнализировать: просигнализировав
попробовать: попробуйте
родитель: родителей
продемонстрировать: продемонстрировали
загибаться: загибается
объединить: объединивший
конечность: конечности
большинство: большинства
хвост: хвост
губа: губы
пушистый: пушистых
элитный: элитных
основный: основных
светлый: светлее
старофранцузский: старофранцузских
недостаток: недостатками
донести: донесите
гораздо: гораздо
менять: меняли
череда: чередой
бег: бег
осмотр: осмотр
потерять: потерявшая
