слабый: слаб
кто-нибудь: кого-нибудь
товар: товар
существование: существование существования
овощ: овощи
ожирение: ожирения
упитанный: упитанным
похожий: похожая
кинолог: кинологов кинологи кинолог
отдавать: отдавайте
тело: тела телу
популярность: популярности
принцип: принципе принципу
бурый: бурыми
агрессия: агрессия
переставать: перестают
расти: растет растут
таковой: таковые
активный: активные активным активных активнее
чёрный: черный
отбор: отбор отбора
сколько: сколько
терять: теряйте
быть: будете е будут
голубеть: голубей
наш: наш
название: название названия
след: следа следу
расслоение: расслоение
примерно: примерно
типичный: типичен
документ: документами
варёный: вареным
сухой: сухого сухая
носитель: носитель
пушнина: пушнины
больший: большими большую большей
хороший: лучшим лучшей лучшего лучший хорошей хорошее
скрещиваться: скрещивались
обсуждение: обсуждения
западный: западно
миска: миску миске миски
оптимально: оптимально
пилотаж: пилотажем
цена: цена
удаваться: удается
универсальный: универсальны
подушечка: подушечки подушечек
генетический: генетические
материал: материалов
природа: природы
пропорциональный: пропорциональном
впадать: впадает впадайте
натаскивать: натаскивать натаскивают
авария: аварий
точный: точный
обличие: обличьем
поведение: поведения поведение
резец: резцов
стоять: стоят
сторона: стороны
дисквалифицировать: дисквалифицирующие
обучаться: обучаются
пробовать: пробовать
инстинкт: инстинкты инстинктов
пятно: пятнами
субпродукт: субпродукты
семейство: семейства
пробежка: пробежки
зато: зато
россия: россия
живот: живот живота
ряд: ряда
обратный: обратная
получаться: получается
учуять: учует
особый: особые особой
радужка: радужки
представитель: представителей представителям представителя представители
предложение: предложение
съесть: съеденной
охранник: охранник охранника
шея: шея шею
волос: волосом волоса
городской: городская городских
стричь: стричь
шерсть: шерсть шерсти шерстью
компаньон: компаньоны
вогульский: вогульские
сибирский: сибирским сибирская
рыба: рыба
зверь: зверь зверя зверем
карело-финский: карело-финской
привыкать: привыкают привыкающая привыкая
челюсть: челюсти
должный: должны должен должна
самый: самая самый самым самых самые
андрей: андрей
мегаполис: мегаполиса
потомство: потомства
взгляд: взгляд
исключение: исключение исключения
соревнование: соревнования
защита: защита
начать: начнет начали
хищник: хищники
уступать: уступают
относиться: относится относятся
питомец: питомцами питомец питомца питомцем
поселить: поселить
месяц: месяц месяцев
граничить: граничащую
свора: своры
вынужденный: вынужденными вынужденная
общение: общения
столь: столь
независимый: независимы
ценный: ценный
нога: ног ногам ноги
отличаться: отличается отличаются
местный: местных
важно: важно
коричневатый: коричневатый
главный: главный главная
способность: способность
душа: душе
моментально: моментально
популярный: популярны
травма: травмы
история: история
дикий: дикой
радость: радости
кто-то: кого-то
щенок: щенка щенков щенки щенок щенку
вместить: вместите
потрудиться: потрудиться
выгул: выгул выгула
успешно: успешно
увлечь: увлеченные
никакой: никакой
выполнять: выполняя
мыть: моют
настолько: настолько
лесополоса: лесополосу
коснуться: коснулся
остяцкий: остяцкие
комплект: комплект
зайти: зашла
даваться: дается
нередко: нередко
помета: пометах помет
характеристика: характеристика
ассоциация: ассоциации
грубый: грубого
рабочий: рабочая рабочим рабочими рабочих рабочие рабочей
такой: таком таких такие такого
руб: руб
помощь: помощью
насытить: насытят
пищевой: пищевых
треть: треть
зарождение: зарождения
купание: купания
следующий: следующие
зонарно-пегий: зонарно-пегий
пол: пола
уверенно: уверенно
выдающийся: выдающимся выдающиеся выдающихся
редкий: редким
болезнь: болезнями
еда: еды едой
коготь: когти
подозрительный: подозрительного
порода: породе породам породы пород породами породу порода породой
унаследовать: унаследовали
приемлемый: приемлемы
змея: змеи
обладать: обладать обладают
палец: пальцы пальцами пальцев палец
популяризация: популяризации
возможный: возможных
быстро: быстро
саблевидный: саблевидный
добавлять: добавляют
ненецкий: ненецких
первый: первой первом первым первый первая
шерешевский: шерешевский
основное: основном
водоём: водоемах
видео: видео
помимо: помимо
полноценный: полноценного
интеллигент: интеллигент
признать: признана
фронтальный: фронтальной
внимание: внимания внимание
меню: меню
отогнать: отогнать
незапамятный: незапамятных
подопечный: подопечные подопечного
месячный: месячного месячных
пёс: псы
гиподинамия: гиподинамия
способный: способно способный способна
вакцинация: вакцинация
выражаться: выражаясь
лысеть: лысеет
нерешительность: нерешительность
настоящий: настоящую настоящий
выбиваться: выбивается
профилактика: профилактикой
щетинистый: щетинистого
команда: командами командам команда
охотник: охотника охотник охотники охотникам охотников
речь: речь
содержание: содержание содержания
стать: станут
девочка: девочка девочки
ярый: ярая
замечательный: замечательно замечательных
важный: важен важный
западно-сибирский: западно-сибирские западно-сибирских западно-сибирской западно-сибирскую западно-сибирская
нагружать: нагружать
испачкаться: испачкалось
разновидность: разновидностей разновидности разновидность
жить: живет
холка: холки холка холке
рельефный: рельефная
путь: путь
раскрутить: раскрученном
предстоять: предстояло
кстати: кстати
территория: территорию территории
появляться: появляться
связь: связь связи
русский: русские
внутрипородный: внутрипородных внутрипородные
уделять: уделять
другой: другую другие других другими
выраженный: выраженная выраженными
одетый: одеты
трещина: трещин
тип: типов типа типы
передний: передним передние
внешность: внешность
открыть: открыло
прижать: прижатые
единственный: единственный
владелец: владельцев
длина: длине длины длина
лидер: лидером лидеров
флегматичный: флегматичные
уточнить: уточните
смазывать: смазывают
сводистый: сводистые
выложиться: выложиться
жилистый: жилистые
жильё: жилья
состояние: состоянии состояния
потерять: потерять
выгуливать: выгуливаемым
подкормка: подкормками
прожить: прожил
год: годах года годам лет год гг
дважды: дважды
интерес: интереса интересы
естественный: естественных естественного естественной
плюсна: плюснами
комфортный: комфортного
расслабиться: расслабиться
сильный: сильных сильны сильный сильными
частенько: частенько
охранно-сторожевой: охранно-сторожевых
эктопаразит: эктопаразитов
придавать: придающую
напоминать: напоминающие
заниматься: заниматься занимались занимающиеся
выставка: выставки выставками
крысарик: крысарик
обычный: обычными обычным
доброжелательность: доброжелательность
уважать: уважают
смотреть: см смотрящими
чистый: чистого
смысл: смысла
превышать: превышает
фотография: фотографии
осматривать: осматривать
агрессивный: агрессивная
работать: работать работают работающие
овчарка: овчарок
уход: уходе уход
голубой: голубой
красно-бурый: красно-бурый
знать: знать знают
медведь: медведем медведя
сравнительный: сравнительной
борьба: борьбу
климат: климат
результат: результат результате
высокий: высокая высшим
особь: особь особи особям особей
отреагировать: отреагирует
питомник: питомники питомниках питомник
верхний: верхнее
неприхотливость: неприхотливость
переносить: переносят
глаз: глаза
собственный: собственном собственными собственной собственное
прийтись: придется пришлось пришелся
наклонить: наклоненной
базовый: базовыми
часть: части частью часть
шоколадный: шоколадный
любопытство: любопытством любопытство
мочь: можем могут
быт: быту
форма: форме форму формы
покровный: покровным
лайк: лайки лайками лайка лайку
русско-европейский: русско-европейской
поскольку: поскольку
ошпарить: ошпаренным
охотничий: охотничьи охотничьих охотничья охотничьем охотничьей охотничьего
отодвигать: отодвигая
необходимость: необходимостью
краткий: краткая
обзавестись: обзавестись
общий: общую общего
врождённый: врожденная врожденный врожденные
любой: любого любую любые любой любыми любым
устанавливать: устанавливая
лайка: лайкой лаек
отношение: отношение отношении отношению отношения
бревно: бревне
отличительный: отличительные отличительная
место: место местом
полный: полную полный
трекер-ошейник: трекер-ошейник
исключительно: исключительно
скучать: скучающая
отметить: отметить
некондиция: некондиция
весь: весь вся всем
сушка: сушкой
локация: локации
игривость: игривость
своеволие: своеволие
эксперт: экспертов
государственный: государственной
заводский: заводским
факт: факт
равный: равная равна
психологический: психологические
экстремальный: экстремальным
неустойчивость: неустойчивости
вконтакте: вконтакте
рассчитывать: рассчитывайте рассчитывать
рядом: рядом
лёгкий: легче легкое
секция: секции секция
версия: версии
возложить: возложили
разведение: разведением
ярко: ярко
срок: срок
хозяин: хозяин хозяином хозяину хозяина
поинтересоваться: поинтересуйтесь
исчезать: исчезающие
животное: животных животным животного животными животные животное
размер: размерах размер размера
корректироваться: корректироваться
мать: мать
одинаково: одинаково
проскакивать: проскакивают
альбинизм: альбинизм
выяснять: выяснять выясняют
появление: появления
увеличить: увеличить
чреватый: чревато
обожать: обожаемого
характер: характером характер
преследование: преследования преследовании преследованием
продемонстрировать: продемонстрирует
выбрать: выбрать выбранная
экземпляр: экземпляров
свисать: свисает
собачник: собачники собачников
бесконечный: бесконечного
метод: методам методов
счёт: счет счету счетов
основать: основана
хотя: хотя
соломенный: соломенную
продукт: продуктов продукты
стандартизация: стандартизации
натура: натуры
суперохотник: суперохотника
х: х
расстояние: расстоянии
злобный: злобного
мягкий: мягкие
вид: видами виде
предпочтительный: предпочтительнее
сельский: сельская
баранка: баранку
четверолапый: четверолапым четверолапых
самостоятельность: самостоятельность самостоятельности
менять: менять
набирать: набирает
звук: звукам
северный: северных
пластина: пластину
свободно: свободно
кокапу: кокапу
очередной: очередная
чувствовать: чувствовать
немецкий: немецких
хорошенько: хорошенько
бедро: бедрах бедрами
эвенкийский: эвенкийских
мера: меру
сырой: сырым
наконец-то: наконец-то
палевый: палевыми
информация: информация
поимка: поимки
идеальный: идеальной
будка: будка будке
друг: друг друга
групповой: групповые
защитный: защитную
акробатический: акробатических
создание: создание
телосложение: телосложения
чутьё: чутье
подстилка: подстилку подстилкой
травмироваться: травмироваться
гребень: гребнем
трижды: трижды
создавать: создавать
лес: лес лесу
азартный: азартной
пегий: пегий
мириться: мириться
окрас: окрас окрасу окрасы
отродье: отродья отродий
обитатель: обитателей
площадка: площадках
вплоть: вплоть
воздух: воздухом
сравнительно: сравнительно
среди: среди
восстанавливать: восстанавливать
число: число числе
добыча: добыча добычи
проживать: проживавших
это: этим это
махровый: махровый
самоуверенный: самоуверенные
проявление: проявлению
длинный: длинные длинный длинными
считаться: считается
пищеварительный: пищеварительную
потерянный: потерянные
неприятность: неприятностями
развитой: развитыми развиты
обучение: обучению обучением
коммуникабельный: коммуникабельная
зырянский: зырянских
цирковой: цирковая
просто: просто
силуэт: силуэту
энергетический: энергетический
мало: мало
избранный: избранных
хватить: хватит
малое: малого
питие: питья
обязать: обязано
добывать: добывать
конец: конца конец
этикет: этикета
промысловик: промысловиков промысловиками
водить: водить
знакомить: знакомить
произойти: произошедшая
отпустить: отпущенный
основа: основами
час: часа
рыжий: рыжий рыжими
покладистый: покладисты
собака: собакой собак собака собакам собаке собаки
малыш: малышам малыши малыша
попытка: попытка
дерево: деревья
тон: тона
выдержать: выдержанным
штанишки: штанишки
женский: женского
зазеваться: зазевавшимся
считать: считают
окружающие: окружающим
плохой: плохое плохой худший
глазной: глазные
подышать: подышать
добавить: добавьте
недопустимый: недопустимого
человек: человеку человека человек человеком
прогулка: прогулки прогулках прогулок
происхождение: происхождения
заболевание: заболевания
профессиональный: профессиональные
резкий: резкий
аптечка: аптечку
необходимо: необходимо
демонстрировать: демонстрируют демонстрирует
уснуть: уснут
деньга: деньги
уральский: уральских уральским
входящий: входящим
неприхотливый: неприхотливая неприхотлива
грумерский: грумерским
задний: задние
пр: пр
депрессия: депрессию
черта: черты чертами черта
дрессировка: дрессировку дрессировка дрессировке дрессировки
стандартный: стандартный стандартных стандартные
время: время времен времени
сука: суки сук
фанат: фанатов
препарат: препаратами
агрессивность: агрессивность
глубокий: глубже глубокая
смена: сменой
суровый: суровый суровым
достижение: достижениями
объёмность: объемность
забросить: заброшен
просмотр: просмотров
элемент: элементы
терпение: терпения
слух: слуха слухом
фенотип: фенотип
избежание: избежание
например: например
несколько: несколько нескольких
своеобразный: своеобразным
зарекомендовать: зарекомендовавшие
враг: враг
рост: рост
мериться: меряются
ответ: ответа ответов ответ
отечественный: отечественных
согласно: согласно
мансийский: мансийские мансийский мансийских
сила: силы силами
добычливость: добычливость добычливости
реклама: реклама
соответственно: соответственно
жизнедеятельность: жизнедеятельности
говядина: говядиной
средний: среднее средний
объёмный: объемным
приятель: приятель
щёлкнуть: щелкнуть
обращать: обращают
выделять: выделяют
использование: использованием
неплохой: неплохим
второй: второй
окд: окд
породный: породными породных породные
оказаться: оказавшись
рекомендоваться: рекомендуется
парк: парк
мочка: мочки мочка
получиться: получится получиться
воспитание: воспитание
явно: явно
безусловно: безусловно
пермский: пермской
дичь: дичи дичь дичью
правильно: правильно
который: которыми котором которых которым которые которому который
пытаться: пытающиеся
сайт: сайту
присматривать: присматривать
свободный: свободного
слышать: слышать
сущность: сущности
округлый: округлым
глист: глистами
дополнительный: дополнительных дополнительную
позволять: позволяет позволяющий
лишний: лишними лишних
реагировать: реагирует реагирующим
пища: пищей
недуг: недугов
сбрасывать: сбрасывать
лишь: лишь
течка: течки
вариант: вариант
домашний: домашними
минус: минус
опытный: опытные
соперничать: соперничать
выводить: выводить выводя
погоня: погоней
экстерьер: экстерьер
треугольный: треугольной треугольного
роговица: роговицы
вкрапление: вкраплениями
иметь: имеющий имело иметь имеют
форум: форум форуме
предпочтение: предпочтение
тест: тесты
подтянутый: подтянутый
белка: белки
запах: запахам запах
начало: начала начало
данный: данный
отшлифовать: отшлифовали
порой: порой
мальчик: мальчики
внешне: внешне
мясо: мяса мясо
эталонный: эталонного
порез: порезы
ровный: ровные
лично: лично
фриз: фризе
помощник: помощникам помощник
серый: серый серыми
значительно: значительно
восстанавливаться: восстанавливаются
подмешивание: подмешивание
добытчик: добытчиков добытчики добытчика
один: одна одной
описание: описание
горизонт: горизонте
убирать: убирать
лай: лая лай лаем
крем: кремами
стандарт: стандартом стандарт
заинтересоваться: заинтересовались
приход: приход
обратить: обратили
серьёзный: серьезный
лопатка: лопатки
предыдущий: предыдущий
продолговатый: продолговатые
ветеринарный: ветеринарными ветеринарную
свернуть: свернут
витаминный: витаминными
стоячий: стоячие
посмотреть: посмотрите
искренне: искренне
пражский: пражский
имидж: имиджа
психика: психики
преданность: преданность
дело: делу делом дело делами деле
дар: дар
обработка: обработка
поэтому: поэтому
идти: шла
интересный: интереснее
четыре: четырех
случай: случаев случае
копирование: копирование
дружелюбный: дружелюбная
короткий: короткий короткие короткая
прекрасно: прекрасно
активность: активность
максимум: максимуму
переутомлять: переутомлять
дружелюбность: дружелюбность
попасть: попали
клиновидный: клиновидная
плавно: плавно
иммунитет: иммунитет
отзыв: отзывах отзывы
колено: коленями
война: войну
антигельминтный: антигельминтными
крупный: крупных крупнее
кошка: кошки кошек
следовать: следует
животный: животному
поясница: поясницы
шум: шум
широкий: широкий широкую
самостоятельный: самостоятельные
висячий: висячие
гав: гав
тратить: тратьте
псовина: псовина псовину
отличие: отличие
диплом: диплома
подсказать: подскажите
местность: местность
кусок: куски
хантыйский: хантыйский хантыйских хантыйские
рассмотрение: рассмотрению
назад: назад
международный: международные
планировать: планируете
оттенок: оттенка оттенок
пожалуйста: пожалуйста
неуправляемый: неуправляемые
лето: летом
пополниться: пополнилась
шелушение: шелушений
слой: слоем
кость: кости
зарубежный: зарубежные
крестец: крестца
отвести: отведенные
дом: дома доме
локоть: локти
любитель: любителя любителей
трофей: трофеями трофеев
привлекательность: привлекательности
баранина: баранины
целое: целом
объявление: объявления
лишить: лишено
старинный: старинным
сделать: сделать сделано
частное: частного
основной: основные
полова: половой
интеллект: интеллект
охранный: охранные
многие: многие
заводчик-одиночка: заводчику-одиночке
сжатие: сжатие
средне: средне
вес: вес
спина: спину
потомок: потомка потомок
план: план плане
возраст: возраст возраста
жилища: жилищу
ежедневно: ежедневно
круповой: круповой
рада: рады
пропустить: пропустить
гуляние: гуляниями
своевременный: своевременная
пристрастие: пристрастий
голова: голову голова
именно: именно
образно: образно
отклонение: отклонения
чрезмерный: чрезмерная
улица: улице
сегодняшний: сегодняшние
отсутствовать: отсутствуют отсутствует
правильный: правильнее правильной
продолжительность: продолжительность
заканчиваться: заканчивающуюся
селение: селениях
таёжный: таежного таежных
перекос: перекос
отлично: отлично
линия: линия
полустоячий: полустоячие
оказываться: оказывается
хребет: хребтом
аппетитный: аппетитный
развитие: развития
основный: основными основных
череп: черепу череп
никак: никак
бороться: бороться
слегка: слегка
дождаться: дождаться
здравствуйте: здравствуйте
сравнить: сравнить
иметься: имеются
фишка: фишка
чистокровный: чистокровную чистокровной
обращаться: обращаться
фото: фото
рабченить: рабченя
м: м
вы: вами
реализовать: реализующая
сустав: суставами суставов
будущий: будущий
готовый: готов
яндекс: яндекс
давать: дают
коврижка: коврижки
разучивание: разучивание
здоровый: здоров здоровым здоровый
свой: свой своего своих свои
нижний: нижнее
кто: кого кому
оставлять: оставлять
стайный: стайный
прямой: прямую прямой
сверхспособность: сверхспособности
запас: запасы
обитать: обитало обитавших
классифицировать: классифицировать
лапа: лапы лап
придирчивый: придирчиво
породистый: породистых
восполнять: восполнять
выразительный: выразительные
соболь: соболя
птица: птицу
двор: дворе
официальный: официальной
журнал: журнал
высота: высота высоты высоту
гонять: гонять
рожать: рожает
выносливый: выносливая
дружба: дружбу
делать: делать делают
особенный: особенное
страна: стране страна
колоритно: колоритно
постав: постав
красный: красная
э: э
русско-финский: русско-финских
предпочитать: предпочитая предпочитают
ведущий: ведущей
еженедельно: еженедельно
ширина: ширины
покров: покров
умный: умной
нерв: нервах
сэкономить: сэкономить
кормить: кормят
выдрессировать: выдрессировать
жуткий: жуткую
совершенно: совершенно
контролировать: контролировать
обоняние: обоняние обоняния
узкий: узкий
либо: либо
помогать: помогают
привить: привитый
начинать: начинать начиная
масштаб: масштабах
поиграть: поиграть
беспощадный: беспощадный
неуправляемость: неуправляемостью
минута: минут
суховатый: суховатого
уживаться: уживаться
упрямство: упрямство
провоцировать: провоцирующая
вязкость: вязкость
какой: какие
овальный: овальной
охота: охоте охота охоты охотой охоту
эффектный: эффектны
интересовать: интересуют
громкий: громкими
неприемлемый: неприемлемо
задать: задать
поднимать: поднимает
развлекать: развлекают
условие: условиям условиях
дешёвый: дешевле
белый: белой белый
богатый: богатую богатый
рассматривать: рассматривать
доверять: доверяйте
проверка: проверка
корпус: корпуса корпус
кобель: кобели кобелей
наставник: наставник
плохо: плохо
ущерб: ущерб
ограничивать: ограничивать
диморфизм: диморфизм
злс: злс
омускуленный: омускуленная
стремительный: стремительная
перейти: перейти
острота: остроту
необходимый: необходимых
зверьё: зверье зверья
сутки: сутки
физический: физические
статус: статус
постный: постные
держатель: держателя
нетипичный: нетипичную
пополнять: пополнять
советский: советских советский
новосибирский: новосибирской
связываться: связываться
уравновесить: уравновешенные
фурминатор: фурминатор
когтерез: когтерезом
прохождение: прохождение
менее: менее
заселение: заселения
тот: тех тому
зависимый: зависимая
жёсткий: жестким
новый: новыми
мазь: мазями
неутомимый: неутомимые
лицо: лиц
удачный: удачных удачный
потенциал: потенциал
требование: требования
отдаление: отдалении
наблюдать: наблюдая
собрат: собратьев
область: область области областей
отсутствие: отсутствие
невероятно: невероятно
слишком: слишком
одиночество: одиночеству
будущее: будущего
уделить: уделите
требоваться: требуется требовались
масса: массу
собранный: собранные
запрет: запрет
кой: коем
посредством: посредством
окраина: окраина
день: день
ровно: ровно
взрослый: взрослая
собачий: собачье
мелкий: мелкие
морда: морда
гигиена: гигиена
присущий: присущая
подросток: подростков
проявляться: проявляющиеся
поймать: пойманной
разнообразить: разнообразят
челюстной: челюстной
подобный: подобные подобных
ваш: ваш ваших
вольер: вольере вольера вольеров вольер
запустить: запустить
какой-то: какие-то
небольшой: небольшие
подключать: подключая
дружески-покровительственно: дружески-покровительственно
оценка: оценке
овладеть: овладела овладеть
поведенческий: поведенческие
бдительность: бдительности
звонкий: звонким звонкий
агрессировать: агрессирует
обрамлять: обрамляет
объединяться: объединялись
сказываться: сказывается
вещь: вещей
излишний: излишне
предъявляться: предъявляются
отрабатывать: отрабатывать отрабатывая
стая: стаи стае
опасность: опасность
правило: правило правила
расхождение: расхождение
игрушка: игрушки
воспаление: воспаления
прикус: прикуса прикусом
трюк: трюков
пренебрегать: пренебрегать
целенаправленно: целенаправленно
крепкий: крепкими крепких крепкого
удмуртский: удмуртских
п: п
выбирать: выбирая
качество: качествах качества
племенной: племенных племенным
стоимость: стоимость
допустимый: допустимый
подойти: подойдут
поле: поля
пучок: пучки
натуральный: натуральных
особенно: особенно
отменный: отменный
желательно: желательно
удовольствие: удовольствие
анастасия: анастасия
бишон: бишон
заветренный: заветренные
делить: делить
надбровье: надбровья
достаточно: достаточно
дрессировать: дрессировать
обязательно: обязательно
повышенный: повышенное
доминировать: доминировать
распространяться: распространяется
круглый: круглые
пара: пару паре
редко: редко
тренировка: тренировки
кровь: кровей
неделя: неделю
так: т
короткийнедостаточный: короткийнедостаточно
лишать: лишать
клещ: клещи
пять: пять
поводок: поводке поводок
вогульско-остяцкий: вогульско-остяцких
универсал: универсал
понимать: понимать
рельефность: рельефностью
несмотря: несмотря
растительный: растительные
купить: купить
часто: часто
помочь: помогите
налетать: налетая
бессмысленно: бессмысленно
товарищ: товарища товарищ
отлавливать: отлавливать
адаптировать: адаптированы
издревле: издревле
что: чему
период: периоды период
непременно: непременно
степень: степень
бедный: беднее
миссия: миссию
ухо: уши
кинологический: кинологические
погодный: погодным
ссср: ссср
яблоко: яблоки
система: системы
функция: функцию
подспорье: подспорьем
подшёрсток: подшерстка
дезинфекция: дезинфекцию
крупа: круп
сантиметр-друга: сантиметр-другой
вечный: вечную
открытый: открытых
мешать: мешающие
свердловский: свердловской
представлять: представляют
одноклассник: одноклассники
соревновательный: соревновательный
квартира: квартиру
попутно: попутно
послушание: послушания
выезд: выезд выезды
узнать: узнать
кусать: кусают
помол: помола
залечивать: залечивать
необыкновенный: необыкновенную
предать: преданных
коса: косой
здоровье: здоровья здоровье
пройти: прошло
заканчивать: заканчивая
зубовналичие: зубовналичие
вертикальный: вертикальными
грудь: грудь
случайный: случайные
кроме: кроме
равносторонний: равностороннего
удивление: удивление
географический: географическому
отстоять: отстоящие
жестоко: жестоко
треугольник: треугольника
нетерпимый: нетерпимы
среднее: среднем
сегодня: сегодня
воротник: воротник
нечего: нечего
регулярный: регулярные
содержимое: содержимое
частый: чаще
поиск: поиск поиска
слышный: слышно
получить: получить
звезда: звезда
зуб: зубы зубов
сочетание: сочетания
вообще: вообще
пропорция: пропорциям
сгладить: сглажена
жительство: жительства
некоторый: некоторые
себя: собой
выглядеть: выглядят выглядит
сибиряк: сибирякам
мастер: мастера
термически: термически
белок: белком
помутнение: помутнение
сторож: сторожа
нормальный: нормального
зрение: зрения
тигровый: тигровый
коллектив: коллективе
независимость: независимость
нос: нос
игра: игры
учесть: учтите
чей: чьих
потребность: потребность
периодически: периодически
порок: пороки
средство: средство
предок: предков
линька: линьки линька
три: тремя
жизнь: жизни
остальной: остальном
абсолютно: абсолютно
забывать: забывайте
безобразничать: безобразничать
собачка: собачка
они: ними
потратить: потраченной
ждать: ждите
сильно: сильно
едва: едва
скакательный: скакательных
право: право
ребёнок: детьми
приземистость: приземистостью
отказаться: отказаться
нанести: нанести
недополучать: недополучающее
видеть: видит
пространство: пространства
светлый: светлый
неугомонный: неугомонным
воспитывать: воспитывать
учитывать: учитывать
сородич: сородичи
переходить: переходит
разговорчивость: разговорчивость
бездомный: бездомных
изоляция: изоляции
нужно: нужно
мимимишность: мимимишности
настойчивость: настойчивость
также: также
продажа: продажи
шёрстный: шерстный
цель: цели цель
момент: моменты момент
окружающий: окружающих
предоставлять: предоставляя
свидетельствовать: свидетельствует
человеческий: человеческого
мощный: мощные
прогуливаться: прогуливаться
ставка: ставку
прочёсывать: прочесывать
желание: желания
побег: побегам
завзятый: завзятых
ход: ходу
заразиться: заразиться
нарисоваться: нарисовалась
детство: детства
голодовка: голодовками
умеренно: умеренно
обрезка: обрезки
развиваться: развивалась
отличный: отличных
эпизодический: эпизодического
царапина: царапины
кисломолочко: кисломолочка
дорогой: дорогая
стоить: стоит
разумно: разумно
сквер: сквер
приложить: приложил
проверять: проверяют
зависеть: зависит
вопрос: вопрос
затягивать: затягивать
тренировочный: тренировочных
реальный: реальная
протестировать: протестировать
разводить: разводить
вполне: вполне
предложить: предложил
перемещение: перемещение
стараться: стараться
угробить: угробят
равнина: равнины
умение: умения умение
модель: моделями
профиль: профиль
труд: трудом
сезон: сезон
каша: каши
салон: салонам
легко: легко
нестандартный: нестандартные
превратить: превратить
привыкнуть: привыкли
подравнивать: подравнивают
лента: ленту
утеплять: утепляющим
потенциальный: потенциальная
порция: порции
мороз: морозы
лоб: лбом
основательно: основательно
утвердить: утверждены
намордник: намордник
бельмо: бельмо
произвести: произвести
уверить: уверены
каждый: каждое
принять: приняли
закон: законы
выходить: выходить
бесполезный: бесполезного
избыточный: избыточная
вакансия: вакансии
разъезжать: разъезжать
специалист: специалисты
образовать: образована
сбежать: сбежать
коми: коми
старый: старому
осень-весна: осень-весна
скачок: скачок
город: города
обойтись: обойдется обойтись
бодрый: бодр
вроде: вроде
выделить: выделить
инструмент: инструментов
плечо: плеч
ножницеобразный: ножницеобразным
темно-карий: темно-карие
обработать: обработанные
сезонный: сезонные
выше: выше
обнаруживаться: обнаруживающийся
увлечься: увлекшись
праздник: праздником
маленький: меньше
сбалансировать: сбалансировать
расцениваться: расценивается
ошалеть: ошалевший
сорт: сорта
нежелательный: нежелательных
заводчик: заводчика заводчики
цениться: ценились
занятие: занятия
бешенство: бешенства
чересчур: чересчур
изучать: изучать
столетие: столетия
ещ: ещ
добыть: добыть
посадить: посажены
корм: корма
кабан: кабана
тратиться: тратится
бигль: бигль
спортсмен: спортсменов
дедовский: дедовским
практически: практически
рейтинг: рейтинг
дефект: дефекты
проблема: проблем
подписываться: подписывайтесь
зсл: зсл
лесной: лесных
вытянутый: вытянутая
следовательно: следовательно
запретить: запрещено
очень: очень
обычно: обычно
поучиться: поучиться
немало: немало
особенность: особенности особенность
аборигенный: аборигенных
обезжиренный: обезжиренная
исправить: исправить
тапочки: тапочек
наиболее: наиболее
муштровать: муштруйте
бродячий: бродячих
кличка: клички
деление: делении
генофонд: генофонда
довольно: довольно
низкокачественный: низкокачественные
частность: частности
концерт: концертами
прежде: прежде
привычный: привычной
список: список
возможность: возможность
метис: метисов
лобанов: лобанов
удалённый: удаленном
завтра: завтра
знакомый: знакомы
касаться: касается
аутсайдер: аутсайдеров
окрасить: окрашена
четвероногий: четвероногого
группа: группу
многочисленный: многочисленная
исстари: исстари
запретительный: запретительным
вырастить: вырастить
проект: проекте
сразу: сразу
мочевыделительный: мочевыделительную
склонный: склонны
кг: кг
бок: бок
насколько: насколько
потеря: потеря
тресковый: тресковых
ученик: учеников
хождение: хождение
пропадать: пропадают
разрушительный: разрушительна
собственность: собственности
ошейник: ошейник
рацион: рацион
пиар: пиаром
стоп: стопа
подвижность: подвижность
утеплить: утепленная
гарантия: гарантии
валяться: валяющиеся
котофей: котофеем
совещание: совещание
причём: причем
массивный: массивной
энергия: энергии
родитель: родителей
крайность: крайность
кормление: кормление
конечность: конечности
достучаться: достучаться
плоский: плоским
хвост: хвост
зонарно-рыжий: зонарно-рыжий
масло: масла
закономерный: закономерным
мускулистый: мускулистые
гораздо: гораздо
увлекаться: увлекающиеся
г: г
специальный: специальный
гуща: гуще
хозяйский: хозяйской
