иметь: имели имеет иметь имеют
тримминг: триммингом тримминг
процесс: процессе процесс
обусловить: обусловлено
промыть: промыть
кинолог: кинологов
отдавать: отдавайте
принимать: принимающие принимаешь
покой: покоем
держаться: держатся
широко: широко
отрабатывать: отрабатывайте отрабатывать
смириться: смириться
посторонний: посторонних
сколько: сколько
четверолапый: четверолапого четверолапому
провоцировать: провоцируя
название: название названия названию
кинологический: кинологический
добавка: добавок
собака: собаку собак собака собаке собаки
состоять: состоит
приятный: приятный
любознательный: любознателен
справляться: справляются
партнёрский: партнерские
обсуждение: обсуждения
другой: другое другие другого других
оставаться: оставаться
агрессия: агрессии
нестабильный: нестабилен
привлечение: привлечением
цена: цена
реальность: реальности
обновляться: обновляется
мелкий: мелкое мелкой мелкого
опробовать: опробовать
материал: материалов
природа: природы природе
удовольствие: удовольствием
эмоция: эмоций
трусость: трусости
расчёска: расческой
мешать: мешающий
поведение: поведения поведении поведению поведение
вить: вить
тренировка: тренировками
плотный: плотного
немногочисленный: немногочисленные немногочисленным
сторона: стороны сторона
долгий: долгого
дисквалифицировать: дисквалифицирующие
обучаться: обучаются
инстинкт: инстинкты
положительный: положительных
пробежка: пробежки
город: городах города
россия: россия
живот: живот
карьера: карьеру
забыть: забудьте
итог: итоге
обратный: обратная
компактный: компактный компактное
получаться: получается
выворот: выворота
начинать: начинают начиная
слабость: слабость
радужка: радужки
представитель: представителей представителям представители
искать: искать ищу
остеопатия: остеопатия
команда: команду команд команды команда
попробовать: попробовать
суслик: суслика
грыжа: грыжа
шея: шея шеи
пример: пример
шерсть: шерсть шерсти шерстью
вводить: вводить
специально: специально
крупа: крупа круп
репа: репой
челюсть: челюсти
должный: должны должен должно
тип: тип типа
вест: вест
догвартс: догвартс
взгляд: взгляд взглядом
отмереть: отмерший отмершие
перемещаться: перемещаются
западный: западное западная
паинька: паиньки
сегодняшний: сегодняшних сегодняшним сегодняшними
относиться: относится относитесь
питомец: питомцами питомцев питомцу питомец питомца питомцем
месяц: месяц месяцы месяцев
полталлох-терьер: полталлох-терьерами
большой: большой
спустя: спустя
равно: равно
отличаться: отличается отличаются
болонка: болонки
важно: важно
держать: держите
расчёсывать: расчесывают расчесывать
скопиться: скопившиеся
умереть: умерли
вест-хайленд-уайт-терьер: вест-хайленд-уайт-терьером вест-хайленд-уайт-терьер вест-хайленд-уайт-терьерах вест-хайленд-уайт-терьеры вест-хайленд-уайт-терьеру вест-хайленд-уайт-терьерами вест-хайленд-уайт-терьеров вест-хайленд-уайт-терьера вест-хайленд-уайт-терьерам
моментально: моментально
герцог: герцога герцогу
история: история
трудноуправляемый: трудноуправляемыми
мериться: мериться
радость: радости
эпидермальный: эпидермальная
щенок: щенка щенков щенки щенок щенке
растительный: растительным
завидеть: завидев
задобрить: задобрите
прощупываться: прощупываются
энтузиазм: энтузиазме
выгул: выгул
живить: живя
отбрасывать: отбрасывая
краситель: красители
успешно: успешно
пытливый: пытливым
хрупкость: хрупкостью хрупкость
тестировать: тестируйте
юный: юного
особый: особое особой
голова: голове голову голова
приятно: приятно
чувствовать: чувствуют
валяться: валяться
семья: семьи семье
нередко: нередко
пышный: пышную
воронка: воронки
характеристика: характеристика
стареть: стареющий
меховой: мехового
роскошный: роскошной
исключить: исключите
пиарить: пиарить
выставка: выставках выставки выставке
такой: таком таких такие такому
руб: руб
причина: причинам причиной
прятать: прячьте
переход: переходы
вернуть: верните
беспричинный: беспричинной
пейзаж: пейзажами
еда: еды
замок: замком
значит: значит
отнюдь: отнюдь
где-то: где-то
стриппинговочный: стриппинговочным
считать: считает считанные
быстро: быстро
менять: меняет менять
контактный: контактный
входить: входят
белоснежный: белоснежной белоснежные белоснежный белоснежных
удаться: удалось
видео: видео
записать: записать
электросталь: электросталь
начать: начать начал начав
понравиться: понравившегося
меню: меню
никакой: никаких
кошка: кошка кошки кошек
условие: условии условия
месячный: месячного
улица: улицу улице
домашний: домашних домашнего
каша: кашами
досаждать: досаждать
способный: способно способны
спускать: спускать
каждый: каждой каждым каждые каждый
владелец: владельца владельцев владельцу владельцы
лохматик: лохматик лохматики лохматиков
настоящий: настоящую
экспонировать: экспонировать
рисовый: рисовой
ваш: вашу ваше вашей ваш вашего ваших
рацион: рациона рацион
рыхлый: рыхлой
называть: называют называемую
содержание: содержание содержания
стать: станут стал
собственный: собственного собственным собственной
работа: работе работы
замечательный: замечательно
приучать: приучать
жесткошёрстный: жесткошерстных
плакинг: плакинга
подлинный: подлинная
бок: боках
бархатистый: бархатистой
составлять: составляет составлять
искусственный: искусственные
холка: холки холке
охрана: охрану
кривизна: кривизны
проверить: проверенные
утверждать: утверждают
окрас: окраса окрас окрасов окрасе
предел: пределы
ветеринар: ветеринару ветеринара
основатель: основателем
воздух: воздуха
шубка: шубкой шубки шубок шубке шубка
покупка: покупкой
масло: масло маслом
кстати: кстати
бонус: бонус
изменение: изменение изменения
связь: связь
соревнование: соревнованиях
уделять: уделять
лентяй: лентяй
сформировать: сформировать
клуб: клуб
отмечаться: отмечалось
удивляться: удивляться
состав: составе составы состав
ворчание: ворчанием
внешность: внешность внешности
дурак: дурака
частичка: частички
мягкий: мягкой
старание: старания
незнакомый: незнакомыми
формирование: формировании
скалистый: скалистыми
налёт: налет
предрасположенный: предрасположены
уничтожитель: уничтожителей
пока: пока
фон: фоне
трудновоспитуемый: трудновоспитуемых
жилистый: жилистые
голодный: голодными
оба: обе оба
жильё: жилья жилье
ошейник: ошейнику ошейник
уходить: ухоженный ухоженную
наружу: наружу
аллергия: аллергии аллергия
вязка: вязки
бесцельно: бесцельно
мэлкома: мэлкому
дважды: дважды
структура: структуру
проницательный: проницательный
кислота: кислоты
погода: погода
салюк: салюки
раскрыть: раскрыли
расчесать: расчесать
плотно: плотно
комплекция: комплекцию
казаться: кажутся
поводок: поводку поводка
бесполезный: бесполезное
тримминговать: тримминговать
металлический: металлическими
вестик: вестику вестика вестикам вестики вестиками
превратиться: превратилось
смотреть: см смотрите смотреть
способность: способности
лёгкий: легкий легкой легки
осматривать: осматривать
фотография: фотографии
кисломолочный: кисломолочной
невзирая: невзирая
современный: современные
уход: уходе уход
разрывать: разрывали
период: периода периоды период
развернуть: развернуты
столько: столько
темя: темени
результат: результат результатами
дать: данной даст дайте дай
страдать: страдают
высокий: высокая
питомник: питомники питомникам питомнике питомник
верхний: верхней
сметь: смел
отдел: отделом
имидж: имидж
взрослый: взрослой
выбирать: выбирайте
глаз: глаза глазами
индивидуальный: индивидуальную индивидуальный
человек: человеке человека
тактика: тактику
шотландец: шотландцы шотландец шотландцам
половинка: половинкой
поведенческий: поведенческим
прийтись: придется
корм: корм кормов
составление: составлению
самый: самым самое самую
начаться: началась
выщипывать: выщипывать
морда: морды
ознакомиться: ознакомиться
помета: пометам помете
шотландский: шотландский
собачий: собачьей
вести: вести
малыш: малышу малышей малышами малыши малыша
год: года лет годом году
существовать: существуют
продукция: продукцией
поскольку: поскольку
обучение: обучения обучению
охотничий: охотничьи охотничий
пользоваться: пользуются
необходимость: необходимостью
краткий: краткая
разработать: разработанные
минималистичный: минималистичными
общий: общую
врождённый: врожденная врожденное
дополнительный: дополнительные
наслаждаться: наслаждается
дорога: дороги
ринуться: ринутся
отношение: отношение отношении отношению отношения
место: место
морской: морских
эпоха: эпохи
ввести: ввести
исключительно: исключительно
сородич: сородичей сородичи
нести: несет
эксперт: экспертов
скорректировать: скорректируют
умный: умный умная
выполнить: выполнил
упрямство: упрямством
остаток: остатки
вконтакте: вконтакте
недомыслие: недомыслию
домочадец: домочадцам
проявление: проявление
ремешок: ремешок
угадать: угадайте
образцовый: образцовый
разновидность: разновидности разновидностями
уничтожить: уничтожить
выпяченность: выпяченность
трофей: трофеи
безобидный: безобидные
роль: роль
управляемый: управляемыми
среда: среде
пол: пол
ценник: ценник
размер: размерах размеры
животное: животных животным животного животное
чистить: чистящий чистят
исключение: исключений
выставочный: выставочная выставочную
параметр: параметрам
земля: земле землю
запах: запахами
волос: волос волоса
ножницеобразный: ножницеобразного
выбрать: выбрать
поддержка: поддержку
оценить: оцените
избавляться: избавляться
рабочий: рабочим
основать: основана
сустав: сустава
чёрный: черного
хотя: хотя
прогулка: прогулками прогулку прогулки прогулках прогулке
подтон: подтон подтона
шейкер: шейкера
цветовод: цветоводов
упорный: упорных
редкий: редкой
одном-единственный: одном-единственном
сам: сами самого
век: веке веками
келпи: келпи
непоседа: непоседа
внешний: внешних внешним внешнюю внешняя
становление: становлении
который: которую которое которой которого котором которая которых которые который
существенно: существенно
рыть: рыть
программа: программу
воспитанник: воспитанника
скула: скулах
форма: форму
проблема: проблемы
свободно: свободно
порода: породам породы пород порода породой
павловский: павловский
хорошенько: хорошенько
упрямый: упрямы
страсть: страсть
приключение: приключений
крошеный: крошеную
официально: официально
мера: меру мера
мыслить: мыслит
вычёсываться: вычесываются
два: двум
информация: информация
обладать: обладает
таковой: таковыми
дуга: дугами
экспресс: экспресса
максимально: максимально
пострадать: пострадает
палец: пальцами
проводить: проводить
трижды: трижды
остальной: остальных остальным остальном
специалист: специалистов специалисты
обитатель: обитателей
площадка: площадках площадке
заметный: заметные
источник: источники
хотеться: хотелось
протереть: протереть
сидеть: сидят
среди: среди
дом: дом дома
талант: таланты
собираться: собираюсь
тормозить: тормозит
подушечка: подушечками
линия: линию
полоса: полосу
хайлнд: хайлнд
хороший: лучшего
обеспечить: обеспечены
грудина: грудине
считаться: считается считались
разведение: разведении разведения
брюшина: брюшины
верёвка: веревки
загрязнение: загрязнения
хризантема: хризантемы
ландшафтный: ландшафтными
вручную: вручную
облачать: облачают
причинять: причинять
просто: просто
мало: мало
недуг: недугам
синдром: синдром
добывать: добывать
завиток: завиток
конец: конца конце конец концов
пивная: пивные
пуститься: пуститься
принять: принято
гулять: гуляя
потечь: потеки
утолщаться: утолщается
низкий: низкая низкое
одиночество: одиночеством одиночеству
угостить: угостить
территория: территории
му: му
локоть: локтей
добавить: добавьте
стол: столом
чистка: чистка
попрошайка: попрошайки
проживание: проживание
мусор: мусор
пушистик: пушистика пушистик
умеренный: умеренная
происхождение: происхождения происхождении
благо: благо
стык: стыке
лапка: лапки
зуб: зубьями зубы
заболевание: заболевания заболеваний
гряда: грядами
необходимо: необходимо
готовый: готовы готовым
противостояние: противостояние
первый: первые первое первый первую первых
закат: закатом
одуванчик: одуванчик
пища: пищи
вытаскивать: вытаскивая
терьер: терьер терьеров
частично: частично
собака-компаньон: собаки-компаньоны
какой-нибудь: какой-нибудь какого-нибудь
задний: задние задних
заведомо: заведомо
нейтрализация: нейтрализации
бегом: бегом
виртуозно: виртуозно
ситуация: ситуация
тщательно: тщательно
авторитет: авторитета авторитетом
деятельность: деятельность
высокогорье: высокогорье
дрессировка: дрессировку дрессировка дрессировки
кэмпбелла: кэмпбелла кэмпбеллу
достоинство: достоинство достоинства
время: время времена времени
лохматый: лохматой
сука: суки сук
фанат: фанатов
агрессивность: агрессивность
ушной: ушной ушного
требовать: требует
день: дней день
лоб: лбу
достоверный: достоверных
англ: англ
показывать: показывает
скручивание: скручивание
курица: курицу
одёжка: одежки
хозяин: хозяином хозяина хозяине
просмотр: просмотров
родственник: родственников
внезапный: внезапными
сглаживать: сглаживая
аргайла: аргайла
поставить: поставить
например: например
несколько: несколько нескольким
обнаружиться: обнаружились
следующий: следующим
родина: родиной
сведение: сведений сведению
рост: рост
потомство: потомство
шотландия: шотландия шотландии
стерильный: стерильной
вне: вне
имение: имения
каменный: каменных
уступать: уступающим
оценка: оценку оценке
твёрдый: твердые
реклама: реклама
соответственно: соответственно
исполниться: исполнится
щипать: щиплют
средний: среднее средний
полотно: полотна
украшать: украшающую
использование: использованием
бой: бой
яркий: яркие
фантастический: фантастическим
мускулатура: мускулатурой
свинка: свинок
полагаться: полагается
выраженный: выраженным
очаровательный: очаровательные
вкус: вкус
подчеркнуть: подчеркнуть
диагностировать: диагностирована
часть: частью часть
неисправимый: неисправимый
грядка: грядок
воспитание: воспитание
изваляться: изваляться
собраться: собравшихся соберетесь
захотеться: захочется
прибыль: прибыли
сайт: сайту
родословная: родословной
появление: появлении
чей: чьей чья чьи
нежели: нежели
попонка: попонки
сахарный: сахарный
понять: понять
полезно: полезно
наскок: наскоками
крупный: крупная
быть: будут
отпор: отпор
жить: жившим живут
лишь: лишь
пытаться: пытается
стрижка: стрижка
реагент: реагентами
репутация: репутацией
выводить: выводить выводят
форум: форум форуме
стоп: стопом
предпочтение: предпочтение
протяжение: протяжении
сушка: сушки
нисколько: нисколько
уникальность: уникальность
боль: боль
полковник: полковника полковнику
подвиг: подвиги
полакомиться: полакомиться
игровой: игровую
траншея: траншеи
заводить: заводить
чистота: чистоте чистоты
скоро: скоро
компенсировать: компенсировать
расстёгиваться: расстегивающийся
высокогорный: высокогорный
фриз: фризе
раковина: раковине
шоу-класс: шоу-класса
натаска: натаске
раскапывать: раскапывая
описание: описание
побеситься: побеситься
начало: начало
вестиковый: вестиков
встречаться: встречаться встречаются
таракан: тараканы
посадить: посаженные посажены
агрессивный: агрессивных
гигиена: гигиены гигиена
здоровье: здоровьем здоровье
округлый: округлые
габарит: габаритам
белый: белых белой белый белом
угода: угоду
глубоко: глубоко
гибрид: гибрид
длинный: длинный длинная
однако: однако
похожий: похожим
становиться: становится становятся
поэтому: поэтому
явный: явные
крыса: крысу
препятствия: препятствией
пертёс: пертеса
консультация: консультацию
переключить: переключите
копирование: копирование
дружелюбный: дружелюбная
короткий: короткий короткие короткая
нужда: нужду
промышленный: промышленных
далёкий: подальше
проверка: проверки
активность: активность
дружелюбность: дружелюбность
незнакомец: незнакомцам
побаловать: побаловать
ногинск: ногинск
отзыв: отзывах отзывы
нога: ноги ногу ногах
доминант: доминантов
мел: мела
следовать: следует
физический: физическом
джордж: джорджу джорджа
письменный: письменные
атопический: атопический
шум: шум
надёжный: надежные
широкий: широкий широким широкой
обязать: обязана
предупредить: предупредить
особь: особи особям особей
натуральный: натуральные
особо: особо
коммунальщик: коммунальщиками
отличие: отличие
подсказать: подскажите
желтеть: желтеет
назад: назад
планировать: планируете
пожалуйста: пожалуйста
самозабвенно: самозабвенно
лето: летом
зона: зону
поначалу: поначалу
цвет: цвет
работать: работают
осторожно: осторожно
мочь: могут можете
полемизировать: полемизировать
минимум: минимум
отбеливать: отбеливающий
игра: играх
учебный: учебная
завиваться: завивающаяся
кровать: кровати
гипеурикозурия: гипеурикозурия
всячески: всячески
объявление: объявления
игнорировать: игнорируют
основной: основные
юбочка: юбочку
какой: каким какими
интеллект: интеллект
миниатюрный: миниатюрный миниатюрную миниатюрная
охранный: охранные
тихоня: тихонями
конечность: конечностей конечности
свести: сведенными
средне: средне
вес: вес
гречневый: гречневой
охотиться: охотиться охотится охотились
игривый: игрив
специализироваться: специализировавшийся
длина: длиной длина длину
умильный: умильной
нежелательный: нежелательного
купать: купают
единственный: единственным
линять: линяют
нос: носа нос
именитый: именитым
свой: своим свой свое своего своей своих своему свои
поблажка: поблажек
комнатно-диванный: комнатно-диванных
именно: именно
отклонение: отклонения
стиль: стиле
доверить: доверят
продолжительность: продолжительность
подопечный: подопечный подопечным подопечных подопечного
хомячок: хомячков
член: членов членах
размёт: размет
концентрировать: концентрирует
борный: борной
тыква: тыквой
оттенок: оттенок
подъём: подъем
полка: полку
шампунь: шампунь
окрестить: окрестили
основный: основным основная
слива: сливой
способ: способом
подход: подход
трудиться: трудиться
пройти: прошел
помощь: помощи
слегка: слегка
стимулировать: стимулировавшие стимулировать
тот: те та тому
дополнять: дополняют
здравствуйте: здравствуйте
подойти: подошли
равный: равных
пухлый: пухлыми
норма: нормам
фото: фото
оригинальный: оригинальный
критично: критично
темпераментный: темпераментных
яндекс: яндекс
охапка: охапку
обожать: обожают
тестироваться: тестируются
участие: участие участию
кто: кого
хотеть: хотите
терьерный: терьерной
конфета: конфетой
череп: череп
техника: техника
лапа: лапы
спина: спиной
уровень: уровень
нетипичный: нетипичный
получение: получение
отвести: отведенной
склонный: склонно
журнал: журнал
отличный: отличный отличные
высота: высота
зелень: зелень
минута: минуты
нуждаться: нуждаются
открыться: открылся
стараться: старались
постав: постав
клумба: клумб клумбу
больший: большие
туловище: туловищу туловище
обычный: обычной обычные
пожертвовать: пожертвовать
покров: покров
вакцинация: вакцинацию
болезнь: болезни болезнь
уступка: уступки
записаться: запишитесь
дизайнер: дизайнерами
заводчик: заводчиков заводчикам заводчика заводчики
дирхаунд: дирхаунд
чрезмерно: чрезмерно
палевый: палевых
контролировать: контролировать
терять: теряют терять теряет
моющий: моющие
присутствие: присутствием присутствие
охота: охоте охота охоты
предпочитать: предпочитают
достигать: достигать
интеллектуальный: интеллектуальные
полутора-двухметровый: полутора-двухметровый
отметиться: отметились
парень: парень
керн-терьер: керн-терьер
оценивать: оценивают
молниеносно: молниеносно
мясистый: мясистой
вест-хайленд: вест-хайленда вест-хайленд
зверь: зверя
австралийский: австралийский
желать: желать
голый: голом
кобель: кобели
сваливаться: сваливаются
тигровый: тигровыми
плохо: плохо
глухота: глухота
веста-хайлендова: вест-хайлендов
заметно: заметно
взросление: взросления
пищевой: пищевой
запретить: запретить запрещены запрещено
дело: дело деле
омускуленный: омускуленная
практика: практика
циркуляция: циркуляции
развитой: развитой
являться: являются
перейти: перейти
спровоцировать: спровоцировало спровоцировали
зверьё: зверье
быстрый: быстрее
регулярно: регулярно
запрет: запретом
шумный: шумный
глаз-бусинка: глазами-бусинками
овощ: овощами
маленький: маленькие маленьких меньше
устроить: устройте
менее: менее
незапамятный: незапамятные
охотник: охотники
навязчивость: навязчивостью
идти: идут
шёрстка: шерсткой шерстка
вопрос: вопросу
зелёный: зеленый
краниальный: краниальная
маркий: маркие
откуда: откуда
давать: давайте
во-вторых: во-вторых
потенциал: потенциал
норный: норной
вправе: вправе
отсидеть: отсидел
полина: полина
собрат: собратьев
область: область области
приобретать: приобретать
слишком: слишком
один: одном
уделить: уделите уделить
никто: никто
новаторск: новаторски
расщелина: расщелин
подшёрсток: подшерсток подшерстка
стандарт: стандарта
азартный: азартны
мордочка: мордочка мордочку
выдающийся: выдающимися
ровно: ровно
играть: играют
субординация: субординацию
уэсть: уэсти
розенет-терьер: розенет-терьерами
здоровый: здоровая
бдительность: бдительность
привет: привет
желание: желанием желание
дождь: дождем
небольшой: небольшие
квартирный: квартирных
звонкий: звонким
уникальный: уникальный уникального
враждебность: враждебности
спелый: спелой
горный: горными
гребневой: гребневую
излишний: излишне
сложный: сложнее
мочка: мочка
вычёсывание: вычесывание
пугать: пугать пугая
половина: половину
постный: постное
правило: правило правила правил
декоративный: декоративных
внимание: внимание
зубной: зубной
отработка: отработки
прикус: прикуса прикус
оптимист: оптимист
зависимый: зависим
эдвард: эдварду
любой: любые любой любым
пушистый: пушистые
удалять: удаляют удалять
делегировать: делегировать
копаться: копаться
племенной: племенных
карантин: карантине
средневековье: средневековья
увлажнить: увлажненную
стоимость: стоимость
приобрести: приобрести
петрушка: петрушка
иначе: иначе
любопытный: любопытный
слюна: слюны
душа: душой
желательно: желательно
зверёк: зверька
жёсткий: жесткая жесткого
строго: строго
включать: включать
делить: делить
достаточно: достаточно
мягко: мягко
обязательно: обязательно
ответ: ответов
рисковать: рискуете
повалять: повалять
задорный: задорный
ход: ходе
фактор: факторов
пара: пару
полениться: поленитесь
показатель: показателям
возраст: возраста
качество: качествам качества
сочетаться: сочетается
неделя: неделю
группа: группе группы
мука: мука
скромный: скромным
пять: пять
точнее: точнее
любитель: любителей
несмотря: несмотря
исследователь: исследователи
ходить: ходить
сладость: сладости
купить: купить купите
часто: часто
склонность: склонность
развитие: развитии
проходить: проходит
вертикально: вертикально
стричь: стригут
снаружи: снаружи
гость: гостей
разводить: разводили
рыться: рыться
случай: случаях случае
болезненный: болезненными
предок: предки
хозяйка: хозяйкой
дикий: дикого
точка: точку
ухо: уши ушам
этот: этих
живой: живой
попадание: попадании
наличие: наличие
миндалевидный: миндалевидную
барсук: барсуков
одурманить: одурманенные
вероятность: вероятность
огородник: огородников
далеко: далеко
тянуть: тянуть
холод: холода
припухлость: припухлости
ум: ума
навсегда: навсегда
отбирать: отбирать
одноклассник: одноклассники
энергичный: энергичный
падать: падали
скорее: скорее
меловой: меловые
нижний: нижними
веста-хайленд: вест-хайленды
волосок: волоски
дисплазия: дисплазия
рвать: рвать
выпадать: выпадают
мнение: мнение
интерчемпион: интерчемпионы
нора: норы нора
подходить: подходить подходят
полный: полный
заканчивать: заканчивая
случайный: случайные
относительный: относительной
передний: передние
кроме: кроме
мясо: мясо
повлиять: повлиять
барсучий: барсучьи
вкусняшка: вкусняшкой
коричневый: коричневые
среднее: среднем среднего
испытывать: испытывают
чувство: чувство
перспективный: перспективного
покровный: покровного
частый: чаще
поиск: поиск поисках
направление: направлению
черта: черте
коротко: коротко
тазобедренный: тазобедренного
магазинный: магазинной
час-полтора: час-полтора
характер: характер
потрогать: потрогайте
белые: белые
концентрироваться: концентрироваться
продукт: продукт продукты
ноготь: ногтей
ухватистый: ухватистые
выдра: выдр
укорачивать: укорачивают
салфетка: салфеткой
воображать: воображаемого
консультативный: консультативную
сторож: сторожа
щётка: щеткой
симпатичный: симпатичные
сделать: сделано
незначительный: незначительными
лососёвый: лососевое
ранний: раньше
присмотреться: присмотритесь
колтун: колтуны
потребность: потребность
периодически: периодически
смесь: смесь
влиять: влияет
порок: пороки
лис: лис
трапеза: трапезы
действовать: действует
снежно-белый: снежно-белого снежно-белый
жизнь: жизни
выход: выхода
перепелиный: перепелиным
забывать: забывайте
средство: средства
рука: руку
посад: посад
ребёнок: детьми
вспахать: вспаханной
благодаря: благодаря
минутный: минутные
груминг: груминг
размягчать: размягчая
диабет: диабет
служить: служит
нож: ножа ножом
недовольный: недовольным
доброжелательно: доброжелательно
волнистый: волнистая
различный: различные
глупый: глупее
мимимишность: мимимишности
абразив: абразивы
покрыть: покрыта
также: также
экстерьер: экстерьера
горловой: горловую
продажа: продажи
шёрстный: шерстный
любимец: любимца
норовить: норовит
момент: моменты момент
внутри: внутри
плановый: плановые плановую
грязный: грязных
мощный: мощные
уважать: уважает
корпус: корпус
удалить: удалит
застрять: застряли
витаминный: витаминных
бишон: бишона
прыжок: прыжок
круп: крупу крупом
неженка: неженки
оставлять: оставляет
ранее: ранее
виллебранд: виллебранда
тёмный: темный
выпуклый: выпуклый
наследственный: наследственным
крайне: крайне
разведенец: разведенцы
стоить: стоит
это: это
вид: вид
вайта: вайт
разный: разных
интересно: интересно
гореть: горите
манчестер-терьер: манчестер-терьер
помойный: помойную
приобретение: приобретение
вполне: вполне
детский: детской
выносить: выносят
любить: любят
адреналин: адреналина
бишона-фриз: бишона-фризе
умение: умения умение
отдельный: отдельных
сезон: сезон
различаться: различаться
повседневный: повседневной
пшеничный: пшеничную пшеничная
позволять: позволяйте позволяющий
легко: легко
сохранить: сохранить
лента: ленту
беспощадный: беспощадны
подумать: подумайте
зимний: зимние зимний
столетие: столетий
поясничный: поясничным
подпортить: подпортить
основательно: основательно
котироваться: котировались
острый: острым
сердечно-сосудистый: сердечно-сосудистые
остроконечный: остроконечные
сахаров: сахарова
уверить: уверены
отдалённо: отдаленно
общаться: общается
допустить: допустить
игрушка: игрушку
во-первых: во-первых
клиент: клиентам
ркф: ркф
подмешивать: подмешивать
вакансия: вакансии
прямо: прямо
выезжать: выезжать
подобрать: подберут
селекционер: селекционеров
приходиться: приходится
компаньонский: компаньонские
цель: цель
дерматит: дерматит
постоянно: постоянно
ответственный: ответственных
пауза: паузу
дальнейший: дальнейшем
пахнуть: пахнут
смазать: смазать
выше: выше
придавать: придавая
вместе: вместе
течение: течение
оказывать: оказывать
утверждение: утверждения
толчёный: толченого
амбициозный: амбициозны
зарегистрировать: зарегистрированные
сигнализация: сигнализации
большинство: большинство
главный: главная
практически: практически
крапива: крапива
изучать: изучают
рейтинг: рейтинг
рассудок: рассудка
генетический: генетических
дефект: дефекты дефектами
древний: древняя
обширный: обширную
подписываться: подписывайтесь
цып: цыпа
вынужденный: вынужденная
орехово-зуево: орехово-зуево
хватать: хватайте
мороженое: мороженым
наблюдать: наблюдает
использовать: использовать
соблюдать: соблюдать
спрятаться: спрятаться
обязанность: обязанности
очень: очень
обычно: обычно
выполнять: выполнять
наоборот: наоборот
постепенно: постепенно
совместный: совместное
кличка: клички
дичь: дичью
отреагировать: отреагировать
довольно: довольно
частность: частности
прежде: прежде
лай: лаем
готовиться: готовьтесь
развести: разведенного
возможность: возможность
касаться: касается
закрепиться: закрепилось
втираться: втирается
обрабатывать: обрабатывают
одновременно: одновременно
функция: функцией
потомок: потомок
желтоватый: желтоватый
проект: проекте
менингоэнцефалит: менингоэнцефалит
сильный: сильным
повадка: повадки
гасить: гасивших
палитра: палитру
надевать: надевать
кг: кг
вывести: выведенный
абрикос: абрикоса
свободный: свободной
темперамент: темперамента
клетка: клетках
линька: линька
фрукт: фруктами
корзина: корзине
ирония: иронией
господин: господина
страна: страна
целый: целый
содержать: содержащие
чужак: чужака
обаятельный: обаятельных
прямой: прямой
объяснять: объясняют
газон: газон
облик: обликом
справлять: справлять
звук: звуками
надбровный: надбровными
важный: важный
кусочек: кусочком
наедине: наедине
особенность: особенность
пупок: пупка
дрожжи: дрожжи
тренироваться: тренироваться
зоошампунь: зоошампуня
причём: причем
груша: груши
шустрик: шустрику
тишина: тишиной
правильный: правильной
недостаток: недостаток
белошёрстный: белошерстных
давно: давно
родитель: родителей
напоминать: напоминающий
подстричь: подстричь
кормление: кормление
выдерживать: выдерживая
превращаться: превращаются
ожидание: ожидании
слух: слухом
хвост: хвост
постараться: постарайтесь
ихтиоз: ихтиоз
изысканный: изысканный
авантюра: авантюр
яйцо: яйцом
рассвирепеть: рассвирепевший
посыпать: посыпают
недобросовестный: недобросовестные
брокколи: брокколи
выступать: выступающая
шаг: шаг
