преподнести: преподнесены
иметь: имели иметь имеющие имеют
короткий: короткую коротким короткие
дорогостоящий: дорогостоящие
территориальный: территориальные
овощ: овощи
эмоционально: эмоционально
утеплитель: утеплитель
ситуация: ситуациях
околачиваться: околачивались
кровь: крови
шампунь: шампуней
лосьон: лосьонах
обильный: обильнее
удивительно: удивительно
необходимость: необходимость
здоровый: здоровых здоровым
из-под: из-под
следить: следить
участвовать: участвовать
раздавать: раздают
сколько: сколько
голландец: голландцами голландцы голландцев голландец
переименовать: переименовали
четверолапый: четверолапого четверолапым четверолапые
миссия: миссия
политический: политической
название: название названия
разрешать: разрешает
фактурный: фактурной
собака: собаку собаками собакой собак собака собакам собаке собаки
тон: тонах тон тона
округлый: округлой
больший: большими большую
заранее: заранее
прикус: прикусе прикуса
обсуждение: обсуждения
сушка: сушке
наследственность: наследственностью
агрессия: агрессии агрессию
миска: миску миске
сочленение: сочленений
цена: цена ценам
рыба: рыбу
подходить: подходившие
зачастую: зачастую
водом: водомах
развлекать: развлекает развлекать
бич: бичом
проводить: проводящим
генетический: генетические генетическую
смышлёный: смышленые
материал: материалов материала
природа: природы природе природу
подшёрсток: подшерстком подшерсток подшерстка
кузен: кузен кузенов
неутомимый: неутомимый
ферма: ферм
недуг: недуга недугов недуги
выдающийся: выдающейся
массивный: массивным
виноградник: виноградников
туманный: туманного
владелец: владельцам владельцев владельцу владельцами владелец владельцем
неприятность: неприятностью
поведение: поведения поведение
ставить: ставящий ставящими
мускулистый: мускулистыми
дисквалифицировать: дисквалифицирующие
призыв: призывов
де: де
дефектный: дефектными
режим: режиму
выраженный: выраженный выраженных выраженного
зато: зато
россия: россия россии
живот: живот
морда: морде морду морды морда
раковина: раковины
обратный: обратная
итог: итоге
шалун: шалуном
великобритания: великобритании
размер: размеров размером
волчий: волчьего волчий
представитель: представителей представителям представителем представитель представителями представители
отказать: отказать
позаниматься: позанимается
охранник: охранник
разгрузить: разгрузить
пикник: пикников
шея: шея шеи
волос: волосом волос волоса
полезный: полезнее
овчарка: овчарки
компаньон: компаньон
получать: получать
шерсть: шерсть шерсти
ласково: ласково
бунтарь: бунтарю
неприятный: неприятное неприятного
шарообразный: шарообразные
высокий: высоких высокая
эпилептический: эпилептических
фристайл: фристайлу
челюсть: челюсти
игра: игре игр
небольшой: небольшого небольших небольшим
несложно: несложно
потомство: потомства потомство потомству
тип: тип типов
уважать: уважал
клянчить: клянчат
исключение: исключение
переносимость: переносимость
чёрный: черные черная черного черным черными
сегодняшний: сегодняшних
периодический: периодическая
месяц: месяц
необходимый: необходимы необходим
препятствовать: препятствуя
переноситься: переносится
спустя: спустя
равно: равно
представлять: представлять
включая: включая
учитывать: учитывайте
важно: важно
рис: рис риса
палка: палки
подвывания: подвываниями
аристократический: аристократического
травма: травмы
история: история
гипотиреоз: гипотиреоз гипотиреоза
кинологический: кинологических кинологической
застенчивый: застенчивое
щенок: щенка щенков щенки щенок
шоу-карьера: шоу-карьеры
двойной: двойную двойная
суперпремиум: суперпремиум
белок: белка
нормально: нормально
действие: действиям действие
стильный: стильный
миниатюрный: миниатюрное миниатюрную
прилегать: прилегающие
питомец: питомцев питомцу питомец питомцы питомца
мини-волк: мини-волки
особый: особое
минимальный: минимальный
семья: семьи
нередко: нередко
характеристика: характеристика характеристики
немецкий: немецкий немецких немецкого немецкие
быть: е будут
род: рода
стоп: стоп
офтальмологический: офтальмологических
руб: руб
пол: пола полу
пятно: пятна
повод: поводу повод
месячный: месячный месячных
лакомый: лакомый
общение: общению
требовательный: требовательны
систематически: систематически
быстро: быстро
входить: входят
супервыгодный: супервыгодные
еда: еду
видео: видео
обследование: обследования
розовый: розовой
жирный: жирную
внимание: внимания внимание
меню: меню
вода: воды
подопечный: подопечные подопечному
обаятельный: обаятельный
разбить: разбить
домашний: домашних домашнего
белый: белое белого
назначение: назначению
позвать: позовут
расстаться: расстаться
светлый: светлыми светлее
шуба: шубе
пятнышко: пятнышко
лохматик: лохматик
кеннел-клуб: кеннел-клубом
экспонировать: экспонировать
скука: скуки
талант: талантов
рацион: рациона
пренебрегать: пренебрегайте
лопатка: лопатками
называть: называют
коленный: коленные коленной
кайма: кайма
содержание: содержание содержания
грозный: грозных
работа: работе работу
подкрепиться: подкрепиться
стресс: стресса
международный: международных
попытка: попытки
кеесхонда: кеесхонд кеесхонду кеесхондах кеесхонда кеесхонды кеесхондам
вертикальный: вертикальном
приятный: приятное приятную
проявить: проявил
ринг: ринге
численность: численность
вольфшпиц: вольфшпицах вольфшпиц вольфшпицы вольфшпица вольфшпицев
окрас: окраса окрас окрасу окрасами
предел: пределы
запомнить: запомните
риджбек: риджбек
пристальный: пристальном
объект: объект
воздух: воздуха
выражение: выражения
различаться: различаются
облик: облика облику
кстати: кстати
он: нему
связь: связь
точно: точно
подобный: подобным подобных
клуб: клуб
брида-особь: брид-особей
преданно: преданно
состав: составе
признать: признает
единственный: единственный единственное
похожий: похожие
длина: длине длины
прогулка: прогулкам прогулку
шпицева: шпицевой
работяга: работяга
пока: пока
жир: жира
взаимодействие: взаимодействия
развиваться: развивается
сокращать: сокращать
собачий: собачьего собачьих собачьему
общество: обществу
треугольный: треугольную
расцвечиваться: расцвечивается
дважды: дважды
структура: структуру
среднестатистический: среднестатистический
презентовать: презентовано
завезти: завезли
шаловливый: шаловливый
суточный: суточного
данный: данного
заниматься: заниматься
свойство: свойства
делаться: делается
обычный: обычными обычных
тесный: тесных тесного
жидкость: жидкостях
причина: причина
приём: приемов
качество: качестве качества
критический: критических
тримминговать: тримминговать
свобода: свободе
сомкнутый: сомкнуты
смотреть: см
друг: друзья друг друге друзьями
плюс: плюс
лёгкий: легкий
фотография: фотографии
кабинет: кабинетам
развлечение: развлечений
четвероногий: четвероногие четвероногого
широкий: широкие широкую широкая
агрессивный: агрессивная агрессивное
хороший: хорошие лучшими хорошее
надолго: надолго
уход: уходе уход уходом
предводитель: предводитель
корма: корме
знать: знать
столько: столько
помнить: помните
результат: результатов
улечься: улеглось
страдать: страдают
питомник: питомники питомника питомникам
имидж: имидж имиджа
череп: черепом
глаз: глаза глаз глазами
район: районе
набить: набить
самый: самый самым самыми самых самые
должный: должен должно должна
обзаводиться: обзаводиться
прийтись: придется
незнакомый: незнакомым
кинолог: кинолог
корм: корм корма
начаться: началась
веселие: веселья
часть: части часть
век: века
форма: форме форму формой формы
год: года лет году
предпочтительный: предпочтительный
покровный: покровным покровный
ветеринарный: ветеринарным
порекомендовать: порекомендовать
поскольку: поскольку
дом: домах дома
умильный: умильного
состояние: состоянием
краткий: краткая
причастность: причастность
обзавестись: обзавестись
любой: любого любую любой любым
сухой: сухом
отношение: отношение
место: место месте
компания: компанию
малыш: малышей малыши
исключительно: исключительно
сородич: сородичей сородичи сородич
половой: половому
отвести: отведено
мириться: мирится
эксперт: экспертов
японский: японский
факт: факт
отказываться: отказывайтесь
затылочный: затылочной
изящество: изящество
канистерапия: канистерапии
шерстинка: шерстинок шерстинки
предпочитать: предпочитающим предпочитают
вконтакте: вконтакте
постоянный: постоянной
свет: свет
калорийный: калорийными
беспроблемный: беспроблемные
стоить: стоила стоит
создать: создать
грумера: грумеру
видный: виден
разновидность: разновидности разновидность
уничтожить: уничтожить
цирковой: цирковые
бить: бьют
незамеченный: незамеченной
роль: роль
шубка: шубки шубке шубка
поинтересоваться: поинтересуйтесь
немаловажный: немаловажный
развитие: развитие развитию
увлечь: увлечь
животное: животных животным животного животными животные животное
различие: различия
ножницеобразный: ножницеобразном
сомнение: сомнение
сырой: сырую
проскакивать: проскакивают
производитель-чемпион: производителей-чемпионов
сша: сша
сыр: сыром
переводить: переводить
преследование: преследования
шпиц: шпиц шпица шпицев
источать: источает
выбрать: выбрать
понравиться: понравиться
львиный: львиную
оценить: оцените
избавляться: избавляться
изделие: изделия
отполировать: отполировать
повстанческий: повстанческому
основать: основана
сустав: сустава суставы
хотя: хотя
заводчица: заводчицей
рисунок: рисунка
предлагать: предлагающих предлагающие
х: х
продолжительный: продолжительные
загрязнить: загрязнена
голландский: голландскую голландским голландские голландских голландский
сам: сами сама
открытие: открытием
местный: местной
уличный: уличному
нескончаемый: нескончаемой
середина: середины
включить: включены
бедро: бедрах бедрами
темперамент: темпераментом
естественный: естественного
квартира: квартире квартирах
облаивать: облаивать облаивая
климат: климате
информация: информация информацию
поход: походов походам
максимально: максимально
натуральный: натуральный
телосложение: телосложения
хотеть: хочет хотите
палец: пальцами
гребень: гребнем
унылый: унылые
приятель: приятеля приятель
остальной: остальных
мытьё: мытья
характер: характера характерах характер
родословный: родословную
яблоко: яблока
желток: желтки
крепкий: крепкие крепкое
подходящий: подходящий
кончик: кончик кончиком
выигрышный: выигрышный
пятиминутка: пятиминутки
число: число
серьёзный: серьезных серьезный серьезной
крупа: крупы
серый: серые серый
учесть: учесть
веко: веки
основательный: основательным
продолжительность: продолжительностью продолжительность
разговаривать: разговаривают
обильно: обильно
длинный: длинные длинную длинными
мыть: мыть
кто: кем кому
расчёсывание: расчесыванием расчесывания
новорождённый: новорожденную
сайт: сайтах сайту
просто: просто
проходиться: проходиться
силуэт: силуэту
хватить: хватит
припадок: припадков
желать: желающих
найти: найдет
одиночество: одиночестве одиночеству
конец: конца конец
этикет: этикета
рассекать: рассекали
некомфортно: некомфортно
исполнять: исполняли
принять: принято
новый: новом
волноваться: волнуйтесь
находить: находить
группа: групп группе
обратить: обратить
умный: умных
фрукт: фрукты
отдохнуть: отдохнуть
заменить: заменить
приводить: приводят
штанишки: штанишки
температура: температур
несправедливый: несправедливо
развивать: развивать
добавить: добавьте
неудобно: неудобно
чистка: чистка
холка: холка холке
тысяча: тысячам
доминирование: доминирования
дог-шоу: дог-шоу
каждый: каждым
конкретный: конкретнее
удачный: удачные
происхождение: происхождения
тёмный: темные темная темнее
карьерист: карьеристам
необходимо: необходимо
готовый: готовы готового готов
наследовать: наследуют
исторически: исторически
стандартизировать: стандартизировали
пища: пищи
числиться: числится
добродушие: добродушием
соотношение: соотношение
задний: задние
заведомо: заведомо
редкий: реже
косой: косого
набор: набору
терпеть: терпеть
гламурный: гламурный
тракт: тракт
дрессировка: дрессировка дрессировке
стандартный: стандартный
время: время времени
сука: суки сук
мочка: мочкой мочку
агрессивность: агрессивность
ушной: ушной ушное
клещевидный: клещевидном
кисломолочный: кисломолочная
день: дней дня день дни
жёсткий: жесткий
приобретать: приобретающая
начать: начали начал
деятельность: деятельности
подобострастный: подобострастные
пясть: пясти
выдерживать: выдерживать
другой: другие другим
забросить: заброшен
улыбчивый: улыбчивых улыбчивыми
рассчитывать: рассчитываете рассчитывать
хозяин: хозяином хозяина
злак: злаки
грива: гриве
клиновидный: клиновидную
отдельный: отдельные отдельных
например: например
питаться: питаться
несколько: несколько нескольких
деликатес: деликатесами
рост: рост
порадовать: порадовать
голова: головы голова
ежедневный: ежедневным
отечественный: отечественных
крошечный: крошечные
использовать: использует использовать
кондиционер: кондиционеров
вне: вне
обидеть: обидеть
харденброк: харденброк
детсадовца: детсадовца
реклама: реклама
соответственно: соответственно
исполниться: исполнится
средний: среднее средних
обращать: обращают
угодить: угодить
нюанс: нюанс
стать: станете станет
линять: линяет
вещь: вещам
базовый: базовые
компактный: компактнее
еженедельный: еженедельным
ложиться: ложится
полагаться: полагается
голландия: голландии
окд: окд
эмоциональный: эмоционального
рекомендоваться: рекомендуется
сезонный: сезонный
имущество: имущество
воспитание: воспитание воспитанию
учиться: учатся
германия: германия
частый: частым чаще
пушистик: пушистик
правильно: правильно
патриот: патриотов
чау-чау: чау-чау
который: которыми которой которого котором которая которых которым которые которому который
оба: обоих
процедура: процедур
черепной: черепной
выращивание: выращивание
кричать: кричат
родничок: родничок
занять: занять
полезно: полезно
пойти: пойдет
этот: эта
калорийность: калорийность
что-то: что-то
вариант: вариант
долго: долго
образовать: образованная
рабочий: рабочие
репутация: репутацией
вывернуть: вывернутые
серебристо-серый: серебристо-серый
форум: форум форуме форумах
невыполнимый: невыполнимая
предпочтение: предпочтение
сила: сил силу силами
непринуждённый: непринужденным
любитель: любитель любителей
планета: планете
подход: подходов
такой: такие такая таким такими
умеренный: умеренные
мясо: мяса
обработка: обработки
завернуть: завернутые
разнообразный: разнообразные разнообразных
запирать: запирают
крестьянин: крестьян
злаковый: злаковой
собственный: собственными собственные собственной собственную
один: одна одной одном
описание: описание описания
виноград: виноград
начало: начало
стандарт: стандартом стандарт стандартам
мальчиковый: мальчиковых
выставочный: выставочный
оттенок: оттенки оттенок
амбре: амбре
богатый: богаче
владение: владения
требование: требованиями
однако: однако
искренне: искренне
играть: играть
отличаться: отличаются
отсутствие: отсутствием
поэтому: поэтому
окрик: окриков
стена: стенами стен
добавка: добавкой
перекрыть: перекрыт
наличие: наличием наличие
копирование: копирование
дружелюбный: дружелюбная
третировать: третирует
активность: активность
предусматривать: предусматривает
основание: основания
родезийский: родезийский
дружелюбность: дружелюбность
попасть: попали
бридер: бридера
пауза: паузы
доступ: доступ
осматривать: осматривают
отзыв: отзывах отзывы
нога: ноги
скромный: скромными
девочковый: девочковых
развернуть: разверните
черно-серый: черно-серого
заключаться: заключается
походить: походить
кошка: кошки кошкам
следовать: следует
комплект: комплектом
оценка: оценки оценке
шум: шум
заострить: заостренный
пристрастие: пристрастия
черта: черт
пожилой: пожилых
особь: особи особей
поучаствовать: поучаствовать
уровень: уровня уровень
лишний: лишних лишний
отличие: отличие
пшеница: пшеница
занизить: заниженным
мёрзнуть: мерзнут
набегаться: набегаться
породный: породные
назад: назад
лето: летом
поиск: поиском поиск
поначалу: поначалу
слой: слоем слоях
кость: кости
обнаружиться: обнаружилось
интерес: интерес
накапливать: накапливает
мочь: могут можете
мать: матерью
топорщиться: топорщащимся
порода: породы пород породу порода породой
разочаровать: разочаровать
партия: партии
манный: манную
видеть: видеть
толщина: толщину
объявление: объявления
река: рекам
тонкость: тонкостями
основной: основные основной
согласный: согласны
какой: каким
интеллект: интеллект интеллектом
охранный: охранные
восстанавливать: восстанавливая
образовывать: образовывает
вес: вес
спина: спину
овсянка: овсянка
сторожевой: сторожевой
палитра: палитра
швеция: швеции
появиться: появившаяся появились
ежедневно: ежедневно
нос: носа нос
рада: рады
свой: своим свое своих свои
постав: постава
кеесхонд: кеесхондом кеесхондов
именно: именно
чрезвычайно: чрезвычайно
отклонение: отклонения
энергия: энергия
корнелиус: корнелиус
злоупотреблять: злоупотреблять
протирание: протирания
стрижка: стрижки
член: членов
преимущество: преимущество
полустоячий: полустоячие
страна: страны стране страну страна
альтруист: альтруист
трезво: трезво
обладать: обладающий
положение: положении
причёска: прическу
подъём: подъем
озорной: озорной
тазик: тазика
полотно: полотно
зависимость: зависимости
научить: научить
нарушить: нарушивших
хозяйский: хозяйское хозяйского
вокруг: вокруг
четырехразовый: четырехразовое
слегка: слегка
тот: те та тех тому
плохой: плохая
иметься: имеются
фото: фото
бояться: боится
радужный: радужный
подвывих: подвывих
вкусность: вкусностям
нидерланды: нидерландов нидерландах нидерланды
сбываться: сбываются
развесёлый: развеселый
заодно: заодно
десятилетие: десятилетий
бальзам: бальзамов
яндекс: яндекс
количество: количество
переходящий: переходящий
считаться: считаются считалась
незаросший: незаросший
обожать: обожают обожаемым
явный: явными
цитрусовый: цитрусовые
анальный: анальной
чей: чья
гармонично: гармонично
вперёд: вперед
собаковод: собаководы
неразумно: неразумно
рад: рад
трудоголик: трудоголикам
лапа: лапы
делать: делая делать
цветовой: цветовая
придирчивый: придирчиво
выразительный: выразительные
существо: существом
журнал: журнал
эксперимент: экспериментов
зоосредство: зоосредств
сильный: сильнее
высота: высота
загривок: загривок
кавказский: кавказской
повышенный: повышенных повышенное
картофель: картофеля
атмосфера: атмосфера
нарушение: нарушение
превосходный: превосходные
болезнь: болезни болезнь
изредка: изредка
целиком: целиком
заводчик: заводчиков заводчика заводчики
клеймо: клеймом
лоток: лоток
чрезмерно: чрезмерно
упражнение: упражнения
либо: либо
зона: зоны
поиграть: поиграть
минута: минут
кошачий: кошачьи
заболевание: заболевание
образ: образом
существенный: существенные
овальный: овальной овальные
человек: человека человеком
европейский: европейских
простой: проще
ваш: ваши вашем
молниеносно: молниеносно
жильё: жилью
подвес: подвеса
туалет: туалету
обязать: обязанный обязан
разобраться: разобраться
корпус: корпуса корпус
кобель: кобели
вести: ведет ведут
плодиться: плодиться
заметно: заметно
коготок: коготки
допустимый: допустимых
безболезненно: безболезненно
повернуть: повернут
дело: дело
золотистый: золотистыми
циркуляция: циркуляции
противопоказанный: противопоказаны
защитник: защитника
нужный: нужен нужного
распространить: распространенных
версия: версию
шоу-собака: шоу-собакой
перейти: перейти
разумный: разумнее
сутки: сутки
отдавать: отдавая
из-за: из-за
главное: главное
производить: производимых
купаться: купается
соратник: соратник
отбираться: отбираются
маленький: маленькие меньше
недостаточный: недостаточное
весомый: весомый
менее: менее
процент: процента
пострадать: пострадали
складка: складок
духовный: духовной
помещение: помещениях
собрат: собратьями собратьев
прохлада: прохладу
терять: теряет
дворовый: дворовыми
чистоплотный: чистоплотны
потенциал: потенциал
наделить: наделены
внешний: внешний
область: область области
слишком: слишком
уделить: уделите
антистатик: антистатиком
развить: развита
зимой: зимой
баржевый: баржевых
коготь: когтями
потерпеть: потерпеть
отучить: отучить
альбион: альбиона
запрет: запрет
псовый: псового
гигиена: гигиена
дружить: дружить
внешность: внешностью внешности
побег: побегами
копчёность: копчености
некрупный: некрупные
ван: ван
наивно: наивно
немножко: немножко
звонкий: звонким
рубль: рублей
безграмотность: безграмотности
пелёнка: пеленку
разумеется: разумеется
неделя: недель неделю
неизвестно: неизвестно
сообразительный: сообразительные
пушистый: пушистые пушистый пушистого
три: трем
самостоятельный: самостоятельную
чёрно-белый: черно-белый
происходить: происходило происходит
выставка: выставке
сформировать: сформирована
австралия: австралии
стоимость: стоимость
подойти: подойдут
процесс: процесса
поддерживать: поддерживать
особенно: особенно
разреветься: разревевшуюся
возле: возле
урок: уроков
субпродукт: субпродуктов
задорный: задорный
распространяться: распространяется
лабрадор: лабрадорами
пачкаться: пачкается
успеть: успели
придавать: придает
свинина: свинину
вторгнуться: вторгшегося
возраст: возраста возрасте
опушить: опушены
сделать: сделали сделано
проказник: проказника
однородность: однородность
зоомагазин: зоомагазина
отправляться: отправляясь
постричь: постричь
обследовать: обследуют
гранат: гранат
посадить: посаженный
список: списке
стэнли: стэнли
гизеляра: гизеляр
охотно: охотно
англия: англии
получиться: получилось
понимать: понимать
сарай: сараев
несмотря: несмотря
фонтан: фонтаном
сладость: сладости
купить: купить
носить: носить
часто: часто
старание: стараниям
склонность: склонность
находиться: находятся
прямой: прямые
первый: первый первую
давить: давить
альф: альфы
грибник: грибников
оказаться: оказаться
прижиться: прижились
бессмысленно: бессмысленно
амстердамский: амстердамской
успокоить: успокоит
лохматый: лохматые лохматый
период: периоды
оголять: оголяют
несчастие: несчастье
случай: случаях
пёсик: песика
предок: предки
задача: задача
аджилить: аджилити
сохранять: сохраняющую
содержать: содержат
вылазка: вылазки
выбирать: выбирать
привлекать: привлекают
ухо: уши
задаток: задатками
ссср: ссср
банный: банных
потребность: потребности потребность
округлость: округлость
функция: функцию
эстетический: эстетическом
гречка: гречка
мальтийский: мальтийская
бежевый: бежевые
вселенная: вселенной
бровь: брови
дисплазия: дисплазию дисплазия
нежелательно: нежелательно
весь: вся всем
пухлый: пухлым
угол: углы
опора: опорой
округлить: округленным
хмурый: хмурый
открытый: открытых
пример: примера
одноклассник: одноклассники
марка: марки
терморегулятор: терморегулятора
правда: правда
возможность: возможности возможность
мнение: мнение мнению
чистить: чистить
крупный: крупнейшей крупными
полный: полный
несвойственный: несвойственен несвойственная
грудь: грудь
случайный: случайные
передний: передние
навык: навыки
кроме: кроме
порядок: порядке
шоу-особь: шоу-особей
повлиять: повлиять
жестоко: жестоко
трудовой: трудовой
среднее: среднем среднего
любопытство: любопытство
сегодня: сегодня
обитать: обитавшими
породность: породность
оптимальный: оптимальный
привить: привить
тазобедренный: тазобедренного
температурный: температурному
зуб: зубы зубов
вообще: вообще
молодой: молодым
выполнять: выполняет выполнять
волосок: волосков
соображение: соображений
лишить: лишены лишена
включать: включает
душа: душ
практиковать: практикуют
скучать: скучающий
предпочесть: предпочтя предпочтет
применение: применением
батарейка: батарейкой
белые: белые
учить: учить
помета: помета
подозрительность: подозрительность
укорачивать: укорачивают
обременять: обременять
щётка: щеткой
правильный: правильный
пищеварительный: пищеварительный
корить: корена
колтун: колтуны
килограмм: килограммов
порок: пороки
плечо: плечах
жизнь: жизни
два: двух
гламурность: гламурность
забывать: забывайте
шпицов: шпицов
ждать: ждите ждать
тело: тело
продукция: продукция
проживать: проживавшие
ребёнок: детьми
благодаря: благодаря
переключить: переключит
комондора: комондор
померанский: померанский
приобщать: приобщать
подобно: подобно
эмигрировать: эмигрировали
оттого: оттого
пространство: пространства
выстригать: выстригают
ассоциация: ассоциаций
запах: запаха
присущий: присущего
переходить: переходит
признак: признаку
адаптироваться: адаптироваться
привязать: привязаны
железа: железы
профессиональный: профессиональный
позитивный: позитивный
отличать: отличает
нужно: нужно
мимимишность: мимимишности
также: также
настрой: настрой
покупка: покупки покупке
момент: моменты момент
рассмотрение: рассмотрении
внутри: внутри
известный: известного
шоу-питомец: шоу-питомца
мощный: мощные
ставка: ставку
заглядывать: заглядывают
модель: модель
миролюбивый: миролюбив
продолжать: продолжает продолжали
специальный: специальных
ухаживать: ухаживают
обусловить: обусловленных
фейерверк: фейерверк
яичный: яичные
вволю: вволю
круп: крупу крупом
далёкий: дальше
сбой: сбои
умеренно: умеренно
прививать: прививайте
механический: механическую
густой: густейшего
зафиксировать: зафиксировано
круглый: круглую
изначально: изначально
высоко: высоко
ранее: ранее
практичность: практичность
оставить: оставленный
виллебранд: виллебранда
команда: команда
впоследствии: впоследствии
выпуклый: выпуклый
ожирение: ожирению
сложно: сложно
уживаться: уживается
это: это
вид: вид
царить: царящая царил
эпилепсия: эпилепсия
загородный: загородное
кремовый: кремовых
прохладный: прохладные
чашечка: чашечки
образоваться: образуются
порка: порок
титуловать: титулованных
стабильный: стабильные
разводить: разводить
избыток: избыток
кормить: кормить
спреть: спреем
выносить: выносят
кусочек: кусочек
заставлять: заставлять
подобрать: подобран
селекционный: селекционных
занятие: занятие
своевременно: своевременно
стол: стола
сторожить: сторожащий
нелишний: нелишним
подталкивать: подталкиваете
прочь: прочь
усилить: усилить
клан: клана
легко: легко
собака-улыбака: собака-улыбака
кроха: кроху
употребление: употреблению
уточнить: уточнить
монопородный: монопородный
сохранить: сохранить
лента: ленту
производитель: производителей
здоровье: здоровье
твёрдо: твердо
воспитать: воспитать
грешить: грешат
возникать: возникает
экстраверсия: экстраверсия
кто-то: кому-то
сложность: сложностей
отличный: отличные
многое: многом
кобель-производитель: кобеля-производителя
говорить: говорит
наследственный: наследственная
захотеться: захотелось
вакансия: вакансии
дорожить: дорожащие
продукт: продукты
селекционер: селекционеров
экстраверт: экстраверт
центр: центром
незнакомец: незнакомцев
обойтись: обойдется обойтись
зарубежный: зарубежных
встречаться: встречается
отвечать: отвечали
постоянно: постоянно
план: плане
движение: движению
дальнейший: дальнейшем
чистокровный: чистокровных
специфический: специфических
таковой: таковой
выше: выше
искать: ищите
судно: судов
окрасить: окрашены
затягивать: затягивайте
плавный: плавный
течение: течение
чересчур: чересчур
жара: жару
дёргать: дергать
удовлетворять: удовлетворять
коричневый: коричневого
отрегулировать: отрегулировать
рубеж: рубежом
большинство: большинство
наряду: наряду
главный: главная
практически: практически
традиционный: традиционный
рейтинг: рейтинг
гармоничный: гармоничную
дефект: дефекты
назойливый: назойливого
баронесса: баронессе
дисциплина: дисциплины
подписываться: подписывайтесь
гигиенический: гигиенических
дворняга: дворняг
вновь: вновь
передаваться: передается
запретить: запрещено
очень: очень
обычно: обычно
ладить: ладит
необследованный: необследованных
особенность: особенности
начисто: начисто
холистик-класс: холистик-класса
обезжиренный: обезжиренная
пет-особь: пет-особей
свёртываемость: свертываемости
истреблять: истребляли
пателла: пателлу
постепенно: постепенно
неполный: неполным
завершаться: завершающуюся
кличка: клички
двухмесячный: двухмесячном
правило: правила правил
предоставить: предоставив
частность: частности
прежде: прежде
держать: держать
лай: лаем
готовиться: готовьтесь
увлекательно: увлекательно
касаться: касается
след: следы
закрепиться: закрепилось
племенной: племенного
граница: границы
аниматор: аниматоры
уязвимый: уязвимым
одновременно: одновременно
гормон: гормонов
психологический: психологическая
проект: проекте
сразу: сразу
отдать: отдать
отдыхать: отдыхать
разрешить: разрешены
ретривер: ретриверами
потомок: потомки
арсенал: арсенала
кг: кг
изменять: изменяют
городской: городской
умиляться: умиляться
зерно: зерна
удовлетворить: удовлетворить
полгода: полгода
подружить: подружить
клетка: клетках
линька: линька
навязываться: навязывается
чужак: чужака
щитовидный: щитовидной
колбасный: колбасные
увлекаться: увлекаться
зной: зною
экономить: экономьте
шут: шуты
причём: причем
полноценно: полноценно
кверху: кверху
уникальный: уникальной
плюсна: плюсны
попробовать: попробуйте
прохожий: прохожие
родитель: родителей
рыболов: рыболовов
кормление: кормление
семейство: семейств
конечность: конечности
плоский: плоским
зарегистрировать: зарегистрированы
являться: является
вследствие: вследствие
хвост: хвост
губа: губы
живой: живым
болонка: болонка
перегреваться: перегреваются
кавказец: кавказца
изысканный: изысканный
недостаток: недостатками
конура: конурах
условие: условия
гораздо: гораздо
способный: способны
г: г
настойчивый: настойчивых
поразвлечься: поразвлечься
волшебный: волшебные
брокколи: брокколи
