травма: травм
избавить: избавить
крутой: крутого
иметь: имели имеет
щипка: щипки щипками щипка
желательный: желательная
заметить: заметили
отличать: отличают
тело: тела телом тело
приобретать: приобретают
средний: средняя среднее средних средней средним средний
принцип: принципе
слабовыраженный: слабовыраженный
необходимость: необходимость необходимости
агрессия: агрессия
расти: растет
подбить: подбитой
загородный: загородные
профессиональный: профессиональном
гиперкератоз: гиперкератоза гиперкератоз
классический: классических классическому классическом
раздавать: раздают
сколько: сколько
реагировать: реагировал
ирландский: ирландском ирландских ирландского ирландские ирландскому ирландским ирландскими ирландский
присоединиться: присоединились
колтун: колтунов
название: название названия
часть: частях часть
собака: собаку собакой собак собака собакам собаке собаки
примерно: примерно
растрёпа: растрепой
прыжок: прыжке
справляться: справляются
обсуждение: обсуждения
наследственность: наследственностью
оптимально: оптимально
трогать: трогают
английский: английских английского английском
цена: цена
реальность: реальности
зачастую: зачастую
выгул: выгулах выгул
никто: никому
подушечка: подушечки подушечек подушечками
смышлёный: смышленые
материал: материалов материал
племенной: племенные
поголовье: поголовья
четыре: четырем
обнаруживать: обнаруживает
инструмент: инструменты
скромный: скромная скромных
поведение: поведения поведение
подобный: подобного подобная
поклонник: поклонники
миниатюрный: миниатюрные
силиконовый: силиконовой
морской: морская
сторона: стороны стороной
поручить: поручили
дисквалифицировать: дисквалифицирующие
хороший: хорошую хорошим хорошая хорошей хорошее
игра: игру
семейство: семейства
субпродукт: субпродукты
россия: россия россию
спортсмен: спортсмены
морда: морде морду морды
обратный: обратная
получаться: получается
начинать: начинают
радужка: радужки
предварительно: предварительно
мероприятие: мероприятия мероприятии
представитель: представителей представителями представителях представители
тренировочный: тренировочные
команда: команду команда
попробовать: попробовать
занятие: занятий занятия
появляться: появляются
заточить: заточена
шея: шея шею шеи
универмаг: универмага
поисково-спасательный: поисково-спасательных
шерсть: шерсть шерсти
среда: среды средой
рука: руками руки
кинолог: кинологи
рыба: рыба
ирландец: ирландцы ирландца ирландцам ирландец ирландцев ирландце
полениться: поленился
один: одним одна одной
челюсть: челюсти
демонстрировать: демонстрирующие
взрывной: взрывной
должный: должны должна
тримминг: тримминг тримминге тримминга
взгляд: взгляд
класс: класса
посадить: посажен
звёздный: звездный
энергия: энергию
становиться: становиться
проход: проходе
сегодняшний: сегодняшних сегодняшним
тянуть: тяните
относиться: относится относиться
питомец: питомцами питомцев питомец питомцы питомца
проявлять: проявлял
пускать: пускайте
послушный: послушнее
явный: явная явной
разработать: разработает
вальяжно: вальяжно
столь: столь
спустя: спустя
равно: равно
коммерческий: коммерческое
масть: масти
нога: ног ноги
отличаться: отличается
брайтон: брайтоне
терьер: терьером терьер терьера терьеры терьере терьерами терьеру терьерам терьеров
важно: важно
интриган: интриган
подлежать: подлежащая
терять: теряли терял
история: история
промышленный: промышленные
месяц: месяцы месяца месяце месяцев
щенок: щенка щенков щенки щенок
парка: парке
марина: марина
белок: белка
нормально: нормально
пожалеть: пожалела
успешно: успешно
раздражитель: раздражители
подбирать: подбирать
форма: форма
планка: планку
особый: особое
голова: голове голова
несправедливость: несправедливости
определение: определению
полуоборот: полуоборота
фиксировать: фиксирует фиксируют
характеристика: характеристика характеристики
профессия: профессиями
стоп: стоп
главный: главных главная
практика: практике практики
выставка: выставках выставке выставку
скрывать: скрывать
руб: руб
поздний: позднее
эмоция: эмоции
гармоничный: гармоничное
год: годы годах лет год годов году
пол: пола
навык: навыков
война: войны
зкс: зкс
невероятность: невероятности
коготь: когти когтями
хрупкость: хрупкости
номер: номера
стать: стала станут стало
белизна: белизной
псовина: псовины псовина псовину
вытерпеть: вытерпеть
стабильный: стабильная
возможный: возможных
стекло: стекло
систематически: систематически
быстро: быстро
кардинально: кардинально
нож: ножей нож
первый: первой первые первого первый первая первую первых
сужаться: сужается
присутствие: присутствия
водоём: водоемах водоема
видео: видео
почёсывание: почесывания
подойти: подойдет подойдут
полноценный: полноценного
дать: дала дало
свисать: свисают
стремиться: стремятся стремится
угадываться: угадываться
полностью: полностью
очередь: очередь
забавный: забавные
условие: условии условиям
полёживать: полеживает
быть: будьте
улица: улицу улице
домашний: домашних
выглядеть: выглядел выглядят
каша: кашами
способный: способный способных способен
гений: гений
владелец: владельца владельцев владельцу владелец
всыпать: всыпать
поисковик: поисковиком
гордый: гордый гордая
называть: называют
речь: речь
знакомиться: знакомиться
служить: служат
содержание: содержание содержания
сумятица: сумятице
рыжеть: рыжей
опытный: опытного опытные
собственный: собственного собственным собственной
опустить: опущены
мелкий: мелких
целесообразность: целесообразность
нужный: нужны нужный нужное
немного: немного
приколист: приколисту
международный: международных
жесткошёрстный: жесткошерстных
газон: газонах
посещать: посещают
витаминный: витаминные
рекомендовать: рекомендуют
привыкать: привыкает
сорвиголова: сорвиголовы сорвиголовами
зона: зонам
утверждать: утверждают
пет-категория: пет-категории
оставаться: остаются
предел: пределы предел
последующий: последующую
риджбек: риджбек
воздух: воздуха
покупка: покупкой
глюкозамин: глюкозамином
одинаковый: одинаков одинаковым
спортивный: спортивного спортивные спортивных спортивными
бонус: бонус
кстати: кстати
толк: толку
он: нему
связь: связь
добавка: добавкам
разобрать: разобранному
сформировать: сформировать
разговаривать: разговаривать
внешность: внешность
немедленный: немедленному
единственный: единственный
мягкий: мягкой
изумрудный: изумрудного
лоб: лба
энергичный: энергичные энергичен энергичны
уметь: умеющий
отвечать: отвечает
бедро: бедра
пока: пока
дублин: дублине
рабочий: рабочий
ограничивать: ограничивает
внешний: внешние внешним
забор: забор
солдат: солдат
рвение: рвением
элегантный: элегантными
нижний: нижние нижней
давать: давать давайте
прижать: прижатую
сократиться: сократились
раздобыть: раздобыть
сбыться: сбылась
ситуация: ситуацию
заниматься: заниматься
быстрый: быстрый быстрее
вспыльчивый: вспыльчив вспыльчивы
подрастить: подрастите
лидерство: лидерство
психика: психика
выраженный: выраженно
лежать: лежит
тримминговать: тримминговать
смотреть: см смотрят
еда: едой
эмигрантка: эмигрантки
способность: способности
фотография: фотографии
травля: травля
развлечение: развлечений
помогать: помогает
невзирая: невзирая
щётка-пуходёрка: щетка-пуходерка
ассоциация: ассоциациями
обусловить: обусловленной
работать: работать работали
наглядно: наглядно
надолго: надолго
уход: уходе уход
непререкаемый: непререкаемый
неугомонный: неугомонному
вожделенный: вожделенную
бережный: бережное
складываться: складывается
страдать: страдать
результат: результат
клей: клеем
высокий: высокая высший высокий
озорной: озорному
присутствовать: присутствует
питомник: питомники питомника питомников питомник
объяснять: объясняя
разлив: разлива
вельш-фокстерьер: вельш-фокстерьерами
глаз: глаза глазах глазами
индивидуальный: индивидуальную
самый: самый самыми самое самых самые
вредный: вредную
морально: морально
скатываться: скатываться
прийтись: придется
вниз: вниз
легкоатлет: легкоатлетов
кинодром: кинодрому
усадьба: усадьбу
долгий: подольше
ус: усы
век: века
вести: вести
стриппинг: стриппинг
грань: гранью
поскольку: поскольку
мечта: мечта
краткий: краткая
умник: умник
компаньон: компаньона
база: базы
источник: источниками источников
любой: любого любую любые любой любым
отношение: отношение отношением отношению
бродячий: бродячими
отличительный: отличительные отличительная
место: место
систематический: систематическом систематическая систематические
поясница: поясницей
компания: компанию
апортировка: апортировку
основа: основ
край: края
сородич: сородичей
комплекс: комплекса комплексам
уроженец: уроженец уроженцев
приветствоваться: приветствуются
эксперт: экспертов
крупяной: крупяными
забывать: забываем
вконтакте: вконтакте
отказаться: откажется
свет: свет
впечатление: впечатление
детёныш: детенышей
лёгкий: легче
появиться: появившимися
щипальщик: щипальщика
поддержать: поддержать
разновидность: разновидности разновидностям разновидность
экономить: экономить
тазобедренный: тазобедренных
выдержка: выдержки
роль: роль
хозяин: хозяин хозяином
сообразительный: сообразительный
свежий: свежими
рыночный: рыночной
поставщик: поставщиков
волос: волос волосу
длина: длины длина
светлый: светлая
выбрать: выбрать
аниматор: аниматор
скула: скулы скулам
облик: облик
оценить: оцените
мясистый: мясистые
основать: основана
чёрный: черного черными
хотя: хотя
увлажнить: увлажненной
усваивать: усваивающие
х: х
кожа: кожу кожей
тримминговочный: тримминговочный тримминговочных тримминговочные
джек: джека
программа: программу
породный: породный породных
осмотр: осмотре
рот: ртом
порода: породам породы пород породами породу порода
хорошенько: хорошенько
заметный: заметный
ценник: ценником
жить: жил
драчун: драчунах
квартира: квартире квартиры
опыт: опыта
совершенство: совершенства
след: следу
мера: меру
ветер: ветер
мягкость: мягкости
информация: информация
обладать: обладает
охотник: охотник
телосложение: телосложение
оттенок: оттенков
групповой: групповые
сохраниться: сохранилось
невероятный: невероятные
субъективно-оценочный: субъективно-оценочны
палец: пальцами
преодолевать: преодолевать
авторитет: авторитет
остальной: остальных остальным
ниже: ниже
машинка: машинка
половина: половины
окрас: окрас окрасы
такой: такое такими
украсить: украшенными
крепкий: крепкие крепкая крепкими
одно-единственный: одно-единственное
нарост: наростами
ребёнок: детям
добавить: добавило добавьте
сравнительно: сравнительно
среди: среди
истинный: истинный
небольшой: небольшая небольшие
кудрявый: кудрявой
перевыполнить: перевыполнить
природный: природным природное
это: этим это
колено: колени
эффективно: эффективно
рыжик: рыжик
новый: новых
высоко: повыше высоко
длинный: длинные длинный длинной
считаться: считается
искатель: искателей
кто: кем
новичок: новичков
панибратство: панибратство
обучение: обучению обучение обучением
тревожный: тревожный
полный: полной полное
просто: просто
щеколда: щеколды
норматив: нормативы
диверсия: диверсиям
британский: британских
сдерживать: сдерживать
неизлечимый: неизлечимых
рыжевато-золотистый: рыжевато-золотистая
рыжий: рыжий рыжего рыжими рыжая рыжие
опираться: опираться
слиться: слился
мировой: мировой
простачок: простачок
метр: метра
лес: лесу
считать: считают
закрыть: закрыть
хулиган: хулиганов
запал: запалом
чистка: чистка
омускуленный: омускуленной
человек: человеку человека человек
сфера: сферы
собачий: собачьим собачьими собачьих собачьем
умеренный: умеренная умеренное умеренной умеренными
происхождение: происхождения
тёмный: темные
негласный: негласному
картонный: картонном
мышца: мышца
неприятный: неприятной
резец: резцы
необходимо: необходимо
готовый: готовы
щенячий: щенячью щенячьего
отзывчивый: отзывчив
задний: задние
редкий: реже
головоломка: головоломки
вид: вида виде видах
кобель: кобеля кобели
тщательно: тщательно
гончий: гончая
импортировать: импортировали
пятый: пятом
символический: символическим
высовывать: высовывать
дрессировка: дрессировка дрессировки
предплечье: предплечья
время: время
сука: суки суку
агрессивность: агрессивность
остров: острова
устроить: устроить
прикрыть: прикрыть
хрящ: хряща
требовать: требует
кисломолочный: кисломолочная
животное: животным животного животные животное
деятельность: деятельности
передний: переднем
пясть: пясти
кость: костей
недельный: недельном
другой: другие другими
просмотр: просмотров
использовать: используйте использовали
уступать: уступает уступали
аутосомно-рецессивный: аутосомно-рецессивным
русло: русло
служебный: служебными служебных
подкормка: подкормки
тянуться: тянется
отдельный: отдельные
например: например
грызть: грызть
отличный: отличная отличные
рост: рост
овладевать: овладевающий
коммерсант: коммерсант
балл: баллов
присущий: присущие
твёрдый: твердые
реклама: реклама
силуэт: силуэта
соответственно: соответственно
наклон: наклоном
плоский: плоский
важный: важную
лосьон: лосьоном
неплохой: неплохим неплохой
бегун: бегуны
секретный: секретную
траншея: траншей
применять: применяющие
типовой: типовой
крючок: крючки
насадка: насадкой
второй: второй
полагаться: полагается
автомат: автомате
окд: окд
воспитываться: воспитываются воспитывался
непосредственно: непосредственно
получиться: получится
направить: направить
подходить: подходили
воспитание: воспитание воспитании воспитанием
продолжительный: продолжительный
безусловно: безусловно
понятно: понятно
проводиться: проводится
работа: работы работу
выводить: выводили
правильно: правильно
хватка: хватку
засветиться: засветились
который: которыми которого которых которым которые который
оба: обоих
сбивать: сбивавшей
располагаться: располагается
сухой: сухие
сайт: сайту
появление: появлении
похвала: похвалу
позволять: позволяет
полезно: полезно
гипотиреоз: гипотиреоза
этот: эта
лишь: лишь
что-то: что-то
пытаться: пытается
вариант: вариант вариантом варианты
окружающий: окружающей
внимательный: внимательный
форум: форум форуме
натаскать: натаскать
пилотаж: пилотаж
хитреца: хитрецы
предпочтение: предпочтение
конец: конце конец концов
протяжение: протяжении
боком: боком
начало: начала начало началу
проходиться: проходитесь
прыгун: прыгуны
прочный: прочная
штаб-квартира: штаб-квартирой
наш: нашей
конечный: конечный
гдр: гдр
советовать: советуют
массивный: массивными
любитель: любители
сезонный: сезонная
эталонный: эталонного
обеспокоить: обеспокоенные
ровный: ровные ровной
близко: близко
значительно: значительно
шоу-класс: шоу-класса
плохой: худший
описание: описание описания
пласт: пласт
мужской: мужского
оценивать: оценивать
стандарт: стандартом стандарту стандарт
спокойный: спокойных
приход: приход
выставочный: выставочный выставочных
изгиб: изгиба
растрескаться: растрескавшейся
ринг: ринги
серьёзный: серьезный
короткий: короткое короткие
менять: меняющая
ответить: ответит
однако: однако
купировать: купировали
ненужный: ненужной
поэтому: поэтому
приступать: приступайте
пробежаться: пробежаться
копирование: копирование
дружелюбный: дружелюбная
активность: активность
развиваться: развиваться
родезийский: родезийский
общительный: общителен
русский: русская
дружелюбность: дружелюбность
увиливать: увиливать
попасть: попали
приподнять: приподнят
плавно: плавно
отзыв: отзывах отзывы
кошка: кошки кошками
кровяной: кровяному
следовать: следует
комплект: комплектом
сторожить: сторожить
массивность: массивность
отсутствие: отсутствии
эрдель: эрделем
просохнуть: просохнет
мимо: мимо
шум: шум
рекорд: рекорды
союз: союз
разовый: разовый
черта: черт черта
курсинга: курсинг
прочить: прочим
заводить: заводит
особь: особи особям особей
понарошку: понарошку
павильон: павильонах
выполнимый: выполнимая
процедура: процедуры процедура
сохранить: сохранили
верхний: верхние
квест: квеста
лениться: ленится
час: час часов
назад: назад
характерный: характерный
планировать: планируете
лето: летом
почему: почему
поначалу: поначалу
решить: решили решил
откровенный: откровенное
всерьёз: всерьез
нечасто: нечасто
настоящий: настоящий
осторожно: осторожно
интерес: интерес
дом: дома доме
костистый: костистые
мочь: могут могла
минимум: минимум
альдер: альдер
влияние: влияния
клубный: клубный
заполучить: заполучить
малыш: малышами малыши
всячески: всячески
ножницы: ножницами ножницы
организовать: организовал
целое: целом
объявление: объявления
сделать: сделать сделано
автопутешествие: автопутешествия
сложный: сложный
основной: основные
задача: задачами задача
интеллект: интеллект
охранный: охранные
вес: вес
своенравный: своенравного
план: план плане
нос: носа нос
разведение: разведение разведения
свой: своим своих
по-настоящему: по-настоящему
банный: банный
смех: смех
именно: именно
прочитать: прочитав
уходить: уходить
ответственность: ответственность
продолжительность: продолжительность
стрижка: стрижки
молодой: молодые
раж: раж
курс: курс курсе
пшенично-рыжий: пшенично-рыжая
самодостаточный: самодостаточная
трезво: трезво
вряд: вряд
обеспечить: обеспечить
высококлассный: высококлассных
короче: короче
сознание: сознании
пакет: пакетом
рельефность: рельефности
манускрипт: манускриптов
пробудить: пробудить
цвет: цвета
шампунь: шампунь
предпочитать: предпочитаете предпочитают
задира: задир
полотно: полотно
кинологический: кинологическими
мобильный: мобильна
размер: размера размеру
зависимость: зависимости
вещество: веществ
несколько: нескольких
депигментировать: депигментированная
основный: основными
шиповидный: шиповидными
принимать: принимать
слегка: слегка
идеальный: идеальном
исполнительность: исполнительностью исполнительность
иметься: имеются
фото: фото
доводить: доводят
отпугивание: отпугивание
прирождённый: прирожденные
пёс: пса
десятилетие: десятилетий
яндекс: яндекс
обращение: обращение
тренироваться: тренируется
болений: боленью
нечаянно: нечаянно
пройдоха: пройдохи
вперёд: вперед
терьерный: терьерной
череп: черепа череп
техника: техника
экстерьер: экстерьером
ставить: ставить
лапа: лапы лап лапу
выполнять: выполняющий выполняющего выполнять
холка: холке
незнакомец: незнакомцу
азартность: азартность
угол: углами
древний: древними
журнал: журнал
линия: линии линией
психотропный: психотропных
высота: высота
бегать: бегает
стиль: стиль
контактировать: контактируют
чей: чьи
страна: стране страну страна
клоун: клоуну
универсальный: универсальный
польский: польский
постав: постав
ванна: ванны
тот: та тех
покров: покров
болезнь: болезни
вызвать: вызвать
свирепый: свирепых
ухо: ушами уши
рытьё: рытью
выдрессировать: выдрессировать
традиционный: традиционного традиционные традиционный
одобрение: одобрении
заводчик: заводчиков заводчикам заводчики
совершенно: совершенно
чрезмерно: чрезмерно
работяга: работяги
активно: активно
развалиться: развалится
растянутый: растянутое
заболевание: заболевание заболеваний
охота: охоте
европейский: европейских европейскими европейские
придание: придания
подопечный: подопечным подопечному подопечного
исчезновение: исчезновение
обеспечивать: обеспечивают
увидеть: увидеть
сверкать: сверкать
заработать: заработать
признание: признание
комната: комнате
округлый: округлая
дог-фризби: дог-фризби
любовь: любви
белый: белой
подвес: подвеса
мускулистый: мускулистое
полезный: полезный
разобраться: разобраться
обязаловка: обязаловки
гоняться: гоняться
пролить: пролить
безотказный: безотказная
перекус: перекус
заметно: заметно
сгиб: сгиб
непредсказуемый: непредсказуемый
хвост: хвосты хвост
дело: дело
осветлить: осветленный
перейти: перейти
постараться: постарается
статус: статус
из-за: из-за
сосиска: сосиску
главное: главное
овощ: овощами
действие: действие
наследоваться: наследуется
стащить: стащить
аккуратный: аккуратного
маленький: маленькие
неожиданный: неожиданные
бородка: бородка бородку
менее: менее
покончить: покончено
сигнал: сигнал
пти-брабансон: пти-брабансон
надежда: надежду
вытянутый: вытянутые
спортивно-компаньонский: спортивно-компаньонский
потенциал: потенциал
джерри: джерри
грудь: груди грудь
требование: требования
заканчиваться: заканчивающимися
подзыв: подзыв
коттедж: коттеджи
адаптироваться: адаптируется адаптироваться
рассказ: рассказы
слишком: слишком
одиночество: одиночеству
обзавестись: обзавелись
подходящий: подходящих
виллебранда-диана: виллебранда-диана
стройный: стройными
клуб: клубом
мина: мин
запрет: запрет
купирование: купирования
зарегистрировать: зарегистрированных
день: день
ровно: ровно
габарит: габаритов
момент: моментами моменты
кольчуга: кольчуги
пузико: пузико
спина: спины спина
гигиена: гигиена
неистощимый: неистощим
провокатор: провокаторах
здоровый: здоровая здоровые
тихонько: тихонько
метод: методом
жильё: жилье
дёрганье: дерганье
ваш: ваш вашем ваша
свобода: свободы
оценка: оценке
уникальный: уникальный уникальным
рубль: рублей
птица: птицы
поле: полях
встретить: встретишь встретите
знакомый: знакомые
островитянин: островитянин
гора: горы
мочка: мочка
основательность: основательность
неплохо: неплохо
санитар: санитаров
испачкаться: испачкалась
правило: правило правила
уравнять: уравняло
выдумка: выдумки
наличие: наличии
изогнутый: изогнутыми
грумер-самоучка: грумеру-самоучке
зубной: зубной
прикус: прикуса
разумеется: разумеется
идти: идет
выйти: выйдет
делегировать: делегировать
разнообразить: разнообразить
фитоотвар: фитоотваром
соперник: соперники
стоимость: стоимость стоимости
удлинённый: удлиненные
приправить: приправленные
особенно: особенно
свернуть: свернет
отметина: отметины
браться: берется
ген: гена
жёсткий: жесткая
понаслышке: понаслышке
учебный: учебный
последний: последние
складка-оборка: складки-оборки
дефицит: дефицит
ороговеть: ороговевший
очертание: очертания
предельно: предельно
противоположность: противоположностью
достаточно: достаточно
обязательно: обязательно
входящий: входящая
селфридж: селфридж
ответ: ответов
любить: любите
промежуток: промежутках
преувеличить: преувеличены
иной: иного
непопулярность: непопулярности
накануне: накануне
пара: пару
показатель: показателям
подыскать: подыскать
возраст: возраста возрасте
негатив: негатив
перекрывать: перекрывают
путёвка: путевку
ушной: ушном ушное
неделя: неделю
группа: группе группы
производить: производит
расчесать: расчесанному
груминг: груминге
удирать: удирать
популярность: популярность
функция: функциями функцию
охотно: охотно
понимать: понимать
костюм: костюма
ходить: ходить
купить: купить
часто: часто
документальный: документальные
актёр: актеру
прямой: прямые
эра: эры
доходить: доходящие
излом: излом
укорачивать: укорачивать
проходить: проходит
некоторый: некоторое
желание: желание
малышня: малышни
стричь: стригут
осуществляться: осуществляется
раздвинуть: раздвинув
что: чему
дёшево: дешево
письменный: письменных
водоотталкивающий: водоотталкивающей
расплывчатый: расплывчатые
аджилить: аджилити
миссия: миссию
приверженец: приверженцы
обойти: обошло
деградация: деградацией
отечественный: отечественного отечественной
ссср: ссср
сожаление: сожалению
рассчитывать: рассчитывать
наказание: наказаниям
видеть: видела
живой: живой
охрана: охрана
подспорье: подспорьем
ирландия: ирландии ирландия
оказаться: оказалось
проблема: проблему проблема
обработка: обработку
мимикрировать: мимикрировать
отменный: отменное
правильный: правильным правильный
четверолапик: четверолапиками
открытый: открытых
далеко: далеко
одноклассник: одноклассники
интерьер: интерьером
кровь: кровь
реакция: реакцию
имиджевый: имиджевые
скорее: скорее
путём: путем
плотный: плотное
попутно: попутно
неимение: неимением
волосок: волоски
кабан: кабанами
правда: правда
здоровье: здоровья здоровье
представительница: представительница
работник: работник
сильный: сильной сильный сильные
случайный: случайные
кроме: кроме
плескаться: плещутся
мясо: мясо
кальцийсодержащий: кальцийсодержащим
вылазка: вылазку
кеннел-клуб: кеннел-клуба
каждый: каждая
любопытство: любопытство
советский: советского
доказательство: доказательством
регулярный: регулярные
частый: чаще
поиск: поиск
беспримерный: беспримерные
направление: направлению направлении
стремительный: стремительный
аналогичный: аналогичном
зуб: зубы
опускаться: опускается
густо: густо
ждать: ждал ждите
вязать: вязали
игнорировать: игнорирующая
служака: служаку
лишить: лишены
характер: характер
дьявол: дьяволами
закон: закону
образовать: образует
белые: белые
запастись: запаситесь
цепь: цепь
период: период
сажать: сажать
надвигаться: надвигающейся
трудяга: трудяги
окончательно: окончательно
неизвестный: неизвестном
пройти: пройдет пройти
реалия: реалиях
щётка: щеткой
скрыться: скрывшийся
чистый: чистому
дисплазия: дисплазии
дополнительно: дополнительно
впечатляющий: впечатляющие впечатляющим
первозданный: первозданным
учесть: учтите
потребность: потребность
порок: пороки
память: память
нуждаться: нуждаться нуждается
недокус: недокус
жизнь: жизни жизнь
абсолютно: абсолютно
гряз: грязе
освоить: освоить
воспринимать: воспринимает
выдающийся: выдающиеся
они: ними
круг: кругов
сильно: сильно
продукция: продукция
треугольный: треугольные
комондора: комондор
утончить: утонченный
путешествовать: путешествовать
заводиться: заводящийся
плечо: плечи
кучка: кучку
российский: российских
снисходительный: снисходителен
старинный: старинных
привязать: привязаны
издевательство: издевательства
предоставить: предоставьте
просторный: просторным
печенька: печеньку
лондон: лондона
выпад: выпады
успех: успехи
селить: селить
тушёный: тушеными
изоляция: изоляции
мимимишность: мимимишности
обывательский: обывательский
вызывать: вызывают
также: также
процесс: процесс
умный: умная
пластырь: пластырем
приятный: приятного
настроение: настроение
поставить: поставленные
шёрстный: шерстный
нарезание: нарезание
любимец: любимца
выуживание: выуживание
внутри: внутри
гордон: гордон
уважительный: уважительным
зелень: зеленью
корпус: корпус
рассматриваться: рассматриваются
некупированный: некупированный
умеренно: умеренно
пластиковый: пластиковом
стоить: стоить стоит
задачка: задачка
лакомство: лакомства
азартный: азартная
сложно: сложно
уживаться: уживается
крайне: крайне
повозиться: повозиться
частота: частоты
осуществлять: осуществляемой
ласка: ласку
заря: заре
схема: схемы
незнакомый: незнакомого
побороться: поборется
право: правах
пухлявость: пухлявости
отдых: отдых
затягивать: затягивать
караульная: караульные
топорщиться: топорщится
фоксом: фоксом
вполне: вполне
потренироваться: потренироваться
излишний: излишней
участок: участком участках
фронт: фронтах
фишка: фишек
чистить: чистящим
ранний: пораньше
невозможно: невозможно
барсук: барсука
стандартный: стандартные стандартным
стол: стола
профиль: профиль
сидение: сиденье
качество: качества
получить: получив получили
какой: какую
собрать: собрать
оберегать: оберегает
заинтересованность: заинтересованность
легко: легко
идеально: идеально
подравнивать: подравнивают
лента: ленту
производитель: производителей
преследовательский: преследовательских
похожий: похожа
глазго: глазго
чистопородный: чистопородных
перечисленный: перечисленное
премиум: премиум
глубокий: глубокой
котироваться: котировались
интенсивно: интенсивно
велосипед: велосипедом
возникать: возникает
теоретически: теоретически
конкретный: конкретных
игровой: игровыми
изучение: изучению
ловить: ловя
податливый: податливее
говорить: говорит
проделка: проделку
конкурент: конкурентов
примерный: примерного
царить: царившей
сила: силу
вакансия: вакансии
утратить: утраченных
приобрести: приобрела
площадка: площадки
рыжеволосый: рыжеволосых
приходиться: приходится
цель: цель
трансформироваться: трансформировался
полтора: полтора
непревзойдённый: непревзойденные
филировочный: филировочные
уничтожение: уничтожению
чистокровный: чистокровных
тренировка: тренировок
достоинство: достоинства
посильный: посильная
скиджоринг: скиджоринг
попытаться: попытались
выше: выше
сценарий: сценарию
потребоваться: потребуются
комплекция: комплекция
обойтись: обойтись
удобно: удобно
каркас: каркасе
мозолистый: мозолистыми
утверждение: утверждения
настежь: настежь
утвердить: утвержденные утвержденных
покрыть: покрытые
распахнуть: распахнутые
корм: корма
понятие: понятиями
узнать: узнала
прочёсывание: прочесыванием
рейтинг: рейтинг
генетический: генетических
ученик: ученики
дефект: дефекты
объём: объем
спектакль: спектакль
вернуть: вернуть
освежаться: освежалась
подписываться: подписывайтесь
великий: великой
обуздать: обуздать
купироваться: купируется
соответствующий: соответствующего
секьюрити: секьюрити
означать: означает
наклонность: наклонностям
запретить: запрещено
очень: очень
обычно: обычно
всевозможный: всевозможные
упоение: упоением
дополнительный: дополнительными
бок: бокам
декоративный: декоративной
исток: истоки
помощник: помощников
будка: будку
пощипывать: пощипывают
наоборот: наоборот
ручной: ручная
кличка: клички
супернянька: супернянька
довольно: довольно
частность: частности
прежде: прежде
прививка: прививок
отыскать: отыскать
тряпочка: тряпочкой
малозаметный: малозаметные
возможность: возможность
касаться: касается
документ: документов
одновременно: одновременно
взрослый: взрослых
желтоватый: желтоватый
соображать: соображают
проект: проекте
продолжать: продолжают
начать: начатое
необходимый: необходим
кг: кг
примитивный: примитивнейший
подставлять: подставляет
трюк: трюк
полгода: полгода
среднее: среднего
минимальный: минимальная
линька: линька
перчатка: перчатки
фрукт: фруктами
рацион: рацион
лепреконовый: лепреконов
керри-бить: керри-блю
дверь: двери
туловище: туловище
потенциальный: потенциальные
низко: низко
темперамент: темперамент
гонка: гонкам
уголок: уголке
любимый: любимым
профи: профи
обходиться: обходятся
снижаться: снижаться
личность: личности
сустав: суставов
непросто: непросто
меняться: меняется
пиарить: пиарили
влюбиться: влюбилась
связный: связных
причём: причем
запустить: запущенным
полноценно: полноценно
представить: представить
недостаток: недостаток
плюсна: плюсны
давно: давно
боковой: боковое
родитель: родителей
ширина: ширина
выщипывать: выщипывают
кормление: кормление
конечность: конечности
свободный: свободное
традиция: традиций
передать: передал
циркуляция: циркуляцию
привезти: привезена
перевоплощение: перевоплощения
являться: является
огородить: огороженным
допуск: допуск
пряник: пряника
ограничиваться: ограничиваясь
выбор: выборе
трусливость: трусливость
случай: случае
негативный: негативные
хондроитин: хондроитином
соплеменник: соплеменников
г: г
феноменальный: феноменальные
трилистник: трилистников
объёмный: объемными
недуг: недуг
царапина: царапин
подрезать: подрезать
бег: бег
темпераментный: темпераментный
толщина: толщины
ощупывать: ощупывать
