уход: уход уходе
теряться: теряются
охотничий: охотничья охотничьими охотничьим охотничьи охотничьих
заячий: заячий
регулярный: регулярные
век: веке век века
сам: сами самой
процесс: процессе процессу
необязательно: необязательно
гончатник: гончатники гончатников
пёс: пес
овощ: овощи
частый: чаще частых
близкий: близкой
приподнять: приподнятом приподнять
хвост: хвостом хвосты хвоста хвост
поиск: поиск
делать: делают делает
встреча: встречи
обязательство: обязательства
принципиально: принципиально
поразговаривать: поразговаривать
тело: тела
кровь: крови кровей кровь
наблюдение: наблюдениям
противоречить: противоречит
средний: средняя среднее
витамин: витаминов
принцип: принципе принципы
положение: положении положение
оптимальный: оптимальный
скот: скота
лимонно-пегий: лимонно-пегий
содержаться: содержалось содержится
опыт: опыт опытом
клетчатка: клетчатки
тазобедренный: тазобедренного
зуб: зубы зубов
вообще: вообще
нагружать: нагружайте
пугать: пугает
молодой: молодым молодая
выдающийся: выдающееся выдающимся
джентльмен: джентльмены
собака: собака собаку собакам собаке собакой собак собаки
паратый: паратая паратой паратых паратую паратые
собственно: собственно
питомец-компаньон: питомцев-компаньонов
цвет: цвета
сменить: сменит
использоваться: используются
сколько: сколько
лисий: лисий лисья лисьих лисью лисьей
британский: британские британская британских британской
седло: седлом
полотно: полотно
символ: символов символом
объясняться: объясняется
парфорсный: парфорсных парфорсная парфорсной
размер: размера
уходить: уходит
климат: климату
уютный: уютно
характер: характер характере характером
жить: жил живут жить живет
название: название названия
впитать: впитали
квартира: квартире
положить: положены положено
некоторый: некоторые некоторым
бонапарт: бонапарта
себя: собой
основный: основная
притязание: притязания
примерно: примерно
терьер: терьеров
наладить: наладить
нора: нору
ржаной: ржаные
массив: массивах
англичанин: англичанин англичанами англичан
набок: набок
стандартный: стандартного стандартный стандартные
присутствовать: присутствуют присутствовали
период: период периоды
гончая: гончие
бороться: бороться
информация: информация
помощь: помощи
охотник: охотник охотники
приятный: приятный приятных приятен
дотошность: дотошностью
преследование: преследование преследования
королевство: королевства
будка: будка
ребятня: ребятни
продукт: продукт продуктами
любимый: любимая любимых
справляться: справляются
гончий: гончую гончей гончая гончих
рабочий: рабочей рабочие рабочий рабочую
обсуждение: обсуждения
отношение: отношениях отношение отношения
явление: явление
максимально: максимально
рукавица: рукавицей
миска: миску
английский: английской английских английским английские английская английского английский
собака-молчун: собак-молчунов
ротовой: ротовой
селезёнка: селезенка
цена: цена
фото: фото
любой: любую любые
затея: затея
чутьё: чутье
короткий: короткая короткие
спрашивать: спрашивайте
фоксхаунд: фоксхаундов фоксхаундам фоксхаунд фоксхаунды фоксхаунда фоксхаундом
служба: службу
щётка: щеткой щетке
представлять: представляла
невысокий: невысокие
сначала: сначала
чутьистый: чутьистая
сука: сука суки
сделать: сделано
гипертрофированный: гипертрофированного
ребро: ребра
запах: запахом
материал: материалов
племенной: племенные
оболочка: оболочкой
самый: самое самых самая
наскок: наскокам
специалист: специалистов специалисты
завалить: заваленным
гигиенический: гигиенические гигиенических
радость: радость
потребность: потребность
сустав: суставами сустава
крупный: крупного крупными
окрас: окрас
спокойный: спокойнее
лис: лис лисы
порок: пороки
обитание: обитания
стандарт: стандарту стандарт стандарта
влиять: влияет
яндекс: яндекс
защищать: защищающая
ушной: ушное ушными
интервал: интервале
перекрывать: перекрывает
крепкий: крепкие
давать: дают
аристократия: аристократии
создавать: создавая
имиджевый: имиджевого
книга: книги
мчаться: мчащейся
внезапный: внезапным
источник: источники
польза: пользу
нести: нести
след: след
жизнь: жизни
упрямиться: упрямится
остальной: остальном
взять: взят
выглядеть: выглядеть выглядели
охотиться: охотятся
приставала: приставалу
силиконовый: силиконовой
стоять: стоят
причина: причин
хотеть: хотите
дом: дом дома
сторона: стороны
минимум: минимума минимум
они: ними
долгий: дольше
дисквалифицировать: дисквалифицирующие
череп: черепа
слабый: слабые
бретонский: бретонский
сильно: сильно
пятно: пятнами
налагать: налагает
экстерьерный: экстерьерные
поместить: поместить
состав: составы
крупа: крупы
власть: власти
техника: техника технику
категорически: категорически
поголовье: поголовье
план: планах
изысканно: изысканно
ненастье: ненастье
ребёнок: детьми
мешать: мешает мешают
побегать: побегать
лапа: лапы
низкий: низкими низкая
который: которых которым которая которые которой который
спина: спиной спине спину
выраженный: выраженной
качественный: качественная
россия: россия
такой: такую таким таких такие
холка: холке
обильно: обильно
обратный: обратная
всё-таки: все-таки
распространить: распространенное
затем: затем
жир: жиром жиры
великобритания: великобритании великобритания
длинный: длинные
считаться: считается
мыть: мыть
вид: виде
способность: способностями
пшеничный: пшеничные
предварительно: предварительно
радужка: радужки
журнал: журнал
наполеон: наполеона
линия: линии
мероприятие: мероприятия
представитель: представителей представители
группа: группы группе
нагонка: нагонки
благополучно: благополучно
подготовка: подготовка
вредитель: вредителей
покрыть: покрыть
высота: высота
охранник: охранник
подход: подходе
находиться: находится
загрязнение: загрязнения
ваш: ваше вашей
что-то: чем-то
шея: шея
просто: просто
изгиб: изгибом
профессиональный: профессиональный
мало: мало
шерсть: шерсть
пара-тройка: пара-тройка
решительность: решительность
мировой: мировую
человек: людей
призвать: призваны
зелень: зелень
надоедливый: надоедливые
нуждаться: нуждаются
специально: специально
нужно: нужно
мимимишность: мимимишности
запрет: запрета
полезный: полезных
наказывать: наказывают
отапливать: отапливаемое
укрыться: укроется
также: также
пророщённый: пророщенные
рекордный: рекордными
больший: большие
челюсть: челюсти
готовить: готовить
небольшой: небольшого
должный: должны должна должно
злоумышленник: злоумышленника
первый: первое первых первые первым первую
хозяин: хозяину
обычный: обычной
бактерия: бактерий
сушка: сушка
потомство: потомства потомство
снижать: снижают
отпустить: отпустить
породный: породного
учитывать: учитывая
болезнь: болезни
энциклопедия: энциклопедии
цель: цели
момент: моменты
локация: локацию локации
выход: выходом
повышенный: повышенная
сюда: сюда
нужный: нужный нужным
нерафинированный: нерафинированным
предлагать: предлагать предлагают
попасться: попавшимся
кормить: кормят
ухо: ушами ухо ушей
домашний: домашней
возникнуть: возникнет
ориентировать: ориентированные
дополнить: дополнены
лиса: лиса
мощный: мощные
ножка: ножки
отзыв: отзывы отзывах
лесополоса: лесополосе
вывести: выведена
морда: мордой
территория: территории территорию территорией
либо: либо
животное: животные животным животных
домик: домик
пахнуть: пахнущем
одеваться: одеваться
иметься: имеется
контакт: контакт
старший: старшего старших
сера: серу
корпус: корпус
добавить: добавьте добавить
активно: активно
сырой: сырыми сырой сырую
совпасть: совпало
погоня: погоне погоня
допустимый: допустимую
прогулка: прогулки прогулках
охранный: охранную охранные
темп: темпа темпами
обязательный: обязателен
образ: образом образ
умеренный: умеренная умеренными
происхождение: происхождения
изматывать: изматывающую
охота: охоте охоту охота охоты
важно: важно
держать: держите держать
квалификация: квалификации квалификацию
тёмный: темным темные
обучаться: обучается
готовый: готовы
гончак: гончак гончаки гончаков
первоначальный: первоначальную
удлинённый: удлиненной
пушистик: пушистиками
идеальный: идеальна
отрасти: отросшие
гнать: гонят
исключение: исключения
история: история
исчезновение: исчезновение
брать: брать берет
лёгкий: легкие
гипотиреоз: гипотиреоз
внимательно: внимательно
светлеть: светлеет
щенок: щенка щенки щенков щенкам
свой: своем
умчаться: умчится
команда: команда команды
заведомо: заведомо
дисквалификация: дисквалификации
проход: прохода
альтернатива: альтернатива
зверь: зверя
отварный: отварном
выгул: выгул
поощрять: поощряют
лакомство: лакомства
тщательно: тщательно
кобель: кобеля кобели
деятельность: деятельность
овсяный: овсяные овсяная
сложно: сложно
гладкий: гладкая
создать: создана создать
морозный: морозную
развлечение: развлечение
производительница: производительницы
повозиться: повозиться
классический: классическая классической классическую
дрессировка: дрессировка дрессировке дрессировкой
американский: американском американский
стоить: стоит
это: это
время: время
истинно: истинно
дикий: дикие
следовать: следовать
паста: пасте
поимка: поимка
массивный: массивные
разный: разных
питомец: питомцев питомца питомцем питомцам питомцу питомец
инфекция: инфекциями
дать: данные дали
испачкаться: испачкался
эпилепсия: эпилепсия
обучение: обучении
комфортный: комфортную
агрессивность: агрессивность
брыть: брыли
любить: любит
банхар: банхар
ставить: ставит
уговорить: уговорить
вести: ведет вести
горизонт: горизонт
помета: пометах
товарищ: товарищей
желудок: желудки
заметно: заметно
характеристика: характеристика
подросток: подросток подросткам
щенячий: щенячьего
главный: главных главная
румяна: румянах
выставочный: выставочные
другой: другие других другими
сельский: сельский
большой: побольше
взросление: взросления
сведение: сведению сведениям
этап: этапах
физически: физически
плоский: плоские
скопировать: скопирует
превратиться: превратилась
зарождение: зарождения
слух: слуха
фенотип: фенотип
перейти: перейти
забор: заборы
полагаться: полагалось
тушить: туши
поставить: поставить поставленной
кельтский: кельтской
мера: мере
толстый: толстые
реально: реально
загонять: загоняя
камень: камня
пегий: пегая
обиженный: обижен
подразумевать: подразумевает
труднодоступный: труднодоступном
недуг: недуги
например: например
эпаньоля: эпаньоль
место: местах месте места место
главное: главное
невозможно: невозможно
послать: пошли
категория: категорию категорий
убрать: убрать
хорьковый: хорьков
сытно: сытно
порода: породе пород породы порода породой
максимум: максимум
рост: рост
легкоусваивать: легкоусваиваемые
своевременно: своевременно
коготь: когтей
значит: значит
облаять: облаять
возможный: возможных
качество: качества качество
считать: считает
быстро: быстро
молоко: молоком молоко
вислоухий: вислоухих вислоухие
скакательный: скакательными
входить: входят
сезон: сезон
игнорировать: игнорирует
менее: менее
чистый: чистых
кмч: кмч
прочь: прочь
еда: еду еде
корнеплод: корнеплоды
твёрдый: твердые
нестомчивость: нестомчивости
уровень: уровне
усилить: усилить
раз: раза
помимо: помимо
видео: видео
клан: клана
соответственно: соответственно
получить: получите получили
гон: гоном гон
шакал: шакалов
реклама: реклама
свора: своре сворой
лисогон: лисогона лисогоны
легко: легко
свойственно: свойственно
вероятный: вероятного
выступать: выступающей
помпезный: помпезное
по-своему: по-своему
неуклонно: неуклонно
быстрый: быстрой
генетический: генетическом
лента: ленту
переход: переходом
аристократический: аристократическое
внимание: внимания
организм: организм организма
полностью: полностью
очередь: очередь
здоровье: здоровье
никакой: никаких
блестящий: блестящего
подходящий: подходящего
основа: основу
звериный: звериным
мелкий: мелкой
быть: будьте
грубый: грубая
кардиомиопатия: кардиомиопатия
плохой: плохой
эксперимент: эксперимент
известно: известно
свинка: свинок
приемлемый: приемлемая
согревание: согревание
снижаться: снижается
спускать: спускать
отсутствие: отсутствие
провалиться: провалился
закон: законам законы
болтушка: болтушку
слишком: слишком
огородить: огороженной
одиночество: одиночеству
привлекать: привлекали
часть: частью часть части
спокойно: спокойно
владелец: владельца владельцев
получиться: получится
помещение: помещение
воспитание: воспитание
внутрь: внутрь
внимательный: внимательного
обладание: обладание
год: лет году
подрезать: подрезайте
трение: трений
зимой: зимой
масса: массу
бульдожина: бульдожиной
округлый: округлых округлые
лошадь: лошадей лошадях
работа: работы работе работу
желток: желток
перенимать: перенимать перенимая
делиться: делятся
лопатка: лопатками
называть: называют
малоподвижный: малоподвижной
сократить: сократив
месяц: месяцев
забыть: забыть
слуховой: слухового
содержание: содержание содержания
ген: гены
день: день
ровно: ровно
сдобрить: сдобренных
габарит: габаритов
хороший: хороший хорошее лучшие
немного: немного
белый: белый
приучать: приучать
сайт: сайту
гигиена: гигиена
промыть: промытые
терпеть: терпит
сила: силу
колония: колонии
весёлый: веселом
разновидность: разновидностей
полный: полного
вывозить: вывозили
город: городу
выжловка: выжловки
конфликт: конфликтов
вакансия: вакансии
рекомендовать: рекомендуют
подключать: подключают
всматриваться: всматривающиеся
физиологический: физиологические
неподходящий: неподходящих
неподготовленный: неподготовленные
схема: схеме
настойчиво: настойчиво
жаркое: жаркому
ноздря: ноздрями
оценка: оценке
высадиться: высадилась
рпг: рпг
прикус: прикус
дама: дамы
исполнять: исполняет
расположить: расположенными
загородный: загородная
родина: родине
затрачивать: затрачивает
долго: долго
опытный: опытные
появиться: появились
репутация: репутацией
выносливость: выносливости
мир: мира
масло: масло маслом
коллектив: коллективов
форум: форум форуме
вроде: вроде
эмоциональность: эмоциональность
кстати: кстати
печень: печень
связь: связь
хрящ: хрящи
разведение: разведения разведение
мочка: мочка
стоп: стопом
протяжение: протяжении
увлечь: увлеченный
убегать: убегают
выжляк: выжляки
преследовательский: преследовательского
полость: полости
выше: выше
данный: данный
постный: постное
требовать: требуют
расцениваться: расценивается
характерный: характерным
индийский: индийские
живой: живых живым
порой: порой
зубной: зубной зубного
собираться: собирались
интеллектуальный: интеллектуальными
салат: салатов
сливочный: сливочное
внешне: внешне
чересчур: чересчур
добавлять: добавляйте
радужный: радужной
временной: временным
столетие: столетия столетии
соответствовать: соответствующим
пока: пока
помахать: помахать
выезд: выезда выездами выезды
происходить: происходило
старый: старой старая
воздух: воздух воздуху
воронка: воронку
признак: признак
выставка: выставке
поскуливание: поскуливанию
абсолютный: абсолютного
совершенный: совершенной
один: одна
описание: описание
собачий: собачьего собачьих
австралия: австралии
практически: практически
обладать: обладают
природный: природная
начало: начало
стоимость: стоимость
рейтинг: рейтинг
яйцо: яйца
среда: среду
лай: лая
оценивать: оценивать
уживчивый: уживчивым
дважды: дважды
ряд: рядах
аристократ: аристократ
иначе: иначе
вестись: велось
общеизвестный: общеизвестный
скорый: скорое
длина: длину
плембрак: плембрак
подписываться: подписывайтесь
посторожить: посторожить
неприхотливый: неприхотлива
проследовать: проследовать
лесной: лесных
спортивный: спортивные
перловый: перловая
миролюбие: миролюбии
карий: карего
симметрично: симметрично
зрелище: зрелище
гречневый: гречневая
изнеможение: изнеможения
сокращаться: сокращаться
сильный: сильные сильным сильной
самостоятельно: самостоятельно
однако: однако
достаточно: достаточно
кошка: кошках кошки
исторический: исторической
плотно: плотно
опция: опцию
обязательно: обязательно
вентилировать: вентилируйте
побережье: побережье
куриный: куриного
дело: делу
отличаться: отличаются
взбивать: взбивают
запретить: запрещено
удалять: удаляйте
почка: почек
сухарик: сухарики
свободный: свободный
длительный: длительную
особь: особей особи
очень: очень
поэтому: поэтому
обычно: обычно
заводчик: заводчики
явный: явные
ладить: ладит
накануне: накануне
людный: людных
плановый: планового
незнание: незнанию
кропотливый: кропотливого
стружка: стружки
истребление: истребления
очертание: очертаний
поводок: поводка поводке
смотреть: см
вторгнуться: вторгшегося
бывать: бывают
впитывать: впитывает
копирование: копирование
возраст: возраста возрасте возраст
монарх: монарха
методика: методики
свинина: свинина
произойти: произошло
филейный: филейные
фотография: фотографии
городской: городского
активность: активность
наиболее: наиболее
неделя: неделю
единичный: единичные
специальный: специальные
невероятный: невероятную
русский: русская
соединить: соединенного
говяжий: говяжьим
дружелюбность: дружелюбность
счищать: счищать
укреплять: укрепляющую
наоборот: наоборот
постепенно: постепенно
поведенческий: поведенческими
орган: органы
доступ: доступ
кличка: клички
черта: черта
правило: правила правилам
охотно: охотно
англия: англии
заниматься: занимаются
довольно: довольно
белок: белков
нога: ноги
противник: противники
набирать: набирающим
иметь: иметь имеющие имея имеют
результат: результат
удалённый: удаленных
облизывание: облизыванию
высокий: высокая высокий
список: список
купить: купить
питомник: питомники питомников
часто: часто
плотный: плотные плотная
съедать: съедает
свидетельствовать: свидетельствуют
восторженный: восторженному
перепрыгивать: перепрыгивая
козий: козье
глаз: глаза
квадратный: квадратной
взрослый: взрослом
ореховый: орехового
перемещение: перемещения
обзаводиться: обзаводиться
леонбергер: леонбергер
углевод: углеводах
прийтись: придется
оказаться: оказаться
шум: шум
подлежать: подлежат
натуральный: натуральными
заболевание: заболеваний
одновременно: одновременно
масть: масть
сметана: сметана
соответствующий: соответствующие
продуктивный: продуктивными
проходить: проходит
рожать: рожала
прочить: прочим
ошибка: ошибок
шотландский: шотландский
проект: проекте
канада: канаде
сразу: сразу
быт: быту
грудной: грудной
ножницеобразный: ножницеобразную
сказать: сказать
отдать: отдать
сохранить: сохранили
свежий: свежую
разводить: разводили
чистка: чистку
отличие: отличие
эстетично: эстетично
голова: голова
позаппрошлое: позаппрошлого
поскольку: поскольку
предсказывать: предсказывающих
контролировать: контролируйте
кончик: кончики
кг: кг
зерно: зерна
широкий: широкой
краткий: краткая
промежуток: промежутком
переходить: переходили
назад: назад
конец: конец
лицо: лица
оттенок: оттенка
родственница: родственницей
автомагистраль: автомагистралей
хилый: хилым
безоговорочный: безоговорочной
почему: почему
линька: линька
грейхаунд: грейхаундов
сеттер: сеттер
ответ: ответ
поясница: поясницей
морской: морских
строение: строению
настоящий: настоящий
малыш: малышей
костистый: костистые
сегодняшний: сегодняшний
галоп: галоп
уделять: уделяйте
страна: страна
рф: рф
сородич: сородичей
прямой: прямой
эксперт: экспертов
суровый: суровую
инстинкт: инстинкта
прежний: прежних
уязвимый: уязвимыми
факт: факт
известность: известность
клетка: клетки
разводиться: разводится
голос: голоса
забрасываться: забрасывается
стая: стае
сердце: сердце
ружьё: ружья
малолетний: малолетнего
вконтакте: вконтакте
прятать: прятать
целое: целом
шерстинка: шерстинки
объявление: объявления
медленно: медленно
повторение: повторения
ценить: ценят
бульдог: бульдогов
нарушение: нарушениями
основной: основные
развить: развитая
приучить: приучена приучить
ситуация: ситуации
весь: всем
встроить: встроенную
интеллект: интеллект
выслеживание: выслеживание
патология: патологии
прыгучесть: прыгучесть
средне: средне
культура: культуры
давно: давно
вес: вес
отличительный: отличительная
энергия: энергии
одноклассник: одноклассники
возникновение: возникновение
типичный: типичная
отвести: отведенными
ступенька: ступеньку
незлоблив: незлобливом
скорее: скорее
вольер: вольер
временно: временно
осуществляться: осуществляться
подспорье: подспорье
охрана: охране
кормление: кормление
маленький: маленьких
подготавливать: подготавливать
сша: сша
являться: является
появление: появления
серьёзный: серьезном
водить: водите
дисплазия: дисплазия
постараться: постарайтесь
мочь: можете
правда: правда
висячий: висячее
средневыраженный: средневыраженным
скорость: скорость
уловить: уловить
немногочисленный: немногочисленных
нашествие: нашествием
выбрать: выбрать
процедура: процедурах
развивать: развивают
проблема: проблема
именно: именно
конструкция: конструкцию
местный: местные
рогатый: рогатого
среднестатистический: среднестатистического
побег: побегах
случайный: случайные
отклонение: отклонения
нежность: нежностям
луг: лугах
случай: случаи
кроме: кроме
способный: способны
основать: основана
мясо: мясо
чёрный: черного
удивление: удивление
хотя: хотя
сбалансированный: сбалансированные
позволить: позволит
кот: котом
голосисто: голосисто
продолжительность: продолжительность
сжатый: сжатые
добродушный: добродушный
зима: зиму
подмешиваться: подмешивались
провальный: провальная
усадьба: усадьба
шаг: шаг
погибать: погибали
