ясно: ясно
туалет: туалет туалету
придать: придать
процесс: процессе
подстригать: подстригать
дисквалификация: дисквалификация
американский: американских американском
кровь: крови
чистопородный: чистопородные чистопородных
гребень: гребня
фу: фу
мимика: мимику
полотенце: полотенце
посторонний: посторонних
сколько: сколько
миссия: миссия
название: название названием названия названии
продвинуть: продвинуть
фон: фон
собака: собаку собаками собакой собак собака собаке собаки
округлый: округлой
открытый: открытом открытым
состоять: состоит
пошалить: пошалить
обсуждение: обсуждения
сушка: сушке сушкой сушка
вернер: вернера
оно: оно
цена: цена цену
зачастую: зачастую
подушечка: подушечки подушечек
генетический: генетические генетический
материал: материалов
перевод: переводе
фридхек: фридхек
расчёска: расческой расчески
гипертермия: гипертермия
излишек: излишки
разрушитель: разрушителей
стоять: стоят
дисквалифицировать: дисквалифицирующие
близкий: ближайшие ближайшим
семейство: семейства
любознательный: любознательной любознательный
подсохнуть: подсохшую
расчёсывание: расчесывании расчесыванием расчесывания
зато: зато
россия: россия
живот: живот
миска: миска
обратный: обратная
итог: итоге
жкт: жкт
хмурить: хмурить
тон: тоном
предварительно: предварительно
приводить: приводить приводят
представитель: представителей представителя представители
команда: команду команда
попробовать: попробовать
преобладать: преобладать
шея: шея
йорк: йорки йорка йорков
особенность: особенностью особенность
шерсть: шерсть шерсти шерстью
компаньон: компаньоны компаньону
репейный: репейное
интеллектуальный: интеллектуальное интеллектуальными
документ: документы
шаг: шага
одиночество: одиночества одиночеству
режим: режимов режим
должный: должны должен должно
несложно: несложно
свет: свете свет
взгляд: взгляд
тренд: трендом
неофициальный: неофициальное
холодный: холодный холодным
нести: неся
чёрный: черные черного
мечтать: мечтающих
человек: людям людей человеком
месяц: месяц месяцев
домик: домик
анальный: анального
назвать: назвать названный
равно: равно
пинчер: пинчер
знакомиться: знакомьтесь
опознавательный: опознавательный
важно: важно
обаяшка: обаяшка
трехцветной: трехцветных трехцветным трехцветные трехцветная
бежать: бежать
встретить: встретить
история: история
пышный: пышный
бьюти-процедура: бьюти-процедур
дополнить: дополненный
промышленный: промышленные
год: годами годы годах года лет году
щенок: щенка щенков щенки щенок щенке щенку
суперпремиум: суперпремиум
фру-фру: фру-фру
нормально: нормально
покупать: покупая
миловидный: миловидной
питомец: питомцев питомцу питомец питомцы питомцам питомца
ринг: ринг
форма: форма форме формы
особый: особое
голова: голове головы голова
метис: метисами
нередко: нередко
попасть: попасть
платье: платье
характеристика: характеристика
немецкий: немецкий немецких немецкая
быть: е будьте будут
выставка: выставках выставок выставку
прикус: прикусов
день: дню дня
дом: дому дом доме
экземпляр: экземпляры
зарождение: зарождения
купание: купания купаниях
мордашка: мордашкой
пахнуть: пахнет пахнуть
пол: пола полу
вид: виды вид
общение: общению
порода: породе породам породы породу порода породой
десна: деснами десны
многолюдный: многолюдных
спина: спине спиной
гипоаллергенный: гипоаллергенным
палец: пальцы
быстро: быстро
немногочисленный: немногочисленного
менять: меняет
жестикуляция: жестикуляцию
чисто: чисто
поколение: поколения
альтернатива: альтернативу
раз: раза
помимо: помимо
видео: видео
псовый: псовым
использоваться: использоваться
узнать: узнал
подопечный: подопечной подопечные подопечных
разрешаться: разрешается
внимание: внимания внимание
деструктивный: деструктивное
полностью: полностью
никакой: никаких
условие: условии
улица: улицу
домашний: домашних домашнего
ниспадать: ниспадающий ниспадающая
шоу-потенциал: шоу-потенциалом
провоцировать: провоцирующее провоцирует
разрешить: разрешенные
остаток: остатков
владелец: владельца владельцев владельцы
такой: таких такие
серп: серпа
интернет: интернете
содержание: содержание содержания
ген: гены
переключение: переключением
исполниться: исполнилось
попытка: попытки
слово: слово
больший: наибольшее
йоркширский: йоркширского йоркширских
запрещать-то: запрещать-то
жить: живет
защита: защиты
пет-категория: пет-категории
гертруда: гертруды
подобрать: подобранный
падение: падениях
риджбек: риджбек
масло: масло
первичный: первичный
нарядность: нарядности
супружеский: супружеской
кстати: кстати
сладость: сладостей
связь: связь
сваливаться: сваливается сваливаться
уделять: уделять
ходить: ходят ходить
финальный: финальный
убедиться: убедиться
задействовать: задействуйте задействован
химия: химия
стоячий: стоячих стоячие
частичка: частички
постричь: постригли
лоб: лба лбу
придавать: придающий
вынужденный: вынужденного
пообедать: пообедали
пока: пока
стать: стали
создаваться: создается
сводистый: сводистые
полный: полная
состояние: состоянии
голосовой: голосовому голосовыми
перхоть: перхоть
структура: структуру
мир: мир
выдавать: выдают
впитать: впитало
протирать: протирать
сладкий: сладкая
милашка: милашки
признание: признания признании
спортивный: спортивные
заниматься: заниматься
плотно: плотно
поднять: поднятым
подсушивать: подсушивают
именитый: именитых
постоянный: постоянным постоянное
ежедневный: ежедневном ежедневного ежедневным
заварить: заваренным
качество: качестве качеству качества
аллергический: аллергическими
металлический: металлическими
смотреть: см
крепко: крепко
фотография: фотографии
потешно: потешно
ассоциация: ассоциациями
уверять: уверяли уверяют
расти: растут
хороший: хорошие хорошими хорошее
уход: уходе уход
помнить: помните
поражать: поражать
высокий: высокая высоким высокий
питомник: питомники
пара: пары
переносить: переносят
глаз: глаза глазами
район: районе
самый: самый самыми самые
классический: классическому классический
прийтись: придется
понятие: понятие
корм: корм корма
масть: масть
решиться: решились
морда: морды
часть: части
сделка: сделку
ветеринарный: ветеринарным
остальной: остальными остальные остальном
поведение: поведению поведение
реакция: реакция реакцией реакциями
поскольку: поскольку
краткий: краткая
появление: появлением
отношение: отношение отношения
кухня: кухне
место: место местах месте
поясница: поясницей
малыш: малышей малыши малыша
исключительно: исключительно
пойти: пошел
сородич: сородичей сородичи
игривость: игривость
эксперт: экспертов
купать: купать
факт: факт
бытовой: бытовая
шерстинка: шерстинок
предпочитать: предпочитающим предпочитает предпочитают
останавливать: останавливайте
вконтакте: вконтакте
совершать: совершать
впечатление: впечатление
передом: передом
бивер-йорк: бивер-йорк бивер-йорка бивер-йорках
создать: создать
ласковый: ласковы
прогрессировать: прогрессирующая
хозяин: хозяин хозяина хозяева
отчаянный: отчаянный отчаянные
обойтись: обойдутся
подбиральщик: подбиральщики
шубка: шубки
французский: французского
регистрация: регистрации регистрацию
животное: животных животным животного животное
уникальный: уникальная уникальным
хлопчатобумажный: хлопчатобумажное
одинаково: одинаково
преувеличение: преувеличений
сша: сша
породный: породная породной
земля: земле земли
хвостик: хвостика хвостик
адекватно: адекватно
волос: волос волоса
раскапывание: раскапыванию
длина: длины длина
выбрать: выбрать
оборудовать: оборудовать
аксессуар: аксессуару
основать: основана
шёрстный: шерстного
хотя: хотя
дисциплинировать: дисциплинирует
плембрак: плембраком плембрак
ножницеобразный: ножницеобразные
порядок: порядок
х: х
серьёзный: серьезные серьезными
внутренний: внутренний
гиперактивный: гиперактивные
безопасный: безопасную
доза: дозой
сам: сами самой сама самом
хвост: хвостом хвоста хвост
прочный: прочный
банальный: банальное банальный
везде: везде
качественный: качественный
золотистый: золотистого золотистых
роутер: роутера
непохожий: непохожие
проблема: проблемы проблема
свободно: свободно
собственно: собственно
страсть: страсть
аллергия: аллергию
отказать: отказал
мера: меру
информация: информация
обладать: обладает
зафиксировать: зафиксирована
контакт: контактом контакт
друг: друг другом друга
оттенок: оттенков оттенок
максимально: максимально
физический: физического
распространить: распространенными
элегантно-плавно: элегантно-плавно
прогулка: прогулку прогулки
гламурный: гламурным
спинка: спинка
сначала: сначала
злокачественный: злокачественная
выбор: выбор
грациозно: грациозно
окрас: окрас окрасом окрасов
считывать: считывает
воспринимать: воспринимать воспринимает
швейцарский: швейцарской
сухой: сухой сухих
накручивать: накручивать
обаяние: обаянием
сбалансированный: сбалансированную
кончик: кончик кончике
среди: среди
природный: природным
вредный: вредные вредно
лежанка: лежанка
категорически: категорически
веко: веки
обидчивый: обидчивых
сквер: скверам
вскоре: вскоре
посмотреть: посмотреть
выносливый: выносливее
межсезонье: межсезонья
собаковод: собаководов
случай: случая случаях случаю
формально: формально
ничтожный: ничтожной
просто: просто
мало: мало
миндалевидный: миндалевидной
бивер-терьер: бивер-терьер бивер-терьера бивер-терьерами бивер-терьеры
подчеркнуть: подчеркнуто
учебный: учебном
частый: частых чаще
принять: принято
новый: новом новой новому
бивер: бивер биверами биверам бивера биверов биверу биверы
великолепный: великолепная
бивер-йоркширский: бивер-йоркширский бивер-йоркширских бивер-йоркширские бивер-йоркширскому бивер-йоркширского
гладкий: гладкий гладкой
низкий: низкая низкие низкое
лакомство: лакомствам лакомства
который: которое которыми которой которых которым которые которому который
вывих: вывих
локоть: локтей локти
выражение: выражение
добавить: добавьте
дегенеративный: дегенеративная
проживание: проживание
вокал: вокал
происхождение: происхождения происхождение происхождением
зуб: зубьями зубами зубы зубов
заболевание: заболевания
приданое: приданое
начаться: началось
необходимо: необходимо
первый: первые первым первое первый первую первых
бивера-йорк: бивер-йорков бивер-йорки
пища: пищи
терьер: терьер терьера терьеры терьеру терьеров
щенячий: щенячью щенячьей
заблуждение: заблуждению
депрессия: депрессию
дверь: дверь
редкий: реже
впасть: впасть
тщательно: тщательно
вписаться: впишутся вписавшийся
дрессировка: дрессировка
стандартный: стандартный стандартное
время: время времени
ковровый: ковров
укладываться: укладывается
подклеить: подклеить
агрессивность: агрессивность
устроить: устроить
пряжа: пряжи
полость: полость
требовать: требует требуют
деятельность: деятельности
проказник: проказников
непосредственность: непосредственность
другой: другие другими
официальный: официальную официальном
использовать: используйте использовать
умение: умений умения
отдельный: отдельные
например: например
несколько: несколько
сетчатка: сетчатки
век: век
множество: множество
родина: родиной
рост: рост
наркоз: наркоз
грумерский: грумерская
чувствительный: чувствительное
колбаса: колбасы
чистокровность: чистокровность
редкость: редкость
собаконенавистник: собаконенавистник
производитель: производителями
копчёность: копченостей
реклама: реклама
соответственно: соответственно
волочиться: волочилась
фен: феном
найти: найдут
полотно: полотна полотно
угодить: угодить
нюанс: нюанс
линять: линяет
анализ: анализ
очаровательный: очаровательной очаровательных
малышка: малышка
выраженный: выраженным выраженные
показать: показали
исходить: исходить
вкус: вкус
поболтаться: поболтаться
рекомендоваться: рекомендуется
напоминать: напоминает
мочка: мочки мочка
преследовать: преследующих
спокойно: спокойно
получиться: получится
губа: губ губы
проявляться: проявляются
воспитание: воспитание воспитанием
германия: германия германии
один: одно
сохранять: сохраняя
здоровый: здорового
угощение: угощений
сайт: сайту
смена: смена
центр: центрам центр
понять: понять
полезно: полезно
получаться: получаются
реагировать: реагирует
лишь: лишь
стрижка: стрижка стрижке
опытный: опытные
рабочий: рабочие
выводить: выводить выводите
питательный: питательные
экстерьер: экстерьер экстерьером экстерьера
иметь: имеющий имела имеет иметь имеют
форум: форум форуме
подкрепление: подкрепление
боком: боком
кормить: кормите кормить
усиливать: усиливающий
уточнять: уточняйте
дружелюбный: дружелюбные дружелюбная
бигуди: бигуди
струнка: струнке
характерный: характерным
сезонный: сезонно
положение: положение
прочность: прочность
внешне: внешне
ровный: ровные
близко: близко
полувисячий: полувисячее
отъесть: отъем
признак: признак
собственный: собственными
объявление: объявлений объявления
описание: описание
начало: начало
пространство: пространство
биро: биро
встречаться: встречаться
китайский: китайская
приход: приход
приучить: приучив приучить
скрипка: скрипку
амбре: амбре
запретительный: запретительную
взаимодействие: взаимодействие
указать: указаны
оглядка: оглядкой
налёт: налета
соблюдать: соблюдая
зубной: зубного
однако: однако
пробор: пробор
играть: играть играет
психика: психики
шнеефлокхен: шнеефлокхен
поэтому: поэтому
коричневый: коричневый
вечный: вечном
копирование: копирование
прекрасно: прекрасно
активность: активность
родезийский: родезийский
продукт: продукта продукты
дружелюбность: дружелюбность
равный: равна
послеобеденный: послеобеденная
насыщенный: насыщенного
отзыв: отзывах отзывов отзывы
разрешать: разрешают разрешайте
нога: ноги ногами
ротовой: ротовую
заключаться: заключается
кошка: кошки кошками
мудрость: мудростью
перемещение: перемещения
нереально: нереально
доступ: доступе
неприятный: неприятный
хлопоты: хлопот
оценка: оценки оценке
шум: шум
союз: союз
преклонный: преклонного
собираться: собирается
особь: особи
прямой: прямая прямые прямой
интеллектуал: интеллектуалом
исчезать: исчезает
спальный: спальное
мать: матери
очищать: очищать
прыжок: прыжках
бладхаунд: бладхаунд
породистый: породистого
планировать: планируете
мантия: мантией
подходящий: подходящие
собака-компаньон: собак-компаньонов
зона: зону
салонный: салонного
сеть: сети
маленький: маленькому маленького маленькие маленьких меньше
дать: дадут дало
настоящий: настоящий
интерес: интерес
мочь: могут можете
минимум: минимум
торговый: торговым
уединённый: уединенный
пылесосить: пылесосить
кровать: кровати
мордочка: мордочке мордочка
лосьон: лосьонами лосьон
выбираться: выбирающиеся
линия: линиях
делать: делайте делая делать
голубой: голубые голубыми голубых голубого
наполовину: наполовину
шалость: шалости
белый: белым белого белой белый
решение: решение
основной: основные
специалист: специалистам
вывод: выводы
интеллект: интеллект
охранный: охранные
тело: теле тело
многие: многие
заключать: заключать
средне: средне
вес: вес
показаться: показаться
нацелить: нацеленный
конец: конец
мокрый: мокрые мокрый
ясный: ясный
ежедневно: ежедневно
нос: носа нос
результат: результаты
брать: берите
средневыраженный: средневыраженным
позитивный: позитивное
пропустить: пропустить
положить: положено
изогнутый: изогнут
родственник: родственники
полезный: полезные
серьёзно: серьезно
чрезвычайно: чрезвычайно
газетка: газетку
рот: рта
туалетный: туалетную
злоупотреблять: злоупотреблять
исследовать: исследованных
продолжительность: продолжительность
молодой: молодые
диван: диване
привыкнуть: привыкнет привыкли
заводной: заводной
доходить: доходит доходящая
интересный: интересный интересная
любитель: любителям
расположить: расположены
мышца: мышцами
следить: следите
цвет: цвета
кинологический: кинологическими
развитие: развития
основный: основным основная
продавец: продавца продавцом
вокруг: вокруг
слегка: слегка
идеальный: идеальном идеальную
цветной: цветных
крепкий: крепче
фото: фото
вы: вами
искать: ищете
активный: активных
миниатюрный: миниатюрных
готовый: готов готовые
яндекс: яндекс
второй: вторые
количество: количество
считаться: считаются
массажный: массажной
уголок: уголок
золотисто-бело-голубой: золотисто-бело-голубой
грызун: грызунов
отзываться: отзывается
кружочек: кружочков
свой: свой свое своего своей своих свои
вперёд: вперед
тактильный: тактильный
череп: череп
общий: общей
вьющийся: вьющейся
лапа: лапы лап
ловля: ловля
ухо: ушах уши
холка: холке
нетипичный: нетипичный
относить: относят
журнал: журнал
гнездо: гнездо
высота: высота высоты
вытирание: вытирания
нуждаться: нуждаются
гулять: гулять
горбатый: горбатой
определить: определить
тот: та тому
клумба: клумб
отсутствие: отсутствия отсутствие
пищеварение: пищеварение
ширина: ширины
контроль: контроля
холистик: холистик
сбривать: сбривать
получать: получают
болезнь: болезни
изредка: изредка
взрослеть: взрослеют
хохлатый: хохлатая
заводчик: заводчиков заводчикам заводчики
думать: думать
лоток: лоток
молчун: молчуны
совершенно: совершенно
овчарка: овчаркой
ребёнок: детей
грязеотталкивать: грязеотталкивающим
пятно: пятен
правильный: правильная правильные правильное
этот: этому
из: изо
минута: минут
супруг: супруги
злой: злое
умеренный: умеренной
масса: массой
кличка: кличка клички
радуга: радугу
травмироваться: травмируются
дешёвый: дешевле
проявить: проявить
нелегко: нелегко
бивера-терьер: бивер-терьеров
вливаться: вливаться
поддаваться: поддавайтесь
навстречу: навстречу
слюна: слюна
весь: всему
плохо: плохо
определять: определяют
вести: ведет вел
ручка-спица: ручкой-спицей
неясный: неясным
неустойчивый: неустойчив
подзывать: подзывая
повязать: повязали
укутать: укутать
родить: рожден
длинношёрстный: длинношерстные
этап: этап
развитой: развитой
являться: являются является
перейти: перейти
продажа: продаже
отдавать: отдавая
разный: разные разных
из-за: из-за
главное: главное
действие: действием действию
отметиться: отметился
усиливаться: усиливается
номер: номер
начинать: начинает
воспитывать: воспитывая
запретить: запрещенного запрещено
сокращать: сокращает
красивый: красивого
предпочтение: предпочтения
шёрстка: шерсткой
звезда: звезду
зашкаливать: зашкаливает
оставаться: оставался
во-вторых: во-вторых
клетка: клетка
отделять: отделять
вместо: вместо
успевать: успевает
выбирать: выбирает выбирая
обстановка: обстановке
костяк: костяк
область: область
слишком: слишком
будущее: будущего
конский: конский
уделить: уделите
атрофия: атрофия
пигментировать: пигментированные
гигиена: гигиена
терпеть: терпит
пригодность: пригодности
предпочесть: предпочли предпочтет
характеризовать: характеризующих
позволить: позволить
печёночный: печеночный
небольшой: небольшие небольшой
покров: покрова
книзу: книзу
появиться: появился
ваш: вашего вашем ваша
пелёнка: пеленку
пользоваться: пользоваться
разведение: разведения разведению
топ: топ
сложный: сложна
длинный: длинная длинной
нота: нот
убеждённый: убежденные
глава: главу
ранний: ранний
кабель: кабель
находиться: находящиеся
игрушка: игрушки
прядь: пряди
робот-пылесос: робот-пылесос
претендовать: претендовать
пренебрегать: пренебрегать
ушной: ушного ушное
каждый: каждый
пушистый: пушистые
гиперурикозурия: гиперурикозурия
месячный: месячных
короткий: короткие короткой
племенной: племенных
терьерский: терьерские
запрет: запретах
образец: образцов
стоимость: стоимость
приобрести: приобрести
разноцветный: разноцветный
непосредственный: непосредственный
осмотреть: осмотрите
строго: строго
личный: личное
спешить: спешите
появляться: появляйтесь
включать: включать
предельно: предельно
шоу-собака: шоу-собаку
груминг: груминга груминг
достаточно: достаточно
обязательно: обязательно
грязь: грязи
изолировать: изолированный
струиться: струящейся
обязать: обязан
привычка: привычки
круглый: круглые
очертание: очертаний
возраст: возраста возрасте
специальный: специальные специальный
заскучать: заскучать
доставлять: доставляло
популярность: популярность
список: списке
поводок: поводке
осторожность: осторожность
понимать: понимать
несмотря: несмотря
купить: купить
плотный: плотный плотные
стандарт: стандарте стандарт
любой: любой
семья: семье семей
метрика: метрики
ушко: ушки
оказаться: оказаться
приемлютый: приемлют
проходить: проходит проходите
красно-рыжий: красно-рыжие
период: периоды период
интерьер: интерьера
непременно: непременно
задача: задача
слушаться: слушаться
рождение: рождения
лицо: лица лицо
свёрнутый: свернуты
аналогичный: аналогичная
глазной: глазных
отправить: отправить
мотивировать: мотивируя
неполностью: неполностью
живой: живой
чаемый: чаем
подшёрсток: подшерстка
заслуживать: заслуживают
бровь: брови
трендовый: трендовая
домочадец: домочадцев
угол: углы
средний: средними
далеко: далеко
дрёма: дрема
одноклассник: одноклассники
имиджевый: имиджевые
работать: работающие
прийти: пришла
основатель: основателей
выход: выходов выход
здоровье: здоровья здоровье
чистить: чистить
снежинка: снежинкой снежинку
кобель: кобелем
прижиматься: прижимаются
грудь: грудь
случайный: случайные
кроме: кроме
движение: движении
простой: простые
сплошной: сплошной
суть: сути
нечего: нечего
три: трех
поиск: поиск
наклон: наклона
тёплый: теплого
опускаться: опускается
участок: участков
характер: характер
влага: влаги
некоторый: некоторые
выглядеть: выглядят
общительный: общительный
острый: острыми
вселенский: вселенской
помета: помета
укорачивать: укорачивают
голдаст-йорк: голдаст-йорк
сделать: сделано
игра: игры
колтун: колтуны
потребность: потребность
порок: пороки пороками
задорно: задорно
предок: предков
генофонд: генофонд
чистый: чистый
нежный: нежный
жизнь: жизни
два: двух
забывать: забывайте
стандартизация: стандартизацию
человеческий: человеческое
скакательный: скакательных
право: право
разрешиться: разрешилась
роскошный: роскошный
растение: растения
дело: дела
шелковистый: шелковистая
затем: затем
облегчение: облегчения
рука: рукой
способность: способностями
запах: запах
стриженый: стриженой
издевательство: издевательства
ветпаспорт: ветпаспорта
быстрый: быстрая
нужно: нужно
мимимишность: мимимишности
также: также
проблемный: проблемные
будущий: будущую
идеал: идеале
достаточный: достаточной
деликатный: деликатных
момент: моменты
сука: сукой
фамилия: фамилия
выгодный: выгодную
гигиенический: гигиеническими
прошлое: прошлого
подтвердить: подтвердили
разбирать: разбирая
корпус: корпус
косметика: косметика
миелопатия: миелопатия
отсюда: отсюда
кожа: кожи
говорить: говоря
искушение: искушения
высоко: высоко
коммуникабельный: коммуникабельные
книга: книгах
пухлявый: пухлявым пухлявые
сложно: сложно
счастливый: счастливые
крайне: крайне
стоить: стоит
это: это
важный: важная важный
вариация: вариации
вопрос: вопрос
спокойный: спокойном
порка: порок
приобретение: приобретение
квартира: квартиры
сведение: сведению
клубочек: клубочек
обучать: обучать
недопуск: недопуск
впечатлиться: впечатлиться
внешность: внешности
любить: любят
страх: страх
стол: стола
приучение: приучения
отвести: отведенном
крупный: крупным
совать: сующий
подрасти: подросшую
отводить: отводят
прочь: прочь
произойти: произойдет
континент: континенте
клан: клана
позволять: позволяйте
легко: легко
идеально: идеально
повадка: повадок
лента: ленту
переход: переходом
воспитать: воспитать
рисковать: рисковать
незлопамятный: незлопамятные
руководство: руководство
непромокаемый: непромокаемую
формировать: формировать
уверить: уверены
многое: многом
визуально: визуально
во-первых: во-первых
последовательность: последовательность
захотеться: захотелось
ркф: ркф
проплешина: проплешин
попона: попону
удивляться: удивляйтесь
вакансия: вакансии
обратно: обратно
путать: путают
страдать: страдающих
забавно: забавно
авторитарный: авторитарного
цель: цель
протест: протест
постоянно: постоянно
план: плане
непревзойдённый: непревзойденные
сказать: скажешь
профессиональный: профессиональная
треугольничек: треугольничков
грудной: грудная
сценарий: сценарию
отверстие: отверстия
съесть: съесть
необычный: необычный
похвала: похвала
удобно: удобно
ватный: ватные
стоящий: стоящие
похожий: похожи
чересчур: чересчур
столетие: столетия
распространение: распространение
покупка: покупка
сериал: сериал
коммерческий: коммерческий
большинство: большинство
главный: главная
практически: практически
социализировать: социализировали
рейтинг: рейтинг
связка: связками
напоследок: напоследок
дефект: дефекты
устанавливаться: устанавливается
известный: известные
подписываться: подписывайтесь
двигаться: движется
товарищ: товарищ
атласный: атласная
квадрат: квадрат
очень: очень
закрепить: закрепить
обычно: обычно
класс: классов
бок: бокам
второе: второе
систематический: систематического
наоборот: наоборот
маска: маски
круп: крупом
совместный: совместное
правило: правила
частность: частности
прежде: прежде
держать: держать
непрофессионал: непрофессионалов
исключительный: исключительных
образовывать: образовывать
впереди: впереди
необходимый: необходимые
граница: границы
баланс: балансе
взрослый: взрослых взрослым
проект: проекте
сразу: сразу
комнатный: комнатные
отдыхать: отдыхать
всеобщий: всеобщая
получить: получили
стабильность: стабильности
кг: кг
темперамент: темперамента темперамент
минимальный: минимальная
хрусталик: хрусталика
линька: линька
требоваться: требуются
особенный: особенную
страна: страна
сустав: суставов
обустраивать: обустраивая
причём: причем
оригинальный: оригинальная
формирование: формирования
ситуация: ситуации
глазок: глазки
лаять: лает
кверху: кверху
предложить: предложившим
родитель: родителей
приподнимать: приподнимаемые
вызывать: вызывает
превращать: превращает
прогуляться: прогуляться
кормление: кормление
конечность: конечности
натуралка: натуралкой
оба: оба
родословный: родословными
противоречивый: противоречивых
тип: типы
возможный: возможны
устоять: устоять
типичный: типичные
улучшение: улучшения
