америка: америке
надёжный: надежен
спокойный: спокойного спокойным
тратиться: тратиться
заметить: заметили
коттеджный: коттеджных
овощ: овощи овощами
йогурт: йогурте
тело: тела
пигментация: пигментацию
кровь: крови кровь
свёкла: свеклы
широко: широко
хозяйство: хозяйств хозяйства
средний: средняя среднее средней
обожать: обожать
опыт: опыт
агрессия: агрессия агрессии агрессию
расти: растет
следить: следить
классический: классических классической
сколько: сколько
своевременный: своевременной
отвар: отваром
интересоваться: интересоваться
целый: целой целые
востребовать: востребованные
осмотр: осмотра осмотр
название: название названия
прошлое: прошлое
примерно: примерно
скрещиваться: скрещивались
заранее: заранее
обсуждение: обсуждения
суровый: суровых суровым
другой: другое другие других другими
сочленение: сочленений
противник: противнику
неприязнь: неприязнь
английский: английских
цена: цена
содержаться: содержится
материал: материалов
куда-то: куда-то
стража: стражей
владелец: владельцам владельца владельцев владельцы владельцами владелец
трясти: трясет
поведение: поведения
внезапный: внезапным внезапную
прочесать: прочесать
тренировка: тренировками тренировке
собственный: собственных собственный собственного собственным собственные собственную
среагировать: среагировала
морской: морская
сторона: стороны сторону
долгий: дольше долгую
дисквалифицировать: дисквалифицирующие
движение: движениям
игра: игру игре
власть: власти
шлейка: шлейку
прикрикнуть: прикрикнув
расчёсывание: расчесывании
бежать: бегущего
россия: россия россии
живот: живот
морда: морде морды морда
необязательный: необязательный
обратный: обратная
итог: итоге
маленький: маленьким меньше
жкт: жкт
южноафриканский: южноафриканского южноафриканская южноафриканский южноафриканские
радужка: радужки
ради: ради
представитель: представителей представитель представители
зоопаста: зоопасту
тренировочный: тренировочные
команда: команду командой команды команда
появляться: появляются
игрушка: игрушкой игрушками
шея: шея шее
овчарка: овчарки
развитой: развитым развит
шерсть: шерсть шерсти
бурбуля: бурбулями бурбулей бурбуля бурбуль бурбули бурбулю бурбулям
пресекать: пресекайте пресекать
высокий: высоких высокий
несоблюдение: несоблюдения
служебный: служебной
рыба: рыба
качество: качеств качества
оптимальный: оптимальная оптимальный
выражение: выражению
должный: должны должен должно должна
несложно: несложно
самый: самая самым самое самых самые
небольшой: небольшого
тип: тип типа
говядина: говядина
протестировать: протестируйте
исключение: исключение исключений исключения
проконсультироваться: проконсультироваться
энергия: энергию
грузовой: грузовые
уступать: уступают
умный: умным умен умная
относиться: относится относятся
поселить: поселить
месяц: месяц месяца месяцев
домик: домик
паркет: паркете
атлетически: атлетически
общий: общим общий
некоторый: некоторых некоторые
столь: столь
спустя: спустя
перенять: перенять
ромашковый: ромашковым
дело: дел дело деле
косметика: косметику
включая: включая
сузить: суженная
годный: годного
превратиться: превратится
главный: главный главная
зимовать: зимовать
тесный: тесные
норма: норм
история: история историю
играть: играйте играть
известный: известных
неблагополучный: неблагополучным
щенок: щенка щенков щенки щенок щенку щенкам щенками
придумывать: придумывайте
томат: томаты
проверять: проверять
альтернатива: альтернатива
нормально: нормально
выгул: выгул
успешно: успешно
выполнять: выполняя выполнять
настолько: настолько
проявлять: проявляет
нажива: наживы
разбираться: разбирается
обычный: обычный обычной обычных обычные
взрослый: взрослый
форма: форма
чувствовать: чувствуют
обучение: обучении
семья: семьи
метис: метисами
приятный: приятные
воронка: воронки
проделать: проделать
дисбактериоз: дисбактериозом
характеристика: характеристика
руб: руб
несколько: несколькими несколько нескольких
экземпляр: экземпляры
ветеринар: ветеринаром
эмоция: эмоции
заводчик: заводчик заводчиков заводчика заводчики
около: около
антагонист: антагонистов
купание: купания
импульсивный: импульсивных
выдающийся: выдающимся
менять: меняя
сиюминутный: сиюминутным
коготь: когти
порода: породе породы пород породами породу порода
значит: значит
маска: маска
палец: пальцы пальцами
популяризация: популяризации
быстро: быстро
вклад: вклад
первый: первой первые первого первая первую
присутствие: присутствия присутствии
раз: раза
видео: видео
мячик: мячики
ферма: фермах
коммерческий: коммерческого
разрешаться: разрешается
полностью: полностью
очередь: очередь
никакой: никаких
лидерство: лидерству
оказывать: оказывают
быть: будьте будут
способный: способный способных способен способны
гений: гений
мышечный: мышечной
бурсит: бурситы
чистокровный: чистокровные чистокровных
выбор: выбором
рацион: рациона рацион
собака: собаками собакой собак собака собаке собаки
речь: речь
содержание: содержание содержания
нужный: нужны
немного: немного
исполниться: исполнилось
попытка: попытки
скалиться: скалится
нагружать: нагружать
слеза: слезы
живой: живом
рекомендовать: рекомендуют
рубец: рубец
защита: защиты
раскачка: раскачку
вейтпуллинг: вейтпуллинге
провезти: провезет
окрас: окраса окрас окрасы окрасов
предел: пределы
впадать: впадайте
подвес: подвес подвесом
спровоцировать: спровоцирует спровоцировать
снег: снегом
длинный: длинном
собираться: собираются собирающиеся
формулировка: формулировки
реальный: реальные
территория: территорию территории
опустить: опущенная
связь: связь
бояться: боятся
расставить: расставленные
вприпрыжку: вприпрыжку
позвонок: позвонка
система: система системой
воплотить: воплощенным
неглубокий: неглубокие
атрибут: атрибут
огрызаться: огрызается
передний: передним передние
внешность: внешность внешности
подушечка: подушечек
спасать: спасают
проходить: проходить проходящих проходит
пока: пока
племенной: племенная
чувство: чувства чувство
стать: стали стало
фон: фоне
спустить: спустит
сводистый: сводистые
травма: травму
скала: скала
потерять: потерять
решать: решают
самочувствие: самочувствия
рвение: рвением
давать: давать давайте даете
загородный: загородный
здоровяк: здоровяк
пошуршать: пошуршите
молниеносный: молниеносной
тёмно-коричневый: темно-коричневые
суточный: суточного
немецкий: немецкой
заниматься: заниматься занимающаяся
неплотно: неплотно
выставка: выставки выставке
плотно: плотно
ткань: тканей тканью
ежедневный: ежедневном ежедневного
ноздря: ноздрей
питомец: питомцу питомец питомцах питомца питомцем
крупный: крупный крупная крупных крупной крупному
смотреть: см смотрите
доверие: доверие
лёгкий: легкий легкую легкой
фотография: фотографии
ассоциация: ассоциациями ассоциация
диван: диванов
работать: работать
хороший: хорошие хорошей
уход: уходе ухода уход
холод: холоду
смотреться: смотрятся
капуста: капусты капуста
голубой: голубой
чёрный: черная черного черную
помнить: помните
распахнуть: распахнутых
результат: результатов результат результаты
африканец: африканца африканцем африканцев
родить: рожденный
страдать: страдают
забвение: забвение
питомник: питомники питомниках питомник
прислушаться: прислушается
верхний: верхней
пара: пары пару парой
противостояние: противостоянию
поладить: поладить
выбирать: выбирайте
глаз: глаза глаз
проказа: проказы
платформа: платформы
прийтись: придется пришлось
отмереть: отмершую
корм: корм
зимовье: зимовье
экспедиция: экспедицию
вниз: вниз
лохматый: лохматую
выучить: выучил
смысл: смысле
внести: внесены внесли
прямоугольный: прямоугольных
год: года годам лет году
прогулка: прогулка прогулке
поскольку: поскольку
краткий: краткая
гениталии: гениталий
артрит: артриты
обзавестись: обзавестись
язык: язык
сильный: сильная сильное сильные
отношение: отношение отношению
желательный: желательны
место: место местах
малыш: малышей малыш малыша
исключительно: исключительно
основа: основ
ребёнок: ребенка детям
весь: весь всем
эксперт: экспертов
десять: десять
стоячий: стоячего
споткнуться: споткнетесь
вконтакте: вконтакте
фактурный: фактурный
свет: свет
отказаться: откажется откажитесь отказаться
впечатление: впечатление
уютный: уютной
прощать: прощает
тренироваться: тренируетесь
создать: создать
обращение: обращении
тазобедренный: тазобедренных
ярко: ярко
роль: роль
хозяин: хозяин хозяином хозяина
отличительный: отличительная
типичный: типичная
развитие: развитие
русский: русской
ценник: ценник ценником
регистрация: регистрации регистрацию
пропустить: пропустите
животное: животных животным животного животными животные животное
размер: размерах размеры
операция: операцией
появление: появления
земля: земле земли
пикировать: пикировать
чреватый: чревато
неуравновешенный: неуравновешенной
длина: длины длина длину
кровать: кроватей
ребята: ребята
вынудить: вынуждена
развивать: развивают развивать
выбрать: выбрать
российский: российские российских
поддержка: поддержку
открытый: открытый
считать: считанные считайте
бурский: бурских
куртка: куртки
счёт: счет
основать: основана
сустав: сустава суставы суставам суставов
брюки: брюки
хотя: хотя
малышня: малышней малышне
продукт: продуктов
охранник: охранника
стачиваться: стачиваются
х: х
серьёзный: серьезные серьезный серьезной
кожа: кожу кожа
скользкий: скользком
традиция: традицией
сам: сами само
век: веке век
выгуливать: выгуливать
больший: большая большие
непослушание: непослушания
глыба: глыбу
пробовать: пробует
опытный: опытный
звук: звукам
закон: закон
свободно: свободно
конкурент: конкурентами
избирательность: избирательности
закреплять: закреплять
мини-марафон: мини-марафон
квартира: квартире квартиры
рискнуть: рискнете
дать: даст
соблюдать: соблюдайте
информация: информация информации
подходить: подходит
друг: друг
ходьба: ходьбе
хондропротектор: хондропротекторы
дрожжевой: дрожжевые
создание: создание
хотеть: хочет
воспринимать: воспринимайте
жилплощадь: жилплощадь
любой: любую любые любой
подстилка: подстилку
надеяться: надеяться надеясь
треугольник: треугольник
отпасть: отпала
юар: юар
создавать: создавать
авторитет: авторитет авторитетов
негативно: негативно
приподниматься: приподнимается
ниже: ниже
характер: характера характер
родословный: родословную
яблоко: яблока
крепкий: крепкие крепким
перемещение: перемещении перемещения перемещениями
правильный: правильного правильный
прямой: прямом прямой
начало: начале начала начало
габарит: габариты
сравнительно: сравнительно
среди: среди
крупа: крупы
потуга: потуги
категорически: категорически
линия: линию линиях линии
знакомый: знакомых
общаться: общаетесь
гасить: гасить
считаться: считается считаются
мыть: мыть
наполеон: наполеона
рабочий: рабочих рабочие
любимый: любимой
воспитанный: воспитанный
загривок: загривком
полный: полной
чудо: чудеса
рука: руки
просто: просто
мало: мало
континент: континента
подпасть: подпав
этикет: этикета
наказание: наказаниями наказанием
подчеркнуть: подчеркнуто
пёс: псов пес
одинаковый: одинаковым
прочий: прочих
проследить: проследите
необходимый: необходимый необходимую необходим
вырождаться: вырождались
гулять: гуляя гуляй гулять гуляете
истерика: истерику
нападение: нападения
домашний: домашней домашним домашнего
гладкий: гладкий
низкий: низкая
умиление: умиления
купироваться: купироваться
который: которое которыми которой которого которых которым которые которому который
приводить: приводят
заменить: заменить заменив
отсутствовать: отсутствовать отсутствует
локоть: локтей локти
добавить: добавьте
молодой: молодой
человек: человеку человека человеком
вычёсывать: вычесывать
фокус: фокусы
собачий: собачьим
происхождение: происхождения
тёмный: темным
демонстрировать: демонстрируют демонстрирует
необходимо: необходимо
выдержка: выдержку
готовый: готовы готов
прибыльный: прибыльным
потерпеть: потерпит
пожалуй: пожалуй
перспективный: перспективные
двухлетний: двухлетнего
окрестность: окрестностях
остановиться: остановитесь
задний: задние
черта: черты черта
считывать: считывают
организация: организация
кобель: кобеля кобели
тщательно: тщательно
сдаваться: сдавались
дрессировка: дрессировка дрессировкой
рывок: рывком
время: время
сука: суки сука
агрессивность: агрессивность
ушной: ушной ушного
полость: полость
защищать: защищать
день: дней дня день
лоб: лбу лбом
бебиситтер: бебиситтера
группа: группой группа
деятельность: деятельности
урок: уроки
показывать: показывает показывают
кость: костей кости
жёстко: жестко
вытереть: вытереть
разрушаться: разрушались
кусаться: кусаться
использовать: используйте использовать
обрадовать: обрадует
терпение: терпения
неожиданно: неожиданно
фенотип: фенотип
комфортно: комфортно
плоский: плоскими
например: например
превосходно: превосходно
грозить: грозит
охрана: охраны
боец: боец
кишечник: кишечнике
постоянный: постоянный
рост: рост
голова: головы головой голова
одиночка: одиночку
дразнить: дразнить
случайный: случайного случайные
вне: вне
покупатель: покупателей покупателям
сила: силы сил силу
категорично: категорично
умеренный: умеренное
резко: резко
к: ко
реклама: реклама
мясо: мясом мяса мясу
получить: получите получить
полотно: полотна
глист: глистов
мотивировать: мотивировать
уважать: уважающая уважает
пегий: пегого
бурбуль: бурбулем
лакомство: лакомствами лакомством
определённо: определенно
незначительный: незначительным
второй: второй
выносливость: выносливостью
мочка: мочки мочка
спокойно: спокойно
получиться: получится
губа: губ
воспитание: воспитание
достигать: достигает
пушистик: пушистик
сжевать: сжевав
произвести: произведенный
правильно: правильно
мышление: мышления
полаять: полает
строгий: строгие
оба: обоих
соседствовать: соседствовать
сайт: сайту
бывать: бывает
закрепить: закрепленных
терпеливый: терпелив
понять: понять
картофель: картофель
энергичный: энергичному
дорогой: дорогое
сорт: сортов
поуговаривать: поуговаривал
лишь: лишь
что-то: что-то
пытаться: пытается
вариант: вариант
долго: долго
экстерьер: экстерьер экстерьера
иметь: имеющий имеет иметь имеют
поход: поход
форум: форум форуме
посягательство: посягательств
снарядить: снарядить
стоп: стопом
времяпрепровождение: времяпрепровождением
протяжение: протяжении
стесняться: стесняйтесь стесняется
комната: комнатах
проспект: проспекты
вольер: вольером вольере
курага: курага
сгусток: сгустком
недельку-другий: недельку-другую
положение: положение
прочность: прочность
африканский: африканский африканское африканского
благоразумие: благоразумием
такой: такие такая таким
член: членам членов членами
внешне: внешне
скоро: скоро
последствие: последствий
километр: километров
грибок: грибки
описание: описание
нормальный: нормальных нормального нормальный
коллаген: коллаген
рано: рано
возмущаться: возмущайтесь
виноград: виноград
стандарт: стандартом
эмигрировать: эмигрировавшие
агрессивный: агрессивных
скандинавия: скандинавии
овсяный: овсяную
дания: дания
лопатка: лопатки
социализировать: социализированный
предоставлять: предоставляете
атаковать: атакуя
округлый: округлые
середина: середине
подростковый: подростковом
найти: найти
гречневый: гречневая
оказаться: оказалась
посмотреть: посмотрите
однако: однако
жёсткий: жестких
отличаться: отличаются
полагаться: полагаться
поэтому: поэтому
пробуждать: пробуждает
спасение: спасение
специализироваться: специализируется
копирование: копирование
дружелюбный: дружелюбная дружелюбным
короткий: короткий коротком
метр: метров
трудно: трудно
активность: активность
чернослив: чернослив
юный: юный юному
дружелюбность: дружелюбность
застелить: застелить
тратить: тратить
отзыв: отзывах отзывы
отследить: отследить
переходить: переходить
нога: ноги
ротовой: ротовую
десятка: десяток
кошка: кошки кошкам
сканировать: сканирует
следовать: следует
крестьянский: крестьянские
животный: животному
мимо: мимо
бежевый: бежевый
шум: шум
гость: гостям
широкий: широкий широкой широкая широких
пола: полы
прочить: прочим
творог: твороге
наказать: наказать
баланс: баланс
вопрос: вопросами
тигровый: тигрового тигровый
летальный: летальным
собака-личность: собака-личность
запрет: запреты запретов
оставаться: оставаясь остается
подкачать: подкачанный
нечасто: нечасто
приподнять: приподняв
дом: дома доме
мочь: могут можете
чинный: чинный
возраст: возрастом возраст возраста возрасте
клубный: клубный
свобода: свободу
формат: формата
глупо: глупо
хулиган: хулигана
конина: конина
размытый: размытые
видеть: видеть
малолюдный: малолюдных
профессиональный: профессионального
объявление: объявления
собрать: соберите собрано
медленно: медленно
делать: делайте делать
сделать: сделать сделали сделано сделало
бульдог: бульдогов
основной: основные
барбос: барбоса
интеллект: интеллект
охранный: охранные
миниатюрный: миниатюрный
средне: средне
вес: вес весом
тяжеловес: тяжеловес
конец: конец
питание: питания
чемпион: чемпионов
затесаться: затесались
нос: носа нос
свой: своим своей своих
разведение: разведение разведения разведению
жировой: жировой
брать: берите
морщина: морщины
чей: чью чьи
именно: именно
южный: южная южную
среднестатистический: среднестатистического
опорно-двигательный: опорно-двигательная
претерпевать: претерпевает
улица: улице
продолжительность: продолжительность
международный: международная
мощный: мощными мощным
составлять: составлять
решиться: решившимся
вряд: вряд
зуб: зубами зубы
доходить: доходит
испытание: испытание
доминант: доминантом
пакет: пакетом
зубной: зубную
боевой: боевой
переселенец: переселенцами
оттенок: оттенок
оттачивать: оттачивать
шампунь: шампунь
ксерокс: ксерокс
кинологический: кинологическими
размещать: размещая
сохранять: сохранять
вокруг: вокруг
обыватель: обывателей
цель: целях
череп: черепу череп
бороться: бороться
заглядывать: заглядывая
идеальный: идеальном
культ: культ
опасный: опасных
найтись: нашлось
вестись: ведитесь
альф-самец: альфа-самца
выплёскивать: выплескивать
фото: фото
м: м
вы: вами
два: две двух
шаг: шаг
шоу-питомец: шоу-питомец
яндекс: яндекс
соответствующий: соответствующими
техника: техники
цитрусовый: цитрусовые
болтать: болтаете
режим: режим
нужда: нужда
резиновый: резиновые
поперёк: поперек
оставлять: оставлять оставляя
вкусняшка: вкусняшки
помета: помет
ухо: уха уши ухо
социализация: социализации
атака: атаку
лапа: лапы лап
спина: спиной
сыграть: сыграло
холка: холке
смочь: смогли
обтирание: обтирание
двор: дворе
журнал: журнал
неделя: недели неделю
тыквенный: тыквенные
высота: высота
выразить: выражено
последующий: последующим
мастиф: мастиф мастифов
морковь: морковь
любимец: любимцам
нуждаться: нуждаются
постав: постав
эластичный: эластичная
бурбулейя-производитель: бурбулей-производителей
мяч: мяч
бойцовый: бойцовой
туловище: туловищу туловище
подмять: подмять
упражнение: упражнение упражнения
покров: покров
подрастать: подрастающего
болезнь: болезни
изредка: изредка
взрослеть: взрослеют
контролировать: контролировать
запросто: запросто
керри-блю-терьер: керри-блю-терьер
либо: либо
уравновесить: уравновешенным
начинать: начинать
аборигенный: аборигенными
этот: этому этих
испачкать: испачканной
сырой: сырыми
тёплый: теплое
дратхаар: дратхаар
минута: минут
взгляд: взглядом
прибывать: прибывающими
секунда: секунды
жест: жест
безумие: безумия
ваш: ваши вашего
обеспечивать: обеспечивают
сегодняшний: сегодняшней
бордер-колли: бордер-колли
привезти: привезли
стена: стен
включать: включайте включает
условие: условиям условиях
динамичный: динамичный
фирменный: фирменная
готовность: готовности
отрабатываться: отрабатывается
допустимый: допустимы
поддаваться: поддавайтесь
расслабляться: расслаблялась расслабляйтесь
перекус: перекус
импровизированный: импровизированного
стычка: стычки
большой: побольше
дальнейший: дальнейшей дальнейшем
развивающийся: развивающимся
немой: нем
грозный: грозный грозного
пригород: пригороды
перейти: перейти
реально: реально
образоваться: образуется
сгодиться: сгодится
из-за: из-за
главное: главное
оживлённый: оживленные
костяк: костяком
максимум: максимум
поверхность: поверхностей
прохожий: прохожих прохожие
менее: менее
приструнить: приструнить
идти: идут шло
хлебушек: хлебушком
обрабатывать: обрабатывайте
предпочтение: предпочтения
выставочный: выставочным
горизонтальный: горизонтальным горизонтальных
коровий: коровье
беседовать: беседуйте
культивировать: культивировать
клетка: клетка
подзыв: подзыв подзыва
вместо: вместо
обстановка: обстановке
англичанин: англичане
слишком: слишком
одиночество: одиночеству
котофей: котофея
сертификат: сертификатами
никто: никто
последний: последний
зимой: зимой
комок: комок
подтверждаться: подтверждаться
сохранность: сохранности
отход: отхода
бруталый: брутал
латекс: латекса
интересный: интересную
гигиена: гигиена
ворчливость: ворчливость
совместный: совместным
подобный: подобные
работа: работу
минтай: минтай
густой: густой
банан: бананы
оценка: оценке
полоса: полосы
рубль: рублей
появиться: появились
птица: птицы
сказываться: сказывается
предпосылка: предпосылкой
неплохо: неплохо
возненавидеть: возненавидит
подозревак: подозревака
половина: половину
правило: правило правила правил
расхождение: расхождение
внимание: внимание
экстрим: экстрим
дог: дог
прикус: прикуса прикус
поздно: поздно
разрешение: разрешение
купить: купив купить
каждый: каждый каждая
выйти: выйдет
организм: организме
скромный: скромный
глубокий: глубокая
часть: часть
целительный: целительную
железный: железную
чужак: чужаком
конура: конурой
стоимость: стоимость
особенно: особенно
плембрак: плембрак
желательно: желательно
автоматически: автоматически
прижать: прижато
строго: строго
естественный: естественную
дефектный: дефектный
осмотреть: осмотреть
делить: делить
запамятовать: запамятовал
страна: стран странах страна
достаточно: достаточно
обязательно: обязательно
грязь: грязи
рисковать: рискуете
прокусить: прокусить
субпродукт: субпродуктов
доминировать: доминировать
приобретение: приобретением
ход: ходе
приспосабливаться: приспосабливаться
расположение: расположение
очертание: очертаний
редис: редис
кольцо: кольцо
производить: производит
отметка: отметки
фермер-африканер: фермеры-африканеры
натягивать: натягивает
реагировать: реагируют
разрешать: разрешайте
поводок: поводке поводок поводка
точнее: точнее
ламинат: ламинате
любитель: любителей
несмотря: несмотря
бурбула: бурбуле
подопечный: подопечных
натуральный: натуральную
ухаживать: ухаживать ухаживающую
подкормка: подкормок
инстинкт: инстинктом
помощник: помощника
бессмысленно: бессмысленно
сотрудник: сотрудники
проявить: проявите
адаптировать: адаптированы
промывать: промывать
упустить: упустит
желание: желание
запас: запас запасе
ходить: ходите
подмешать: подмешана
негодный: негодными
недостаток: недостатки недостаток
приятельствовать: приятельствовать
хозяйка: хозяйкой
основание: основание
лицо: лица
задаток: задатками
поощрять: поощряйте
разъезжаться: разъезжаться
отечественный: отечественного
порыв: порывам
аккуратный: аккуратнее
прямолинейность: прямолинейность
здоровый: здоровый
кисломолочный: кисломолочных
козлятина: козлятина
дизайнерский: дизайнерской
усвоить: усвоить
выставляться: выставляется
напористый: напористых
еженедельный: еженедельных
индивидуальный: индивидуальные
оборона: обороне
африка: африка африке
принести: принес
задувать: задували
сложить: сложенный
далеко: далеко
тянуть: тянуть
трусость: трусость
соблюдаться: соблюдавшиеся
навсегда: навсегда
одноклассник: одноклассники
груз: грузов
плотный: плотное
попутно: попутно
посещать: посещайте
послушание: послушания
забираться: забираться
дисплазия: дисплазия
рвать: рвать
правда: правда
возможность: возможности возможность
скорость: скорость
здоровье: здоровья здоровье
чистить: чистить
деревянный: деревянной
прижиматься: прижимаются
случай: случаи случае
кроме: кроме
кейптаун: кейптауна кейптаун
нарушитель: нарушителя
аргентинский: аргентинский
позволить: позволит позволив
мускулистость: мускулистостью
откровенно: откровенно
пустырь: пустырях
сплошной: сплошной
доминанта: доминанта
тащить: тащить
частый: чаще почаще
поиск: поиск
направление: направлению
отстранённо: отстраненно
квадратный: квадратного
численность: численности
слышный: слышно
куриный: куриное
домушник: домушников
молосса: молоссы
рискованный: рискованный
прародитель: прародителями
догадаться: догадаться
скакательный: скакательного
познакомить: познакомьте
полезный: полезны полезных
себя: собой
задумчивость: задумчивость
урбанизация: урбанизацию
определяться: определяясь
чемпионский: чемпионские
тонкость: тонкости
брожение: брожение
ночевать: ночевать
материк: материк
вдоль: вдоль
консультативный: консультативную
энтузиаст-фермер: энтузиастов-фермеров
реалия: реалиях
светлый: светлые
потребность: потребность
периодически: периодически
порок: пороки
хозяйский: хозяйского
забывчивость: забывчивость
недокус: недокус
неуважительный: неуважительное
будка: будке будку
признавать: признающим признающий
заходить: заходит
жизнь: жизни жизнь
девать: девать
абсолютно: абсолютно
забывать: забывайте
шанс: шансов
ждать: ждите ждать
красивый: красивые
яйцо: яйцо
слабость: слабости
говорить: говорить
благодаря: благодаря
искренний: искреннего
взяться: взялась
всё-таки: все-таки
двигаться: двигаться
повальный: повальную
плечо: плечи
настороже: настороже
портить: портит
добродушие: добродушие
восстановление: восстановление
цветной: цветная
нужно: нужно
массивный: массивная массивные
поблажка: поблажка
мимимишность: мимимишности
слабый: слабое
атлет: атлет
обосноваться: обосновались
также: также
толчок: толчок
вызывать: вызывают
настроение: настроение
лук: лук
покупка: покупки покупка
шёрстный: шерстный
говяжий: говяжьему
помочь: поможет
момент: моменты
окружающий: окружающих
маршрут: маршрута
уметь: уметь
возможно: возможно
кончик: кончику
корпус: корпус
резкий: резким
туповатый: туповатого
манипулировать: манипулировать
переезжать: переезжали
депигментация: депигментация
баранина: баранина
недопуск: недопуском
умеренно: умеренно
класть: кладя
ранее: ранее
отразить: отразить
безоговорочно: безоговорочно
сложно: сложно
район: районам
крайне: крайне
область: области
стоить: стоит
завоевать: завоевали
это: это
вид: вид
массировать: массируя
разный: разных
важный: важная
связка: связок
максимальный: максимальную
пройти: пройдено
существо: существа
опасно: опасно
ножницеобразный: ножницеобразный
провоцировать: провоцируют провоцировать
обнимашка: обнимашки
охранять: охраняет
закручиваться: закручивается
оторвать: оторвав
порка: порок
освобождать: освобождает
неуправляемый: неуправляемым
заканчиваться: заканчиваются
вполне: вполне
испанский: испанский
первоклассный: первоклассных
разделять: разделять
застрять: застрял
ванна: ваннах
кусочек: кусочек
перемещать: перемещать
собака-телохранитель: собаках-телохранителях
продемонстрировать: продемонстрируйте
любить: любят
невозможно: невозможно
имущество: имущества
стараться: старайтесь
предпочесть: предпочесть
непризнанный: непризнанной
участок: участках
изменение: изменения
отит: отит
колоссальный: колоссальный
клан: клана
пшеничный: пшеничную
легко: легко
уточнить: уточнить
повадка: повадок
реакция: реакции
скарб: скарбом
лента: ленту
привлечь: привлекло
сторож: сторожей
показать: покажите
основательно: основательно
интенсивно: интенсивно
выглядеть: выглядит
кто-то: кому-то
турне: турне
упорно: упорно
отличный: отличные
уверить: уверены
исход: исходом
титул: титулы
безопасность: безопасности
последовательность: последовательность
захотеться: захотелось
выходить: выходить
ркф: ркф
параллель: параллель
управляемый: управляемым
отбирать: отбиравшие
локтевой: локтевых
выход: выход
вакансия: вакансии
хитрец: хитрец
специалист: специалисты
декоративный: декоративный
сбежать: сбежать
злой: злую
запретить: запретив запрещено
площадка: площадки
массивно: массивно
незнакомец: незнакомцев
обойтись: обойдется обойтись
начинаться: начинается
постоянно: постоянно
щёлкнуть: щелкните
план: плане
вроде: вроде
кефир: кефира
конфликт: конфликт
хрящ: хрящи
достоинство: достоинства
кочан: кочана
выше: выше
грудной: грудная
купировать: купированного
расцениваться: расценивается
молоко: молоко
придавать: придавая
палевый: палевый
управлять: управлять
вместе: вместе
течение: течение
психика: психикой
столетие: столетия
мероприятие: мероприятиям
прочный: прочных
вязка: вязку
сообразительный: сообразительного
рисовый: рисовая
практически: практически
рейтинг: рейтинг
добавлять: добавляемые
проблема: проблем
подписываться: подписывайтесь
ринуться: ринувшиеся
шутка: шутку
срываться: срываться
недостаточно: недостаточно
следовательно: следовательно
европейский: европейские
самостоятельно: самостоятельно
провести: проведет
подойти: подошел
элегантно: элегантно
хвост: хвоста хвост
дефект: дефектам дефектами
очень: очень
особь: особей
обычно: обычно
лужа: лужам
селекционер: селекционеры
особенность: особенности
наплевать: наплевать
бодигард: бодигардов
сквозняк: сквозняки
челюсть: челюстями
грубо: грубо
постепенно: постепенно
буксир: буксире
иммунитет: иммунитете
прокатить: прокатит
страшно: страшно
круп: крупом
кличка: клички
довольно: довольно
список: список
открыть: открыта
лотерея: лотерея
отпускать: отпускать
готовиться: готовьтесь
ругать: ругаете
касаться: касается
конечный: конечном
документ: документов
претерпеть: претерпели
вырастить: вырастить
променад: променада
погладить: погладить
пружинистый: пружинистый
проект: проекте
сразу: сразу
настроить: настроены
темя: теменем
держаться: держаться
медлительность: медлительность
кг: кг
насколько: насколько
городской: городской
злобность: злобность
риск: риск
линька: линька
прилегать: прилегающая
контроль: контроль
темперамент: темперамент
интерьер: интерьер
осторожный: поосторожнее
неуязвимый: неуязвимый
шиворот: шиворот
ответственный: ответственном
причём: причем
вступить: вступит
защитно-караульная: защитно-караульным
клочок: клочки
переулок: переулкам
оружие: оружие
четверолапый: четверолапый
дорога: дорогу
подтянутый: подтянут
родитель: родителей
поймать: поймал
кормление: кормление
конечность: конечности
зарегистрировать: зарегистрированы
исказить: исказить
тягость: тягость
старт: старте
вставать: вставая
угол: углов
быстрый: быстрых
она: ею
собеседник: собеседника
подрезать: подрезать
сообразительность: сообразительности
лающий: лающее
зафиксировать: зафиксированы
восторг: восторге
стул: стульев
угрожать: угрожающий
какой: каких
предоставить: предоставленные
