туалет: туалет
суд: суд
орган: орган
стоять: стоять
средний: средняя среднее средний
фу: фу
пять: пяти
неповторимый: неповторимым
чёрный: черный черного
сколько: сколько
елена: елена
отвар: отваром
бич: бич
название: название названий названия названию
ковровый: ковровых
застраховать: застраховать
примерно: примерно
собака: собаку собаками собакой собак собака собакам собаке собаки
вывести: вывести
британский: британский британских британским британские
сухой: сухого
европейский: европейская европейской европейским европейские
пробраться: пробрались
заранее: заранее
физический: физических физическом
мыслимый: мыслимые
обсуждение: обсуждения
тициан: тициан
другой: другое другие других другими другим
английский: английских английской английский
цена: цена
реальный: реальной
блеск: блеска
заметка: заметку
любимый: любимых
сосед: соседи
выпадение: выпадению
запах: запахом
любопытство: любопытства
материал: материалов материалы
удовольствие: удовольствием
охватить: охваченный
недуг: недуга недугов
напрямую: напрямую
познакомиться: познакомьтесь
гомкий: гомкое
признать: признал
святой: святых святая
эталонный: эталонной эталонным
поведение: поведения поведение
приближать: приближавшие
миниатюрный: миниатюрные
собственный: собственных собственного собственным собственными собственные
оставить: оставленными
простой: простого проще
инстинкт: инстинкты
традиция: традиции традициям
дефектный: дефектными
власть: власти
побегать: побегать
расчёсывание: расчесывании расчесывания
зато: зато
россия: россия россию россии
партия: партию
итог: итоге
забыть: забудьте забыть
обратный: обратная обратное
блюдо: блюдам блюда
справиться: справиться справится
реагент: реагентов
кавардак: кавардак
начинать: начинают начиная
рейган: рейган
представитель: представителей представителям представители
команда: команду команд команды команда
получить: получивших
шея: шея шеи
волос: волосом волос волоса
исполнять: исполнять
стричь: стричь
шерсть: шерсть шерсти
ласково: ласково
поверхность: поверхности
устать: уставшему
низкий: низкий
последующий: последующему
допустимый: допустимыми допустимо допустимая допустима
обстоять: обстоят
вспоминать: вспоминает
кинолог: кинологи
рыба: рыба
фруктовый: фруктовую
буквальный: буквальном
челюсть: челюсти
метод: метод
игра: игре играх
несложно: несложно
тип: тип типа типы
породный: породного
асфальт: асфальта
взгляд: взгляд взглядом
класс: класса классом
отпочковаться: отпочковался
стойка: стойки стойка стойке
начать: начнет начали
проделывать: проделывать
сегодняшний: сегодняшних
относиться: относится относятся
месяц: месяц месяца месяцев
вытирать: вытирают
паркет: паркете
сера: серу
великобритания: великобритания
общение: общения общении
замирать: замирают
некоторый: некоторых
ромашковый: ромашковым
нога: ног ноги
учитывать: учитывайте
погибнуть: погибло
отличаться: отличается
кинг-чарльз: кинг-чарльз кинг-чарльзов кинг-чарльзы кинг-чарльза
сын: сыном
хендлера: хендлеры
важно: важно
породистый: породистой
лидерский: лидерских
душа: душе
моментально: моментально
история: история
лечение: лечению лечения
кинологический: кинологических кинологической кинологическим
кокетливый: кокетливой
прибавить: прибавила
кто-то: кого-то
щенок: щенка щенков щенки щенок
растительный: растительным
проверять: проверять
нормально: нормально
потребовать: потребуйте
поощрять: поощряют
мыть: моют
настолько: настолько
нарезка: нарезку
питомец: питомцев питомцу питомец питомцы питомцам питомца питомцем
кавалер-кинг-чарльз-спаниэль: кавалер-кинг-чарльз-спаниэля кавалер-кинг-чарльз-спаниэль
пылесос: пылесос
малознакомый: малознакомому
возрасти: возрос
нередко: нередко
робость: робостью
братия: братии
приличный: приличного
характеристика: характеристика
такой: таком таких такие такая такого таким
руб: руб
миролюбивый: миролюбивый
соответствие: соответствии
около: около
зарождение: зарождения
роды: родов роды
следующий: следующие
год: годы года лет год годов году
пахнуть: пахнет
пол: пола пол
пятно: пятна
разглаживание: разглаживанию
настой: настоя
походка: походки походкой
еда: еды
кавалер-кинг-чарльз-спаниель: кавалер-кинг-чарльз-спаниелями кавалер-кинг-чарльз-спаниелям кавалер-кинг-чарльз-спаниелем кавалер-кинг-чарльз-спаниели кавалер-кинг-чарльз-спаниелей кавалер-кинг-чарльз-спаниель кавалер-кинг-чарльз-спаниеля
коготь: когти
полезный: полезному
порода: породе породы пород порода
унаследовать: унаследовали унаследовавшее
быстро: быстро
раздражать: раздражают
руководствоваться: руководствоваться
первый: первой первое первый
частый: частое чаще почаще
роль: ролью роль
присутствие: присутствия присутствием
превышать: превышайте
исключительный: исключительные
видео: видео
требовать: требуемой
присовокупить: присовокупить
присаживаться: присаживается
внимание: внимания внимание внимании
меню: меню
полностью: полностью
вода: воды
венценосный: венценосной
родить: родила
условие: условии
форум: форумы форум форуме форумах
пелёнка: пеленкой пеленку пеленка
возможный: возможные
писать: писали
улица: улицу улице улица
выразительный: выразительной выразительные
досаждать: досаждать
расстояние: расстояние
видеть: видящие
возвращение: возвращением
нерешительность: нерешительность
частота: частота
диван: диванах диване
список: списком списке
генрих: генрих
содержание: содержание содержания
мордочка: мордочки мордочка мордочку
кавалер: кавалеры кавалеров кавалера кавалер кавалером
немного: немного
приучать: приучать
слово: слово
кавалер-кинг: кавалер-кинги кавалер-кингах кавалер-кингов кавалер-кинга кавалер-кинг кавалер-кингами
мощный: мощный мощные
рекомендовать: рекомендуют
злаковый: злаковых
жить: живет живут
умница: умница
посторонний: посторонний
охрана: охрану
реагировать: реагировать
оставаться: остаются остается остающиеся
окрас: окраса окрас окрасы окрасов
веганский: веганским
сходить: сходила
кстати: кстати
поколение: поколений
он: нему
связь: связь
доверять: доверять
надёжный: надежного
клуб: клуб
ходить: ходят ходить
отличный: отличной
схожесть: схожести
кеннела: кеннел
заячий: заячьей
внешность: внешность внешностью внешности
газета: газету
сторонник: сторонников
навернок: навернок
найти: нашел
владелец: владельцев владельцу владельцы
завести: завел
сливка: сливки
родство: родстве
вникать: вникать
изучение: изучением
пока: пока
стать: стали стал станет
фон: фоне
смазывать: смазывают
травма: травму
профессиональный: профессиональных
жильё: жилья
аллергия: аллергии
переутомиться: переутомиться
вязка: вязки
выставочный: выставочной выставочным выставочных
перхоть: перхоть
лёгкий: легким легкая
дважды: дважды
накапливать: накапливают
нижний: нижние
непонимайк: непонимайки
структура: структуру
давать: давать
кислота: кислоты
коляска: коляски
обувь: обувь
коммуникабельность: коммуникабельностью
подрезать: подрезают
шелковистый: шелковистого шелковистая шелковистую
беспорядок: беспорядок
поладить: поладит
лидерство: лидерство
скука: скукой скуке
вкусняшка: вкусняшек вкусняшку
выбрать: выбрана выбрать
дорогой: дорогими
награда: награды
причина: причина причине
утопить: утопить
ежедневный: ежедневном
качество: качестве качества
преследовать: преследовать
поле: поле
подобрать: подобрать
смотреть: см смотрите
сходиться: сходятся
пара-тройка: пару-тройку
свинина: свинина
вильгельм: вильгельма
истинный: истинное
фотография: фотографии
осматривать: осматривать
солёный: соленые
помогать: помогает
невзирая: невзирая
агрессивный: агрессивная
надолго: надолго
уход: уходе уход
знать: знать
транспортировать: транспортируют
карьера: карьере
дань: дань
поражать: поражать
псина: псиной
результат: результат результаты результате
дать: данной дали
высокий: высокая высокие
питомник: питомники питомников
выбирать: выбирайте
глаз: глаза глазах
летний: летний
приняться: принялись
самый: самый самыми самые
жирный: жирные
работать: работая
прийтись: придется
сбросить: сбросить
мягкий: мягкий мягкие
недостаток: недостатков недостатки
сметана: сметана
пускать: пускать пускали
морда: морды морда
сказать: сказать
век: века век
смысл: смысле
форма: форме
внести: внесены
любознательный: любознательного
порядок: порядки
хитрость: хитрость
поскольку: поскольку
неудачный: неудачная неудачным
природный: природного
обучение: обучения
незнакомый: незнакомой
джонни: джонни
охотничий: охотничьи
краткий: краткая
выгибать: выгибают
неправильный: неправильной
компаньон: компаньона
база: базы
любой: любого любое любые любой любом любому
отношение: отношение отношению
обаяшка: обаяшки
место: место месте
компания: компанию
вводить: вводите
малыш: малышей малыша
исключительно: исключительно
кадр: кадр
больной: больного
предпочтение: предпочтениями предпочтение
эксперт: экспертов
неограниченный: неограниченным
приятель: приятели приятеля
переборщить: переборщили
факт: факт
бровь: бровях
доверить: доверить
вконтакте: вконтакте
просмотр: просмотр просмотров
старый: старый
свет: свет
хэкнуть: хэкни
рядом: рядом
придирчивый: придирчивым
секция: секции
собачий: собачью
ласковый: ласковы ласковые
дейк: дейк
разновидность: разновидности разновидность
заводной: заводные
встречный: встречном
неотвратимый: неотвратимо
ярко: ярко
столетие: столетию
средство: средств
доброжелательность: доброжелательности
покои: покои
ценник: ценник
приучить: приучите приучить
животное: животных животным животного животными животные животное
различие: различия
один: одного одно одной
одинаково: одинаково
бег: беге
притягивать: притягивают
характер: характером характера характер
преследование: преследования
длина: длины
тиран: тиран
неслучайно: неслучайно
парламент: парламент
оба: обеих
изделие: изделия
хэтчер: хэтчер
рассмешить: рассмешить
передать: передадут
основать: основана
толстый: толстым
хотя: хотя
проникновенный: проникновенным
вдвоём: вдвоем
х: х
кинг-чарльз-спаниель: кинг-чарльз-спаниеля кинг-чарльз-спаниелем
близкий: ближайших близком
скользкий: скользком
постоять: постоять
непоседа: непоседа
внешний: внешних внешнюю
хвост: хвостом хвост
выгуливать: выгуливать
который: которую которое которыми которой котором которых которым которые которому который
скула: скулах
подражать: подражать
называть: называемого
середина: середины середине
мероприятие: мероприятиях мероприятиям
предрасположенность: предрасположенности
квартирный: квартирные
точка: точки
квартира: квартире
размер: размеры
официально: официально
мера: меру
курчавый: курчавой
проживать: проживает
информация: информация
спаниель: спаниелей
максимально: максимально
монарх: монарх монархов
вымыть: вымытое
соблазн: соблазна
сустав: суставы
палец: пальцами
будущее: будущем будущего
кинг: кинг кинги кингов
сначала: сначала
правление: правления
генетический: генетической генетических
кошка: кошкой кошки кошку кошками
специалист: специалистов специалист
половина: половины
угасать: угасать
мириться: мириться
появиться: появившийся
перекрывать: перекрывает
по-маленькому: по-маленькому
крепкий: крепкие
слышать: слышали
обаяние: обаянием обаяния
поясничный: поясничной
протереть: протереть
габарит: габариты
ощупь: ощупь
дом: дом дома доме
талант: таланты
число: число
пушистый: пушистыми
крупа: крупы
категорически: категорически
жёлудь: желудей
продолжительность: продолжительностью продолжительность
настроение: настроении настроения настроение
ориентальность: ориентальностью
длинный: длинные длинным длинная длинной
считаться: считается считаются
натуралка: натуралка
загрязнение: загрязнения
ваш: ваше
просто: просто
забывать: забывать забывайте
мало: мало
неглубокий: неглубоким
слизистая: слизистую
синдром: синдром синдромы
одиночество: одиночестве одиночеству
счастливый: счастливым счастливы
подпалина: подпалинами
знакомить: знакомить
нахождение: нахождения
сушка: сушка
остальной: остальной
иметь: имеющему имело имеет имеющие имеют
принять: принято принята
ксеня: ксеня
час: часа
рыжий: рыжий рыжими
мажор: мажора
аксессуар: аксессуара
обратить: обратить
удаляться: удаляются
составление: составлением
территория: территории
пёсик: песик
приводить: приводят
считать: считают считать
чайный: чайного
екатерина: екатерина
контакт: контакт
начинаться: начинаются
добавить: добавьте
человек: человеку человека человеком
прогулка: прогулки прогулок прогулке
мусор: мусор
сфера: сферы
культура: культур
умеренный: умеренная умеренное
врождённый: врожденной
происхождение: происхождения
трепать: трепать
тёмный: темные
искусить: искушенный
лапка: лапки
наследственный: наследственные
демонстрировать: демонстрируют
необходимо: необходимо
готовый: готовы готовый
разучивать: разучивать
выявить: выявлены
пища: пищи
частично: частично
задний: задние
заведомо: заведомо
овощной: овощное
покрывать: покрывает
корм: кормом корма
подогреть: подогреть подогрело
ждать: ждем
дрессировка: дрессировка дрессировке
изящество: изяществом
время: время времена времени
истинно: истинно
приблизительно: приблизительно
сука: суки сук сука
миксоматозный: миксоматозная
агрессивность: агрессивность
резвый: резвого
заработать: заработает
день: дней день дни
наказание: наказания
деятельность: деятельности
ландсирый: ландсира
родственник: родственников
использовать: используйте использовать
отнять: отнять
учебный: учебного
уверять: уверяют
перловка: перловка
например: например
несколько: несколько
обнаружиться: обнаружились
переизбыток: переизбытка
рост: рост
наблюдатель: наблюдателя
отечественный: отечественных
променад: променадах
триколор: триколор
гриб: грибы
метрика: метрикой
вне: вне
определяться: определяется
хотеться: хочется
лимит: лимит
резко: резко
реклама: реклама
фен: феном
плоский: плоский
репутация: репутация
полотно: полотна полотен
неравнодушный: неравнодушна
угодить: угодить
вытянутый: вытянуты
принцип: принципами
нестабильность: нестабильность
депп: депп
звук: звук звуки
ягода: ягоды
второй: второй второго
сторона: стороне сторону
тротуар: тротуарам
рекомендоваться: рекомендуется
получиться: получится получилось
воспитание: воспитание
атласный: атласной
контактировать: контактировать
конус: конуса
эксперимент: эксперименты
сайт: сайту
путаться: путается
сохранить: сохранило
родословная: родословной
достать: достал
издавать: издают
полезно: полезно
получаться: получаются
компьютерный: компьютерные
мода: моду
крупный: крупная крупные
быть: будут
этот: эта этих
лишь: лишь
опытный: опытные
тот: теми тех той
экстерьер: экстерьер экстерьере
домашний: домашним
позвоночник: позвоночника
стоп: стопом стопа
достаться: доставшиеся
начало: начала начало
приход: приходом
действие: действия действие
общительный: общительных
конечный: конечный конечном
любитель: любитель любителей
собачонка: собачонках
натали: натали
мясо: мяса
идеальный: идеальных
ровный: ровные ровной
верхний: верхними
близко: близко
изрядно: изрядно
шоу-класс: шоу-класса
инвалид-колясочник: инвалидом-колясочником
почёсывать: почесывать
описание: описание
возмущаться: возмущайтесь
измениться: изменился
посадить: посаженные
пройтись: пройдитесь
раствор: раствора
специализировать: специализированные
плохой: плохого
разглаживать: разглаживать
купание: купаний
искренне: искренне
иноходь: иноходь
устраивать: устраивать
поэтому: поэтому
какаржинский: какаржинская
являться: являлись являются
бразда: бразды
копирование: копирование
дружелюбный: дружелюбная
пройти: прошли
активность: активность
подверженный: подвержены
помещение: помещении
насыщенный: насыщенный
дружелюбность: дружелюбность
скручивание: скручиванию
доступ: доступ
плавно: плавно
отзыв: отзывах отзывы
остаться: остались
походить: походить
нуль: нулю
нужда: нужд
следовать: следует
комиссия: комиссии
пожелать: пожелает
провод: провода
животный: животному
отсутствие: отсутствии отсутствие
шум: шум шуму
самостоятельный: самостоятельные
преувеличенно: преувеличенно
мопс: мопсами мопсов
трон: трон
боль: боли
особь: особи особей
потребность: потребностях потребность
выявление: выявление
прямой: прямая прямой
гламурный: гламурного гламурных
вопрос: вопросами
гладить: гладить
лужица: лужицы
гулять: гуляют гулять
клетка: клетку клетках
значение: значение
выучить: выучить
назад: назад
ведущий: ведущие
перепелиный: перепелиное
почему: почему
решить: решили решившим
кость: кости
наш: наши
интерес: интерес
костистый: костистые
мочь: могут мог
хороший: лучшие
влияние: влияния
благородный: благородного
возраст: возрастом возрасте
всеобщий: всеобщего
калорийный: калорийной
целое: целом целого
объявление: объявления
лишить: лишено лишены
зона: зонах зоной
белый: белым белый белом
основной: основные
родитель: родителями
интеллект: интеллект
охранный: охранные охранной
многие: многие
пролапс: пролапс
конечность: конечностей конечности
вес: вес
спина: спину спиной спины
вуд: вуд
го: го
рассекать: рассекающими
полотенце: полотенцем
конец: конец
поклонник: поклонниками
попытаться: попытается
потчевать: потчевать
чемпион: чемпионов
голос: голос
нос: носа нос
рада: рады
сон: сна
по-настоящему: по-настоящему
постав: постава
брать: берите
шубка: шубке
курносый: курносых
рацион: рациону рацион
добрый: доброе
положить: положено
аристократ: аристократы аристократам аристократов
именно: именно
чуждый: чужды
уборный: уборная уборным
отклонение: отклонения
стиль: стиле
склонный: склонная
спать: спящими
устойчивый: устойчивая
нормальный: нормальной
той-спаниель: той-спаниели той-спаниелей
наперегонки: наперегонки
отлично: отлично
питание: питанию
снимать: снимать
повадка: повадками
дисквалифицировать: дисквалифицируют
денежный: денежную
борный: борной
обладать: обладающий
скрещивать: скрещивать
положение: положении положения
оказываться: оказывается
бобовый: бобовые
оттенок: оттенок
симпатяга: симпатяг
развитие: развития
запретить: запрещенные запрещено
мурлыкать: мурлыкающей
утвердить: утвержденными утвердил
антисанитария: антисанитария
слегка: слегка
наслаждаться: наслаждайтесь
покрытие: покрытиях покрытия
восхождение: восхождением
капнуть: капнуть
сокращать: сокращают
фото: фото
любопытный: любопытны
затея: затея
кончик: кончика
прирождённый: прирожденные
развесёлый: развеселый
поучаствовать: поучаствует
два: две
утомить: утомив
яндекс: яндекс
выпученность: выпученности
умный: умны умная
количество: количество количестве
обожать: обожают обожал
рука: руках
режим: режим
ножницы: ножницы
страдать: страдает страдающих
пытаться: пытаться
доморощенный: доморощенные
оставлять: оставлять
привычка: привычек привычку
тактильный: тактильный
помнить: помнить
череп: череп
лапа: лапы
экстраверт: экстраверты
ухо: ушах ушами уши
холка: холке
расценка: расценки
получение: получение
стараться: стараются
двор: дворе
журнал: журнал
сводить: сводит
неделя: недели неделю
речной: речная
рожать: рожать
высота: высота
вокальный: вокальные
сохнуть: сохнуть
что-то: чем-то
выразить: выражено
удлинённый: удлиненную
мастиф: мастиф
клан: клан
любимец: любимцам любимца любимцы
увеличивать: увеличивают
нуждаться: нуждаются нуждается
серьёзность: серьезностью
тэри: тэри
утвердиться: утвердилась
секрет: секреты
больший: большие больших
хозяин: хозяину хозяевам хозяина
ширина: ширины
уживаться: уживаются
болезнь: болезни болезнью болезнь
ограниченный: ограниченной
заводчик: заводчиков заводчика заводчики
дирхаунд: дирхаунд
рубиновый: рубинового рубиновый
совершенно: совершенно
запросто: запросто
поиграть: поиграть
решать: решает
активно: активно
возродить: возродить возрожденной
поднять: поднять
минута: минут
выводить: выводят
будущий: будущих
герцогиня: герцогинь
образ: образом
существенный: существенные
придание: придания
полежать: полежать
собачка: собачки собачек
кенить: кени
ванна: ванну
обнаружить: обнаружены
обезопасить: обезопасить
отдел: отдела
селекция: селекции
линейный: линейного
лоток: лотку
взрослый: взрослые взрослым
проявлять: проявляющего
кобель: кобели кобель
плохо: плохо
четверолапый: четверолапому
пристрастие: пристрастиям
депигментировать: депигментированную
азиатский: азиатского азиатских
пищевой: пищевой
дело: дело дела
волнистость: волнистость
немой: нем
напряжение: напряжение
родиться: род
перейти: перейти
состоять: состоящих
постный: постные
сутки: сутки
статус: статус
ткань: ткани
каждый: каждом каждый каждая
разный: разные разных
из-за: из-за
говориться: говорилось
заселить: заселив
будуар: будуарах
заворачивать: заворачивать
чистить: чистят чистить
уголок: уголках
игнорировать: игнорирует игнорировать
охота: охота
уровень: уровне
традиционный: традиционной
синатр: синатра
шёрстка: шерсткой шерстка
тест: тестов
добродушный: добродушным
воспаление: воспаление воспалениях
вместо: вместо
обстановка: обстановке
внимательный: внимательным
слишком: слишком
водить: водят
кровожадный: кровожадный
перегружать: перегружая
хвалить: хвалить
отучить: отучить
твёрдый: тверже
стандарт: стандарта
шанс: шансы
оживить: оживит
падение: падения
выдать: выдать
море: море
путаница: путаницы
гигиена: гигиена
направить: направленных
карла: карла
удаться: удастся
замашка: замашек
грудь: грудью
ван: ван
зимний: зимнее
киари: киари
оценка: оценке
рубль: рублей
родина: родине
лужайка: лужайке
пользоваться: пользоваться
сложный: сложнее
разведение: разведения
мочка: мочка мочку
предпосылка: предпосылкой
оказаться: окажется
вдаваться: вдаваться
подкупить: подкупить
половик: половиками
скрытый: скрытыми
испытывать: испытывает испытывающие
дог: дог
банальный: банальной
предназначение: предназначение
ушной: ушного
дегенерация: дегенерация
варежка: варежкой
заинтересованный: заинтересованное
психологический: психологическом
засыпать: засыпают
риск: риска
разбойничий: разбойничьих
хина: хинами
племенной: племенных
ассоциация: ассоциация
чеснок: чеснок
выставка: выставке
японский: японскими
завоёвывать: завоевывать
огромный: огромное
стоимость: стоимость
процесс: процесса
заседать: заседали
желательно: желательно
последний: последние
своевременный: своевременного
дефицит: дефицит
строптивость: строптивости
включать: включать
хью: хью
страна: стран странах страна
достаточно: достаточно
дрессировать: дрессировать
потеряться: потеряться
мягко: мягко
обязательно: обязательно
доминировать: доминировать
ход: ходе ход
перекрыть: перекрыты
истощение: истощении
круглый: круглые
пара: пару
постигать: постигают
сирингомиелия: сирингомиелия
прикус: прикусом
нагрузка: нагрузках
отметка: отметки
чрезмерный: чрезмерной
европа: европы
популярность: популярность
поводок: поводке
ламинат: ламинате
отдавать: отдает
англия: англии
охотно: охотно
опасность: опасности
несмотря: несмотря
сладость: сладости
купить: купить купите
часто: часто
азарт: азартом
утешитель: утешителей
подпал: подпалом
семья: семье семья семей
свой: своего своей своему свои
немыслимый: немыслимые
масло: маслом
заболевание: заболеваний
войти: вошли
учесть: учли
фотогеничный: фотогеничны
кс: кс
новый: новое новый
желание: желание желания
сообразить: сообразит
вестись: ведутся
спад: спадам
реестр: реестры
яичко: яичко
голова: голова
случай: случаях случае
убирать: убирая
почесулька: почесульки
разъезжаться: разъезжаться
ядовитый: ядовитого
создание: созданием
крыться: кроется
живой: живой
революция: революции
прежний: прежних
проблема: проблему проблем
лохматый: лохматый
травмировать: травмировать
одуванчиков: одуванчиковой
назойливый: назойливых
оранский: оранского
англичанин: англичанина
вентилироваться: вентилируются
рагу: рагу
обитатель: обитатели
племя: племени
весь: всем
далеко: далеко
навсегда: навсегда
одноклассник: одноклассники
отметать: отметайте
знакомый: знакомым
классический: классическую
возможность: возможности
нетипичный: нетипичным
ветпаспорт: ветпаспортом
случайный: случайные
передний: передние
кроме: кроме
аргентинский: аргентинский
объятие: объятья
хлеб: хлеб
шоу-особь: шоу-особей
след: следами следы
ковёр: ковром
кот: коту
трубчатый: трубчатые
напрочь: напрочь
бридер: бридеры
держаться: держится
поиск: поиск
делать: делают
польза: пользы
беспримерный: беспримерные
участие: участия
зависимый: зависимы
общий: общего
оптимальный: оптимальный
привить: привить
выпревание: выпреванию
зуб: зубы
привилегия: привилегий
выполнять: выполняет
хандра: хандры
занятие: занятиях
вялость: вялость
разрешить: разрешено
неэффективный: неэффективным
прародитель: прародителями
пучеглазый: пучеглазые
применение: применением
фенотип: фенотипе
ящерица: ящерицу
период: период
энергичный: энергичных
чемпионский: чемпионские
шампунь: шампунем
тонкость: тонкости
представить: представлен
свобода: свободой
сторож: сторожа
натуральный: натуральному
зрение: зрения
щётка: щеткой
офтальмолог: офтальмологи
сделать: сделано сделала
встретить: встретив
лакомство: лакомством
приветливый: приветливый
порок: пороки
хозяйский: хозяйского
фрэнк: фрэнк
предок: предков предками предка
линька: линьки линька
стушеваться: стушевавшись
капля: капель
жизнь: жизни жизнь
мокрый: мокрой
нежирный: нежирная
заканчиваться: заканчивается
ярко-выраженный: ярко-выраженной
выдающийся: выдающиеся
подтягивать: подтягивают
право: право
ребёнок: детьми
мешать: мешает
отказаться: отказаться
говорить: говорить
воевать: воюют
префикс: префиксы
небольшой: небольшой
спонж: спонжем
облегчение: облегчения
длительный: длительных
прикрыть: прикрыт
сородич: сородичи
пакостить: пакостить
чарльз: чарльз чарльза
особа: особы
привязать: привязаны
волнистый: волнистая
изгиб: изгибом
успех: успехи
эдвин: эдвина
мимимишность: мимимишности
слабый: слабое
также: также
царить: царят
рональд: рональд
кошкея: кошкеи
бычков: бычкова
лук: лук
покупка: покупки покупке покупка
момент: моменты
уберечь: уберечь
искриться: искрящийся
сушить: сушат
бок: боку
возможно: возможно
король: короля
корпус: корпус
элегантность: элегантность
дополнительный: дополнительную
волноваться: волноваться
стенка: стенкой
наследство: наследство
стоить: стоить стоит
дискомфорт: дискомфорт
короткий: короткой
высоко: высоко
ранее: ранее
эпизодический: эпизодического
восседать: восседающими
конкретно: конкретно
покусать: покусать
котёнок: котенка
хлопанье: хлопанье
ожирение: ожирению
сложно: сложно
кисломолочко: кисломолочка
крайне: крайне
область: области
это: это
тибетский: тибетских
ласка: ласку
перепутать: перепутать
сформироваться: сформируется
черно-подпалый: черно-подпалого
каштановый: каштановые
практиковаться: практикуется
шейный: шейного
обещание: обещание
зависеть: зависит
ням-нь: ням-ням
разводить: разводить
хефнер: хефнер
сведение: сведению
вполне: вполне
портить: портят
интенсивный: интенсивных
смочь: сможет
перекроить: перекроенный
кусочек: кусочек
бомонд: бомонд
снять: снять
ньюфаундленд: ньюфаундленд
клапан: клапана
заинтересоваться: заинтересовалась
отправление: отправления
позитив: позитива
пыль: пыль
какой-нибудь: каким-нибудь
сезон: сезон
собрать: собрать
пребывать: пребывают
существо: существу
удачно: удачно
легко: легко
многий: многих
нестандартный: нестандартные
фобия: фобию
напольный: напольного
избыточный: избыточном
лента: ленту
грунтовый: грунтовые
огурец: огурцы
слизь: слизь
здоровье: здоровье
губа: губой
воспитать: воспитать
обильный: обильная
броситься: бросился
звонкий: звонкий
основательно: основательно
ватный: ватным
британия: британии
желток: желток
лай: лай лаем
параметр: параметров
ожидаться: ожидалось
титул: титулы
обмен: обмен
лёжа: лежа
предыдущий: предыдущих
расчёсывать: расчесывать
тыльный: тыльной
игрушка: игрушкам
фотомодель: фотомодели
ркф: ркф
именовать: именовали
сила: силу
процветать: процветала
вакансия: вакансии
угощение: угощение
продукт: продукты
грызун: грызуна
салатик: салатики
приходиться: приходится
погрызть: погрызть
лондонский: лондонский
постоянно: постоянно
общительность: общительностью
дальнейший: дальнейшем
вор: вора
выше: выше
короткомордый: короткомордые
сорт: сорта
возбраняться: возбраняется
течение: течение
чересчур: чересчур
погоняться: погоняться
повысить: повысить
большинство: большинство
лекарь: лекари
главный: главная
практически: практически
экзотический: экзотическим
рейтинг: рейтинг
инбридинговый: инбридинговой
подписываться: подписывайтесь
двигаться: движется
недостаточныйизбыточный: недостаточныйизбыточный
портрет: портреты
человеческий: человеческом
ты: тебе
сильный: сильные
компактный: компактное
приставка: приставка
кабачок: кабачки
всасывать: всасывает
точность: точностью
обязанность: обязанности
очень: очень
обычно: обычно
недаром: недаром
поболтать: поболтать
особенность: особенности особенность
поддаваться: поддаются
проблемный: проблемный
мытьё: мытье
сторонний: стороннего
наоборот: наоборот
происходить: происходит
движение: движений
избежать: избежать
альбумин: альбумина
кличка: клички
отождествлять: отождествляют
бленхейм: бленхейм
правило: правила
крем: кремом
вариант: варианта
диагностировать: диагностировать
деревце: деревцем
выпечка: выпечка
свидетельствовать: свидетельствуют
экземпляр: экземпляр
повернуть: повернуты
чистопородный: чистопородный
глазастый: глазастых
необходимый: необходимые
схожий: схоже
обещать: обещающих
прогрессировать: прогрессирует
многоквартирон: многоквартироном
проект: проекте
сразу: сразу
арсенал: арсенала
пора: пор
кг: кг
температура: температура
заметный: заметной
сидеть: сидеть
темперамент: темперамента темперамент
курица: курицы
промышленный: промышленным
запас: запаса
висячий: висячего
ответ: ответ
скапливаться: скапливающиеся
туловище: туловище
интервязка: интервязки
снижаться: снижаться
колбасный: колбасные
ругать: ругайте
кормление: кормления кормление
лизнуть: лизнуть
баронесса: баронесс
волна: волне
причём: причем
формирование: формирования
купироваться: купировался
полноценно: полноценно
громкий: громким
давно: давно
премия: премию
есть: едят
вольер: вольер
пателлярный: пателлярная
рассмотреть: рассмотреть
выбор: выборе
равномерный: равномерного
состав: состава
пряный: пряные
типичный: типичные
набрать: наберет
кондиционер: кондиционером
