радость: радостью
короткий: короткую короткий короткие короткая короткой
попытка: попытке попытках
уметь: умеющих
существование: существование
обусловить: обусловлено
состоять: состояли
отличать: отличают
использовать: используя используйте используют использовать
кинолог: кинологов
пигментация: пигментацию пигментация
приобретать: приобретают приобретая приобретает
широко: широко
средний: средняя среднее средних средней средние
популярность: популярности популярностью популярность
соотечественник: соотечественник
защита: защиту
потрудиться: потрудитесь
параллельный: параллельные
загонять: загонять
дрожжевой: дрожжевое
четвероногий: четвероногих четвероногим четвероногую четвероногому
сколько: сколько
быть: будете е будьте будут будь
морской: морскую
название: название названием
кинологический: кинологический
погоня: погоню погоня
собака: собаку собаками собакой собак собака собаке собаки
предостерегающе: предостерегающе
приятный: приятный приятную
порок: пороков порокам пороки
справляться: справляются
ноздря: ноздри
обсуждение: обсуждения
неширокий: неширокие
другой: другое другую другие другими другим
предпочтительный: предпочтителен
ревностный: ревностной
ваш: вашему вашу ваше вашим вашей вашего ваша
миска: миску
оно: оно
английский: английских английским английская английскую английский английские английского
цена: цена
рыба: рыбу
диск: диска
любимый: любимых любимой
подушечка: подушечки подушечками
расположение: расположения расположение
процедура: процедуре процедуры процедура
материал: материалов
щетина: щетиной
казаться: кажется казаться
обнажить: обнажена обнажит
дыхание: дыхание
собрат: собратьям собрату собратьев
обратить: обратите
точный: точный
признать: признал
владелец: владельцам владельцев владельцы
вымыть: вымыть
льюэллин: льюэллин льюэллина
принять: примут
перерастать: перерастающего
олд-молл: олд-молл
гнойный: гнойному
отравление: отравление
неуправляемый: неуправляемой
инстинкт: инстинкты инстинктам
пятно: пятнами пятен
множество: множества
выраженный: выраженный
побегать: побегать
русский: русский
россия: россия россии
живот: живот
ждт: ждт ждте
строгий: строгую строгой
раковина: раковины
забыть: забудьте забыв
обратный: обратная
приблизить: приближена
маленький: маленьким маленький маленькими
размер: размеров размер
радужка: радужки радужка
ради: ради
предварительно: предварительно
скрасить: скрасит скрасить
представитель: представителей представители
утончнный: утончннее
компаньон: компаньонов
команда: команду командам команд команда
шея: шея шею
отмечать: отмечают
выплеснуть: выплеснуть
шерсть: шерсть шерсти шерстью
поверхность: поверхности
низкий: низкий
крючкообразный: крючкообразный
выявить: выявили
выразить: выражены
одиночество: одиночества одиночеству одиночество
крупа: крупа круп
качество: качеств качестве качества
предпочительный: предпочительны
помт: помт помта
челюсть: челюсти челюстям
тип: тип типа
случайно: случайно
узкий: узкая узкий узкую
прямоватый: прямоватые
тримминг: тримминг
каштаново-красный: каштаново-красного
содержать: содержать содержавших содержат
взгляд: взгляд взгляде
исключение: исключение
посадить: посажен посажены
стойка: стойки стойке стойку
энергия: энергию энергии
нести: неся
сохранение: сохранения сохранение
филд: филд
человек: людям человека человек
месяц: месяц месяцев
питомец: питомцами питомцев питомец питомцы питомца
королевский: королевской
рождаться: рождаются
относиться: относится относились относятся
сочленить: сочленены
волшебный: волшебным
сверху: сверху
великобритания: великобритания
двум-трма: двум-трм
шрстный: шрстного шрстный
плечо: плечам плечи
завтрак: завтрака
отличаться: отличается отличаются
магазин: магазин
формат: формат
участие: участием участие участия
важно: важно
присоединять: присоединяя
главный: главный главные главная
душа: душе душу
больший: большем
история: история истории
ватный: ватного
щенок: щенка щенков щенки щенок щенками
определение: определения
парка: парке
пространство: пространстве пространство пространства
белок: белка белков
требовать: требовать
паралич: параличу
попросить: попросите
элегантный: элегантный элегантным элегантная
настолько: настолько
прилегать: прилегающие прилегают
форма: форма форму формой формы
передача: передач
особый: особое
голова: голове головы голову голова
переломный: переломным
обидиенс: обидиенс
кисломолочный: кисломолочные
продолжать: продолжай продолжая продолжает
семья: семьи семье семей
сеттер: сеттеров сеттера сеттеру сеттер сеттерам сеттеры сеттером
нередко: нередко
ставить: ставит
выпуклый: выпуклые выпуклую выпуклыми выпуклый
характеристика: характеристика
род: рода
начинающий: начинающим
стоп: стоп стопа
пятьдесят: пятьдесят
роскошный: роскошной
исключить: исключите
рабочий: рабочая рабочих рабочей рабочую
такой: таком такие такого
помощь: помощью помощи
чрный: чрный чрным чрных
экземпляр: экземпляры экземпляров экземпляр
дом: дому дома доме
предать: преданным преданного
нос: носу носа
заводчик: заводчик заводчика заводчики
доминантность: доминантности
следующий: следующие следующий
год: годы года годам лет году
пол: пола пол
клетка: клеткой клетка клетки
подразумевать: подразумевает
грациозный: грациозный грациозные
коготь: когти когтями
отрастать: отрастая
вложить: вложил
порода: породе породам породы пород породами породу порода
значит: значит
собаковод: собаководам собаководов собаководы собаководами
популяризация: популяризации
палец: пальцы пальцами пальцев палец
первый: первой первые первую
сужаться: сужается
основное: основном
ризеншнауцер: ризеншнауцера
незнакомец: незнакомца незнакомце
видео: видео
помимо: помимо
темпераментный: темпераментном
возможный: возможные
компания: компании компанию компания
каша: кашами
счтом: счтом
каждый: каждой каждые каждом
позаботиться: позаботьтесь позаботиться
небольшой: небольших небольшие
чай: чай
участвовать: участвовали
рисовый: рисовой
гиперобщительность: гиперобщительность
косточка: косточками
выбор: выбором выбор
рацион: рациона рацион
нависать: нависает
лопатка: лопатками лопаток
хороший: хорошим лучший лучшая хороши
содержание: содержание содержания
рак: раков
предположить: предположить
изгиб: изгибами
предъявлять: предъявляйте
крайность: крайности
свет: света
хвост: хвосте хвоста хвост
голод: голода
слово: слово словам
разлука: разлуки
поставить: поставила поставлена поставлены поставленные
усиливаться: усиливаться
лаверак: лаверака лаверак
окрас: окраса окрас окрасом окрасов
объект: объект
шубка: шубкой
подвес: подвес
ушной: ушные
территория: территорию территории
он: нему
обернуться: обернуться
подчинение: подчинения
связь: связь связях
бояться: боятся бойтесь
клуб: клуб
покрыть: покрыты покрыт
угол: углом
отличный: отличной
вода: воде вода
красный: красные
внешность: внешность
ветер: ветра
бездействовать: бездействовать
срок: сроки
лоб: лба
острый: острую острые
спокойствие: спокойствия
переводиться: переводится
прослеживаться: прослеживается
ортопедический: ортопедический
частный: частном
намного: намного
котёнок: котенком
пока: пока
стать: стали стало стать станет
красота: красоты
от: ото
произошлый: произошл
полный: полная полным
бутилировать: бутилированная
принимать: принимая
выставка: выставок выставке
морда: морду морда
состояние: состоянии
выполнить: выполнить
элитный: элитный элитных
подойдт: подойдт
чрезмерный: чрезмерную
аллергия: аллергии
член: член члены
яйцо: яйца
выставочный: выставочной выставочная выставочный выставочную выставочных
пудель: пудели
дважды: дважды
накапливать: накапливают
интерес: интереса
аристократ: аристократ аристократов аристократа
давать: давать давая
размять: размять
ребнок: ребнок
мягкость: мягкость
подтверждать: подтверждают
право: права право
старший: старше
обычный: обычными
плотно: плотно
расчсывание: расчсывании
пруд: пруду
причина: причина причины причиной
ежедневный: ежедневном
птица: птиц птицу птицами
плоский: плоскую плоские
смотреть: см
иммунитет: иммунитетом
фотография: фотографии
широкий: широкие широкую
гордо: гордо
невзирая: невзирая
агрессивный: агрессивная агрессивное
работать: работать
уход: уходе уход
чтко: чтко
знать: знать
революция: революция
последовательный: последовательные
изящный: изящнее
щки: щки
вылизывать: вылизывать
страдать: страдают
высокий: высокая высокую высокой
питомник: питомники питомника питомниках питомнике
глаз: глаза глаз глазами
ненавязчивый: ненавязчиво
стремиться: стремится
дружелюбный: дружелюбное дружелюбным дружелюбных
должный: должен
самый: самый самым самых самые
грязь: грязь грязи
незнакомый: незнакомым
поддержать: поддержит поддержал
корм: корм кормом корма
человеческий: человеческой
часть: части частью часть
незначительно: незначительно
страстный: страстным
отбирать: отбирали
витаминно-минеральный: витаминно-минеральный
поздний: позже
уютный: уютного
век: века
вести: вести
обожать: обожает обожают
поскольку: поскольку
тапочки: тапочки
проявлять: проявляют
прочий: прочие
охотничий: охотничьи охотничьих охотничьей
формула: формула
краткий: краткая кратчайшие
весьма: весьма
появление: появлением
неконфликтность: неконфликтность
отношение: отношение
заболевание: заболеваниям заболеваний
уделять: уделяйте
ветвь: ветви
исключительно: исключительно
заболотить: заболоченной
край: края
отметить: отметить
весь: весь всей всему всеми
закономерность: закономерность
игривость: игривость
эксперт: экспертов
купать: купать
направить: направлены
умный: умный
десять: десять
факт: факт факты
любимец: любимцем любимцу любимца любимец
вконтакте: вконтакте
просмотр: просмотр просмотра
послушный: послушных послушная послушным
рядом: рядом
версия: версии версия
ответственный: ответственного
создать: создать
сочетать: сочетает сочетайте
бретонский: бретонскому
сочетание: сочетание
переход: переход
разведение: разведением разведения
мопс: мопс
ярко: ярко
роль: роль
хозяин: хозяин хозяином хозяину хозяина
грубоватый: грубоваты
животное: животных животным животного животными животные животное
один: одного одна одной одном одни
сырой: сырую сырые сырое
работа: работой работы
мяч: мячом мяч
чадо: чадо
земля: земле земли
печальный: печальными
сыр: сыром
верх: верх
длина: длины длиной длина
выборка: выборку
светлый: светлая светлую
иван: иван
выбрать: выбрать
привлк: привлк
грамотный: грамотной грамотное
неприятный: неприятному
кусочек: кусочки
причм: причм
эффект: эффектом
основать: основана
нежелание: нежелание
охотник: охотниками охотник охотником
ливер: ливер
придерживаться: придерживался придерживаться
присмотр: присмотра
крест: крест
мягкий: мягкие мягкая
интеллигенция: интеллигенции
аллергический: аллергическую
расширение: расширению
манер: манер
рассчитать: рассчитать
лишний: лишним
проведт: проведт
красавица: красавица
установить: установить установите
пометка: пометками
крап: крапа крапом
знакомиться: знакомится
будущий: будущей
собственный: собственным
заняться: занялся
непослушный: непослушным
проживать: проживать проживает
лаверак-сеттер: лаверак-сеттеры
квартира: квартире
официально: официально
мера: меру мере
англичанин: англичанин англичан англичане англичанина
плод: плоды
известный: известны известным
присутствовать: присутствуют
информация: информация
руководствоваться: руководствовались
защищнный: защищнного
приставка: приставку
подходить: подходит
друг: друг друге другом друга друзьями
спаниель: спаниелей спаниели
заполнить: заполнено заполнена
создание: создание
жир: жир
скосить: скошенный
зуб: зуба зубы
сво: сво
сустав: суставы
делиться: делится делитесь
тычок: тычок
прогулка: прогулку прогулки прогулках
проводить: проводить
лежебок: лежебоку
создавать: создавать
активный: активного активным активных активной
ниже: ниже
образовать: образующую образуют образовали
оболочка: оболочкой
приложить: приложить
родословный: родословную
сообразительность: сообразительность
крепкий: крепкие крепкая крепкими крепких крепкого
вызывать: вызывал вызывает
привлечь: привлекла
блю: блю
букет: букетом
ощупь: ощупь
среди: среди
оживлнный: оживлнную
затылок: затылка затылку
запастись: запастись
число: число числа
дуга: дуги
любой: любое любых любом
лапа: лапах лапы лап
лежанка: лежанка
линия: линию линия линии
единодушие: единодушия
веко: веки
детский: детские детскую детский
испытывать: испытывать испытывает испытывают
обильно: обильно
проявление: проявлению
длинный: длинные длинный длинная длинной
считаться: считается считаются
указывать: указывала
кто: кем
развитой: развитые развитого
тонкий: тонкие тонкой
коричневый: коричневым коричневый коричнево
вырасти: вырастет выросших
кишка: кишок
развитый: развитый
волна: волну
провислый: провислую
представить: представьте
титулованность: титулованности
понимать: понимающего понимать
врожднный: врожднной врожднному
находить: находить
рыжий: рыжий рыжим
необходимый: необходимый
вперд: вперд
сеттинг-спаниель: сеттинг-спаниелей сеттинг-спаниель
квадратный: квадратный
ограничивать: ограничивают
лес: лесу
штанишки: штанишки
считать: считают
окружающие: окружающим
компанейский: компанейские
усилие: усилия
контакт: контакт
посчитать: посчитав
ретривер: ретриверы
оранж: оранж
добавить: добавьте
умеренный: умеренная умеренное умеренной
происхождение: происхождения происхождение
будничный: будничной
резец: резцы
необходимо: необходимо
готовый: готовы готов
пища: пищи пищей пище пищу
пять-шесть: пять-шесть
впрямь: впрямь
проявляться: проявляться
задний: задние задних
бдра: бдра
кобель: кобеля кобели кобелей
вакцинация: вакцинации
тщательно: тщательно
разрез: разрез
достоинство: достоинство
получить: полученные получите получить
дрессировка: дрессировка дрессировке дрессировки
предплечье: предплечья
стандартный: стандартный
лимонный: лимонный лимонного
время: время временем
оранжевый: оранжевым оранжевый
сука: суки
прямой: прямым прямая прямой
агрессивность: агрессивность
устроить: устроить
великолепный: великолепные великолепным
полость: полость
защищать: защищать защищает
побудить: побудила
день: дней день
местность: местности
деятельность: деятельности
специализированный: специализированных
противный: противном
пясть: пясти
кость: костей кости
противоречивый: противоречиво
притупиться: притупились
держать: держит
американский: американский американскую
традиционно: традиционно
ротовой: ротовая
параллельно: параллельно
серповидный: серповидную
догонять: догонять
речной: речную
комфортно: комфортно
случайность: случайности
сетчатка: сетчатки
охрана: охраны
рост: рост
глухота: глухоте
пищевод: пищевода
шотландия: шотландия
предпочесть: предпочтут
гриб: грибы
сила: силы
правильный: правильном
предок: предкам предки
жить: жить
брыль: брылями
ругать: ругать
к: ко
реклама: реклама
соответственно: соответственно
глист: глистов
выделять: выделяют
становиться: становилась становится
променад: променадами
очаровательный: очаровательной
нужный: нужным
хромать: хромать
дисквалифицировать: дисквалифицирующим
второй: второй
ягода: ягоды
выпуск: выпуска
соответствие: соответствия
выносливость: выносливостью
рекомендоваться: рекомендуется
губа: губ губы
воспитание: воспитание воспитании воспитанию воспитанием
достигать: достигает
предоставлять: предоставляет
западный: западной
малыш: малыш малыши малыша
премиум-марка: премиум-марки
дичь: дичи
наследственный: наследственных
умалять: умаляло
шесть: шести
разношрстный: разношрстными
наполнить: наполненной
который: которыми которой которого которая которых которым которые который
оба: обоих оба
незаметно: незаметно
поддержание: поддержания
сухой: сухие сухая сухим
сайт: сайту
черепной: черепной
периодический: периодическим
родословная: родословной
вычсывания: вычсывании
позволять: позволяет
специалист: специалисту
занять: занять
добыча: добыче добычу добычей
красно-пегий: красно-пегого
ловирак: ловираками
этот: эта этих
насчитываться: насчитывается
длительный: длительными
лишь: лишь
сюрприз: сюрпризу
вариант: вариант варианты
поймать: поймать
домашний: домашними домашнего
соперничать: соперничать
железный: железным
рбра: рбра
экстерьер: экстерьер экстерьером
включить: включите
треугольный: треугольной
поход: поход
форум: форум форуме
конкретизировать: конкретизируя
оборудование: оборудовании
заворот: завороту
варный: варную
конец: конце конец
апартамент: апартаментах
вверить: вверенную
незначительный: незначительной незначительная
паспорт: паспорт
атрофия: атрофии
проточный: проточная
закруглить: закруглены
выворот: вывороту
сформироваться: сформировались
называть: называли
шампунь: шампуни
пигментировать: пигментирована
место: месте
опустошить: опустошило
подтверждение: подтверждение
выразительный: выразительный
эпоха: эпоху
пастор: пастора
подобать: подобает
напротив: напротив
шоу-класс: шоу-класса
натуральный: натуральной
описание: описание
будни: будни
начало: начало
бельтон: бельтон
мужской: мужского
присущий: присущи присущего
оттенок: оттенки оттенок
перо: перо пером
равномерный: равномерный равномерное
гигиена: гигиены
родственный: родственных
сквозняк: сквознякам
округлый: округлые
мускулатура: мускулатура
белый: белых белого белый
найти: найти
гребень: гребень
бежать: бегущий
обрастание: обрастание
глубоко: глубоко
принести: принесла
однако: однако
огромный: огромные огромной
иноходь: иноходь
психика: психики
устраивать: устраивать
отсутствие: отсутствием отсутствие
поэтому: поэтому
вынуждать: вынуждать
пилочка: пилочка
копирование: копирование
условный: условна условного
прекрасно: прекрасно
активность: активность активности
подверженный: подвержены
основание: основания
продукт: продукта продукты
дискомфортный: дискомфортные
дружелюбность: дружелюбность
выслеживание: выслеживания
близкий: ближе
иить: иили
доступ: доступ
низ: низа
плавно: плавно
отзыв: отзывах отзывы
гордон-сеттер: гордон-сеттеры
прыгнуть: прыгнуть
нога: ноги ногами
крупный: крупных крупного
кошка: кошки кошку
следовать: следует следовать
однообразный: однообразные
толкнуть: толкнуть
чистокровный: чистокровным
животный: животному
шум: шум
гость: гостям
плыть: плывет
бурный: бурного
висячий: висячие
довольствоваться: довольствоваться
особь: особи
дрессировать: дрессируемых
крайний: крайнем
ввиду: ввиду
тврдый: тврдые
отличие: отличие
густой: густая густые
щткать: щтку
рамка: рамки
книга: книгу
понто: понто
придться: придтся
ровный: ровным
актуально: актуально
выучить: выучить
назад: назад
планировать: планируете планировал
инбриндинг: инбриндинга
цвет: цвет
скупой: скупой
настоящий: настоящий
осторожно: осторожно
мочь: могут можете
минимум: минимум
игра: играх игры игра игрой
многолетний: многолетней
возраст: возрастом возраста возрасте
огнестрельный: огнестрельные
куприн: куприн
ухо: ушей ушами уши
ружьё: ружья
атлет: атлетов
целое: целом
объявление: объявления
приседать: приседает приседающий
нарезать: нарезав
сделать: сделать сделано сделайте сделает
ласковый: ласковых ласковое
шалость: шалости
основной: основные
полова: половой
новый: новую новым нового
интеллект: интеллект интеллекта
охранный: охранные
подкрадываться: подкрадывалась
скрещивать: скрещивали
многие: многие
конечность: конечностей конечности
средне: средне
культура: культуры
вес: вес
спина: спину спины спина
степень: степени степень
солнечный: солнечным
гречневый: гречневой
лимон: лимон
блок: блок
голос: голос
линять: линяют
сон: сна сном
рада: рады
отведнный: отведнными
свой: своим своего своей своему свои
жировой: жировой
неотъемлемый: неотъемлемой
возможность: возможностью возможности
чткий: чткие чткий
нехарактерный: нехарактерный
слезиться: слезятся
именно: именно
южный: южная
чрезвычайно: чрезвычайно
коробка: коробкой
рот: рта
локоть: локтями
ошпарить: ошпарив
продолжительность: продолжительность
борзая: борзые
молодой: молодые
остаться: оставшийся
диван: диване
сечение: сечение
окантовка: окантовки
затылочный: затылочный
обеспечить: обеспечить обеспечит
подстилка: подстилке
паста: пасту пасте
крапчатый: крапчатого крапчатых
инстинктивно: инстинктивно
бобовый: бобовые
расположить: расположены
навязывать: навязывает
процесс: процессу
предпочитать: предпочитаете предпочитают предпочитали
сеть: сеть
зависимость: зависимости
осень: осенью
очертание: очертаниями очертания
способ: способом
слегка: слегка
тот: те тому
призров: призров
сэр: сэра сэр
общительный: общительной общительная
фото: фото
показать: показать
толчок: толчком
приобретнный: приобретнных
прибылой: прибылых
толстый: толстую
вы: вами
несформироваться: несформировавшимися
выделяться: выделяются
два: две двух
дуновение: дуновений
манера: манеры манеру манера
яндекс: яндекс
инородный: инородных
массаж: массаж
явный: явными
непромокаемый: непромокаемый
оптимизм: оптимизм
оставлять: оставлять
хотеть: хотите
череп: черепа череп
эрдельтерьер: эрдельтерьера
социализация: социализации
сравнение: сравнении
отклонение: отклонение отклонениями
рад: рад
обязательный: обязательная
отит: отиту отита
собрать: собраны
фрисби: фрисби
холка: холке
глухой: глухие
характерный: характерно
относить: относят
двор: дворе двором
неиссякаемый: неиссякаемый
журнал: журнал
тяжлый: тяжлые
тщательный: тщательном
сильный: сильнее сильным
высота: высота
загривок: загривок
заметить: заметив
что-то: чем-то
укорачивать: укорачивайте
отстоять: отстоять отстоянная
гаррисон: гаррисона
ужас: ужас
последствие: последствиями
нуждаться: нуждаются нуждается
постав: постав
уголок: уголков уголках уголка
определить: определить определило определив
спинка: спинкой
уживаться: уживаются
покров: покров покрова
пожертвовать: пожертвовать
болезнь: болезни
воспаление: воспалению
кормление: кормлением кормления
вызвать: вызвать вызвав
косо: косо
сэкономить: сэкономить
приютить: приютила
клинообразный: клинообразную
чрезмерно: чрезмерно
приключение: приключение
кипяток: кипятком
эпаньол: эпаньолу
водоотталкивающий: водоотталкивающим
образ: образом
доля: доля
овальный: овальной овальные овальное
придт: придт
чрно-крапчатый: чрно-крапчатый
обеспечивать: обеспечивают
бордер-колли: бордер-колли
внимательно: внимательно
поднимать: поднимает
матка: матки
отделение: отделения
подсушивать: подсушивающим
слепой: слепые
селекция: селекции селекция
шоколад: шоколад
увеличивать: увеличивая
стачивать: стачивают
обнаружение: обнаружения
саблевидный: саблевидной
плохо: плохо
движение: движения движении
потенциальный: потенциального потенциальных
терпение: терпение терпением
заметно: заметно
упрямство: упрямства
разнообразный: разнообразен
пищевой: пищевой
диморфизм: диморфизм
дело: дело
труд: труда
жирный: жирное
консервант: консервантов
перейти: перейти
скрещивание: скрещивания
лобный: лобную
зайчик: зайчиком
ткань: ткани
из-за: из-за
главное: главное
регулярно: регулярно
посадка: посадку
поведение: поведение
кан-корсо: кане-корсо
овощ: овощами
частица: частиц
рынок: рынке
начинать: начинает
чистить: чистят
менее: менее
промывание: промывание
охота: охота охоты охотой охоту
переслать: перешли
определять: определяет
уровень: уровне
жадность: жадности
испанец: испанцам
будущее: будущим
ветеринарный: ветеринарный
барьер: барьером
порция: порцию порции
лгкай: лгкая
приспособление: приспособление
оставаться: оставался
улучшить: улучшить
ревность: ревности
требование: требования
разбавить: разбавить
подлинный: подлинные
вместо: вместо
внешний: внешний
препятствие: препятствиями
суета: суете
слишком: слишком
хвалить: хвалить
аусся: аусси
комок: комок
зимой: зимой
лгким: лгким
придата: придат
стандарт: стандарта стандарту стандарт
шоу-категория: шоу-категории
победитель: победителя
кой: коем
ричард: ричард
посредством: посредством
сзади: сзади
выдать: выдать
рука: рук
интересный: интересную
неться: нестся
обрести: обрела
удлиннный: удлиннные
хвостатый: хвостатую
вещество: вещества вещество
ощущение: ощущения
оценка: оценке
восприимчивый: восприимчивы
рубль: рублей
появиться: появились
спереди: спереди
авантюра: авантюры
мочка: мочка
чей: чей
вдаваться: вдаваться
существовать: существовало
ловить: ловить
трх: трх
испачкаться: испачкалась
опустить: опущенным
слабо: слабо
внимание: внимание
варьироваться: варьируется варьировался
зубной: зубной
поясница: поясницу
неделя: недель неделю
зазор: зазора
отказываться: отказываются
выбирать: выбирая
количество: количестве
повышать: повышать
заварить: заваренный
удлинить: удлинена удлинены
скрывать: скрывает
иметь: имеет имеют
обратиться: обратиться
стоимость: стоимость
осмотреть: осмотрите
последний: последнее последней
особенно: особенно
достойный: достойная
неважно: неважно
австралийский: австралийская
желательно: желательно
подавать: подавать
бишон: бишон
естественный: естественную
час: часов
суховатый: суховатые
отсутствовать: отсутствует
опухоль: опухоли
асфальт: асфальту
нравиться: нравится
достаточно: достаточно
мягко: мягко
обязательно: обязательно
предпочтта: предпочтт
костный: костной
задорный: задорный
приобретение: приобретением
фактор: факторов
ребёнок: ребенком детьми
слаборазвитый: слаборазвитый
краситель: красителей
пара: пару
свинина: свинину
редко: редко
угощать: угощать
когтереза: когтерез
заложить: заложена
матрас: матрас
неоспоримый: неоспорим
переходить: переходят переходит
испортить: испорченные
отправляться: отправляясь
европа: европы
поводок: поводке
англия: англии
содержаться: содержатся
несмотря: несмотря
сладость: сладости
купить: купить
часто: часто
подпал: подпалом
прямолинейный: прямолинейной
очередной: очередную
развитие: развитии
страна: странах страна
ирландский: ирландскую
уникальный: уникальным
грудной: грудной грудная
лгкий: лгкие
свежий: свежем
что: чему
приблизиться: приблизиться
расширяться: расширяется
горделивый: горделивую
случай: случаях случае
скула: скулам
кончик: кончики кончику
задача: задача
слушаться: слушаться
счастие: счастьем
корпус: корпусу корпус
орава: оравы
придавать: придают
пугливый: пугливое
начать: начал
независимый: независимые
сохранять: сохраняют сохраняет
ориентировать: ориентированы
округлость: округлость
крыться: кроется
здоровый: здоровый здоровой
наличие: наличие
торопиться: торопиться
обращать: обращайте
географический: географического
платить: платит
чистый: чистой
отменный: отменное
эпилепсия: эпилепсии
желаемый: желаемые
николай: николая
совпадать: совпадает
гордость: гордости
ребнкома: ребнком
далеко: далеко
характеризовать: характеризуют
неправильно: неправильно
гибкий: гибкая
обладатель: обладатели
одноклассник: одноклассники
реакция: реакцию реакции
шотландский: шотландскую
скорее: скорее
славиться: славится
вс: вс
подружейный: подружейной подружейных
нянька: няньку
волосок: волоски волосков
талант: талант
скорость: скорость
сходство: сходство
здоровье: здоровья здоровье
одеть: одеть
грудь: грудь
случайный: случайные
передний: передние
крутиться: крутиться
малый: малейшее меньшим
навык: навыки
коллега: коллеги
мясо: мясо
приближаться: приближался
бархатистый: бархатистые
сплошной: сплошной
среднее: среднем среднего
трубчатый: трубчатые
чувство: чувство
частый: чаще
поиск: поиск
делать: делают
накопиться: накопившуюся
бочкообразный: бочкообразную
идеальный: идеальный
питание: питании
сгладить: сглажена сгладить
характер: характер
некоторый: некоторые некоторым
колечко: колечки
выглядеть: выглядят
пропорциональный: пропорциональным
гончая: гончие
неукротимый: неукротимой
указать: указать
выстригаться: выстригаться
заставить: заставить
прислушиваться: прислушиваются
продолжить: продолжили
бунин: бунин
сторож: сторожа
стратегия: стратегии
дисплазия: дисплазии
лакомство: лакомством
колтун: колтуны
потребность: потребность
хронический: хронический
вовсе: вовсе
генофонд: генофонд
жизнь: жизни жизнь
современный: современных
остальной: остальном
комбинезон: комбинезон
овчарка: овчарка
забывать: забывайте
средство: средства средством
ждать: ждите ждать
сильно: сильно
рельеф: рельеф
едва: едва
любим: любим
мешать: мешает
благодаря: благодаря
телосложение: телосложением
вид: виде вид
оттого: оттого
впервые: впервые
видеть: видит
служить: служит
большой: большом
вправду: вправду
особа: особы
просторный: просторным
проживание: проживания
добродушие: добродушие
склоняться: склоняются
волнистый: волнистая волнистую
псарня: псарни
подвижный: подвижная
обучение: обучение
трхцветный: трхцветный
шоу: шоу
нужно: нужно
мимимишность: мимимишности
поймт: поймт
также: также
параметр: параметры
обзаведтесь: обзаведтесь
корень: корни
достаточный: достаточной
любопытный: любопытным
помочь: поможет
момент: моменты моментом
игривый: игривым
мощный: мощные
нижний: нижней
посильный: посильное
выноситься: выносятся
прошлое: прошлого
бегать: бегать
желание: желания
универсальный: универсальной
клык: клыки
дополнительный: дополнительную
заметный: заметны
телевизионный: телевизионных
декоративный: декоративными
трава: траве
устанавливать: устанавливать
заводить: заводят
умеренно: умеренно
пользоваться: пользовались
говорить: говоря
влажный: влажная
круглый: круглую
изначально: изначально
высоко: высоко
агрессия: агрессию
требовательный: требовательна
понаблюдать: понаблюдайте
зацеловать: зацелует зацеловать
осанка: осанку
великолепно: великолепно
большинство: большинству большинство
ожирение: ожирению
сложно: сложно
складка: складки
крипторхизм: крипторхизм
отмереть: отмерших
область: области
стоить: стоит
очищать: очищайте
это: это
уборка: уборка
иерархия: иерархию
массивный: массивные
разный: разных
действовать: действуйте
существо: существа
ножницеобразный: ножницеобразный
зависеть: зависит
образоваться: образуются
трудность: трудностей
кормить: кормить
вспомогательный: вспомогательного
заканчиваться: заканчиваются
вполне: вполне
походка: походку
обработка: обработке
прийтись: пришлась
поглощать: поглощать
подобный: подобных
любить: любят
подобрать: подобран
способный: способен способны
имущество: имущества
верхний: верхняя
страх: страх
профиль: профиль
гаванский: гаванский
очс: очсы
беспрекословный: беспрекословного
эдвард: эдварда эдвард
слизистый: слизистая
положение: положения
ступить: ступили
склонный: склонна склонны
заниматься: занимается
привыкнуть: привыкли
уточнить: уточнить
лента: ленту
словно: словно
воспитать: воспитать
ошибочно: ошибочно
дефект: дефектом дефектами
лавр: лавры
растительный: растительных
прародитель: прародителей
далкий: далкие
внимательный: внимательного
оценивать: оценивайте
половина: половине
продолжительный: продолжительного
воздух: воздухе
насадка: насадки
проявить: проявит
новость: новостей
выходить: выходить
косолапость: косолапость
увлекательный: увлекательным
ввязаться: ввяжется
регулярный: регулярная
сопротивляться: сопротивляться
вакансия: вакансии
вечерний: вечернего
возбуждение: возбуждении
кислота: кислоту
селекционер: селекционеров
физический: физической
прикус: прикус
шиппёрка: шипперке
мир: мира
приписывать: приписывают
полусмерть: полусмерти
встречаться: встречается
постоянно: постоянно
выделить: выделить
удостовериться: удостоверьтесь
бросить: брошенный
голень: голени
общество: общество
выше: выше
молоко: молоко
обойтись: обойтись
пробежка: пробежке
расти: росла
вместе: вместе
энергичный: энергичном
борный: борную
течение: течение
комплекс: комплекс
уравновесить: уравновешенной уравновешенная
научиться: научиться
тесто: тесто
браковать: бракованные
соответствовать: соответствующим
ещ: ещ
практически: практически
логично: логично
рейтинг: рейтинг
неосторожный: неосторожный
вернуть: вернуть
сбалансировать: сбалансировано
независимо: независимо
подписываться: подписывайтесь
неизвестный: неизвестны
тайком: тайком
круглосуточный: круглосуточный
запретить: запрещено
очень: очень
горбатый: горбатую
возрождение: возрождения
вина: виной
произойти: произошло
огородить: огороженном огороженным
второе: второе
конфликт: конфликта
местоположение: местоположение
ньюкасл-апон-тайне: ньюкасл-апон-тайне
зарычать: зарычит
специальный: специальной
круп: крупом
ориентироваться: ориентировалась
черта: черта
плавный: плавными
кличка: клички
правило: правила
довольно: довольно
частность: частности
выдаваться: выдаваясь
погром: погром
надбровный: надбровные
лай: лаем
жлтуй: жлтую
готовиться: готовьтесь
удаление: удаления
составить: составит
касаться: касается
одерживать: одерживать
одиночка: одиночки
окрасить: окрашена
взрослый: взрослых
проект: проекте
александр: александр
подшучивать: подшучивая
привлекать: привлекала
вотереть: вотер
набрасывать: набрасывал
салон: салон
кг: кг
насколько: насколько
необходимость: необходимости
умиляться: умиляться
энергичность: энергичность
сидеть: сидеть
темперамент: темперамента
сигнал: сигнала
омускуленный: омускуленные
линька: линька
затруднительный: затруднительным
фрукт: фруктами
ответ: ответ
туловище: туловище
муха: мухой
целый: целый
кролик: кролика
тмный: тмные
плечевой: плечевые
дискуссия: дискуссию
зазубрина: зазубрины
обходиться: обходятся
суша: суше
банный: банные
увлекаться: увлекаться
распространнный: распространнных
играть: играет
наедине: наедине
ирландия: ирландия
особенность: особенность
исторический: исторические
ненамного: ненамного
тренировать: тренированных
недостаток: недостаток
плюсна: плюсны
мозг: мозга
родитель: родителей
темп: темп
предусматривать: предусматривают
дерматит: дерматиту
бугор: бугор
постараться: постарайтесь
огорчить: огорчить
тазобедренный: тазобедренной
рысью: рысью
основный: основных
входить: входил
пыль: пыли
мускулистый: мускулистые
промыть: промойте
грызун: грызунами
гораздо: гораздо
трансформироваться: трансформируется
призниться: признатся
бег: бег
шаг: шаг
птичий: птичьем
