травма: травм травмы
овощ: овощи овощами
ребёнок: ребенок детей
персона: персоне
похожий: похожая похожие
тело: тела теле
кровь: крови
средний: средняя средней
пылесос: пылесосом
фу: фу
пять: пяти
защита: защиту защита
приучение: приучении
полотенце: полотенце
пища: пища пищи пищу
опасный: опаснейший
смутный: смутное
серебро: серебра
чёрный: черный черные черным черной
отметина: отметинами
сколько: сколько
десятка: десятку
быть: будете е
осмотр: осмотра
дно: дна дно
название: название названия
расчесать: расчесанные расчесать
нарядить: нарядить
весёлый: веселый веселым
собака: собаку собакой собак собака собаке собаки
тон: тонах тону тон
документ: документами документы документах
приглашение: приглашением
готовность: готовность
состоять: состоит
возникать: возникают
физический: физических физическое
симптом: симптомы симптомов
обсуждение: обсуждения
оставаться: оставаться остаются
жаркий: жаркую
ваш: вашему вашим ваши вашей ваш вашего
оно: оно
английский: английских
цена: цена цену цены
лечение: лечение
застать: застанете
сахар: сахара
выжть: выжла
любимый: любимых
любой: любая любого любые любой любом
смышлёный: смышленые
материал: материалов
удовольствие: удовольствием
приветствовать: приветствуют
бесконечный: бесконечное
чужак: чужаками
желание: желанию желание
вещь: вещи
варьироваться: варьируются
оставить: оставить
завезти: завезены
припасти: припасенным
владелец: владельцам владельцев владельцу
заболеть: заболевший
испытывать: испытывающей испытывая испытывают
миниатюрный: миниатюрные миниатюрном миниатюрная
собственный: собственных собственной собственное
дословно: дословно
качество: качествами качестве качества
любовь: любовь
сторона: стороны стороне
очень-то: очень-то
отравление: отравление
субпродукт: субпродукты
выбраться: выберитесь
русский: русский
россия: россия россии
обратный: обратная
разыграться: разыгрался
температура: температуры
калорийный: калорийных
отчётливо: отчетливо
великобритания: великобритании
начинать: начинают начинает
смочь: сможете
слабость: слабость
размер: размеров размеры
предложение: предложение
соответствовать: соответствует
коврик: коврик
йорк: йорки йорком йорка йорку йорков йорк
пагля: пагль
стричь: стричь стриженные
шерсть: шерсть шерсти шерстью
поверхность: поверхности
сделать: сделают сделано сделаны
обладать: обладающая обладают обладающих
низкий: низкий низким низкое
неприятный: неприятное
специально: специально
по-разному: по-разному
крупа: крупа
кинолог: кинологи
испортить: испортить
заболевать: заболевают
чемпионский: чемпионскими
челюсть: челюсти челюстями
заводчик: заводчиками заводчиком заводчику заводчика заводчики
зарегистрировать: зарегистрирован
должный: должны должен должно должна
несложно: несложно
воспитание: воспитания воспитание
случайно: случайно
тряпочный: тряпочные
клуб: клубе клуб
врождённый: врожденным
начать: начнет начали начал
хрупкий: хрупких хрупкие
тошнить: тошнить тошнило
месяц: месяц месяца месяцев
выносливый: выносливы выносливые
анальный: анального
гостинец: гостинцем
жареный: жареные
некоторый: некоторых некоторую некоторые некоторым
спустя: спустя
осознавать: осознают
королева: королеве
суетливый: суетливых
обои: обои
болонка: болонки
терьер: терьером терьер терьера терьеры терьеру терьеров
беспощадный: беспощадного
шум: шумам шума шум
важно: важно
держать: держите держать
превратиться: превратится превратиться
рис: рис
поджидать: поджидать
кинологический: кинологическом кинологической
закрытый: закрыты
многий: многим многими
история: история
щенок: щенка щенков щенки щенок щенку щенками
мускулистый: мускулист
прибыть: прибывшими
беззаветный: беззаветная
поощрять: поощрять
лепешинский: лепешинской
питомец: питомцев питомец питомца питомцем
каждый: каждого каждые каждая
чувствовать: чувствуют чувствовать чувствует
закутать: закутайте
оба: обоим обе обоих
семья: семьи семье
обожать: обожаем обожавшей
гречка: гречку
кроватка: кроватку
мини-йорк: мини-йорка мини-йорков
характеристика: характеристика
этот: этими эта этих
выставка: выставках выставок выставке
помощь: помощью
дом: дому домах дом дома доме
предать: преданным предан преданы
нос: носу
покараний: покаранием
заработок: заработков
около: около
зарождение: зарождения
купание: купания купании купание купанием
пол: пола
уверенно: уверенно
тёплый: теплым теплую
взрослый: взрослую взрослых
обнюхивать: обнюхивать
еда: еды едой еде
коготь: когти когтей
порода: породе породы пород породами порода
поздний: поздним
отнестись: отнеситесь
знание: знанием
синий: синий
палец: пальцы
считать: считает считают считая
нейродермить: нейродермит
незнакомец: незнакомца
выбрать: выберите выбрать
раз: раза
видео: видео
подойти: подойдет
обязать: обязаны обязана
отправиться: отправившись
характер: характере характером характера характер
природа: природе
перевозбудиться: перевозбудился
манный: манная
внимание: внимания вниманием внимании
очередь: очередь
вода: воды воду водой
никакой: никаких
герой: героем
смысл: смысл
улица: улицу
кеннел-клуб: кеннел-клуб
пёс: псы пес пса
смелость: смелость
холодный: холодную холодным
такой: таких такое такая такого
крошечный: крошечной крошечных
участвовать: участвовали
стремительный: стремительное
домашний: домашнюю домашний домашней домашним домашняя домашнему
отдыхать: отдыхает
рацион: рациона
охотник: охотника охотники
называть: называют
усилиться: усилилась
доходить: доходя
образ: образ
интернет: интернете
хороший: хорошим хорошие хорошему хорошей хорошее
раздумье: раздумий
содержание: содержание содержанием содержания
мелкий: мелких
свет: света
походка: походка
приучать: приучать
носить: носили
движение: движение движении
слово: слово слову
пропорционально: пропорционально
йоркширский: йоркширского йоркширских йоркширским йоркширские йоркширскому йоркширский
игра: играм игр
настоящий: настоящим настоящей
какой-то: какой-то
холка: холки холке
путь: путь
ветеринар: ветеринару ветеринар
комплекс: комплексе комплекс
масло: масло
милый: милые милых
новый: новая новой нового
лай: лае
скрещивание: скрещивании
он: нему
поколение: поколений
связь: связь
респектабельный: респектабельную
уделять: уделять
переносить: переносит
покрыть: покрыты покрыт
система: система
внешность: внешность внешности
клеймо: клейма клеймо
мягкий: мягкой
длинноволосый: длинноволосые
деликатность: деликатностью
преобразование: преобразований
предрасположенный: предрасположены
преимущество: преимуществом
бедро: бедра
сегодняшний: сегодняшнем сегодняшний
стать: стали стал станет
чувство: чувства чувство
вариант: варианте
развиваться: развивается
энергия: энергией
прямой: прямыми прямая прямой
наружу: наружу
поскользнуться: поскользнулся
ветеринарный: ветеринарные ветеринарный
фотография: фотографию фотографии фотографиям
возраст: возрасту возрасте
нижний: нижние нижней
расширять: расширяя
мир: мир мире
пассажир: пассажиров
рекомендоваться: рекомендуются
ниспадать: ниспадать
частенько: частенько
жизнерадостный: жизнерадостного
заменить: замените
скука: скукой
пресекать: пресекать
старший: старше
речь: речи
определённый: определенные определенное определенным
именитый: именитых
поле: поле
крупный: крупный
смотреть: см смотрите смотреть
крепко: крепко
племенной: племенную
пропорциональный: пропорциональное
одинокий: одиноких
тревожность: тревожностью
молчать: молчу
помогать: помогает
прописывать: прописывает
агрессивный: агрессивная
канал: канал
уход: уходе ухода уход
социализировать: социализировать
столько: столько
вылизывать: вылизывать вылизывает
страдать: страдают
высокий: высокая
балерина: балерине
питомник: питомники питомниках питомнике питомник
наш: нашем
верхний: верхней верхние
поесть: поесть
чувствоваться: чувствуется
глаз: глаза глаз
вплотную: вплотную
ненавязчивый: ненавязчиво
каприз: капризов
возражать: возражать
жирный: жирные жирный
выражать: выражает выражайте выражающие
прийтись: придется
создавать: создают создает
укоротить: укоротите укоротить
незнакомый: незнакомым незнакомые
корм: корм корма
прислушиваться: прислушивается
имя: именем
тщательный: тщательный
самостоятельный: самостоятельной
показной: показную
любопытство: любопытством любопытство
ингредиент: ингредиентами
болезненный: болезненны
век: века
год: года годам лет гг годов году
предмет: предмет
ольга: ольге
постоянный: постоянными постоянный
тапочки: тапочки
выпирание: выпирания
покупать: покупать
краткий: краткая
синевато-стальной: синевато-стальной
весьма: весьма
язык: язык
замок: замок
отношение: отношение
всякий: всякого
заболевание: заболеваниям заболевание
малыш: малышей
весь: весь всей всему всем всеми
эксперт: экспертов
освоиться: освоится
купать: купать купают
значиться: значиться
умный: умный умная
подушка: подушке подушек
приятель: приятели
тонкий: тончайшая
факт: факт
неспешить: неспеша
высота: высоте высота
вконтакте: вконтакте
внимательный: внимательными
совершать: совершать
человек: людьми людей человек
рядом: рядом
ответственный: ответственного
претензия: претензии
короткошёрстый: короткошерстых
стиральный: стиральной
ярко: ярко
срок: срок
интеллигентность: интеллигентностью
обрезать: обрезать
сдоба: сдоба
один: одного одно одна
автомобиль: автомобиля автомобилей автомобиле
реакция: реакцией
общий: общий
увеличить: увеличить увеличьте
сыр: сыром сыр
какой: каком каким какие каких
длина: длины длину
спокойный: спокойным
экземпляр: экземпляров
распространить: распространенный
изделие: изделия
основать: основана
хотя: хотя
прикрывать: прикрывают
продукт: продуктов продукты
х: х
уютный: уютную
привычный: привычную
храбрый: храброе храброго
редкий: редкой реже редком
видный: видны
сам: сами само самом самими
отварить: отваренном
выгуливать: выгуливать выгуливайте
красавица: красавица
баловать: балуя
который: которую которое которыми которой которая которых которым которые которому который
звук: звукам
проблема: проблемы
причесать: причесать
познакомиться: познакомиться
иммунный: иммунная
собственно: собственно
хорошенько: хорошенько
проникать: проникать
символический: символических
искупать: искупать
поощрительный: поощрительные
говядина: говядину
выносить: выносить
миллион: миллионами
вид: видов видом виде
заметный: заметен
влажный: влажным влажной
информация: информация
расчёсывание: расчесывание
друг: друг друга
проходить: проходят
наименование: наименованием
непредусмотрительный: непредусмотрительно
прогулка: прогулку прогулки прогулок
сначала: сначала
родословный: родословную родословная
участник: участником
удерживаться: удерживались
ежедневный: ежедневный
гипогликемия: гипогликемия
сообразительность: сообразительность сообразительностью сообразительности
рабочий-шотландец: рабочими-шотландцами
среди: среди
обращаться: обращайтесь
модель: моделей
лапа: лапах лапы
комната: комнату комнате
махинация: махинаций
шелковистый: шелковистой шелковистая
присоединиться: присоединиться
считаться: считается считаются
мыть: мыть
собаковод: собаководов собаководе
минь: мини
карандаш: карандаш
находиться: находится
просто: просто
подбежать: подбежавшую
мало: мало
телепередача: телепередач
вырасти: вырастет
повод: поводов
палочка: палочкой
красноногий: красноногий
знакомить: знакомить
ожирение: ожирением ожирении
принять: принято приняты
доверять: доверяете
груминг-мастер: груминг-мастеру груминг-мастера
стабилизировать: стабилизируйте
режим: режима
гулять: гуляя гулять
фрукт: фрукты
отдохнуть: отдохнуть
обходиться: обходится
камень: камень камни
угостить: угостить угостите
декоративный: декоративная
пёсик: песик песиков
безукоризненно: безукоризненно
добавить: добавьте
изменить: изменили измените
светло-золотистый: светло-золотистый
отвлекать: отвлекая
предрасположенность: предрасположенность
собачий: собачьим собачьем
происхождение: происхождения
резец: резцы
готовый: готовы готовым готовый готовые
первый: первые первый первую первых
приехать: приехав
свой: своем своим свой свое своего своей своих своему свои
дрожь: дрожь
задний: задние задних задней
возврат: возвратом возврата
черта: черты
подобный: подобное
силиконовый: силиконовые
впасть: впасть
ситуация: ситуация
тщательно: тщательно
недорого: недорого
дрессировка: дрессировка дрессировке
стандартный: стандартный стандартных стандартные
голос: голосом
пейсль-терьер: пейсли-терьера
время: время времени
исследовать: исследует
подряд: подряд
сука: суки
курятина: курятину
агрессивность: агрессивность
суровый: суровый
требовать: требует
защищать: защищать
машина: машины машиной
привыкнуть: привыкла
день: дней дня день
полчаса: получаса полчаса
волос: волосы волосами
погода: погоду
популярный: популярные популярнейших популярным популярных
генетический: генетический генетических
животное: животным животными
местность: местности
специализированный: специализированных
противный: противном
кость: костей кости костью
другой: другие другими другая
хозяин: хозяином хозяевами хозяевам хозяев хозяина
просмотр: просмотров
традиционно: традиционно
недокармливать: недокармливают
использовать: используйте использовать
беспокоиться: беспокоятся
предпочитать: предпочитает
настроение: настроением
приближение: приближении
мера: мере
комфортно: комфортно
например: например
несколько: несколько
сетчатка: сетчатки
грозить: грозит грозящий
грызть: грызть грызет
уверенный: уверенной уверенным уверен
рост: рост
ответ: ответа ответов ответ
расцеловать: расцеловать
синевато-золотистый: синевато-золотистой
облаять: облаять
прививка: прививки прививок
гриб: грибы
жить: жить живут живущие
позапрошлый: позапрошлого
резко: резко
к: ко
застенчивость: застенчивости
реклама: реклама
соответственно: соответственно
понять: поймет
свойственно: свойственно
волосяной: волосяной
нужный: нужным нужен
почему-то: почему-то
качественный: качественные
немедленно: немедленно
показать: показали
непосредственно: непосредственно
спокойно: спокойно
уголок: уголки
проявляться: проявляются
континент: континент
внутрь: внутрь
посуда: посуду
скомбинировать: скомбинированы
здоровый: здорового
работать: работающей
ласковый: ласков
блестящий: блестящая блестящие
шесть: шести
откликнуться: откликнувшись
натереть: натерев
бережно: бережно
порекомендовать: порекомендует
сайт: сайту
процедура: процедур процедуры
болезнь: болезням болезни
родословная: родословной
появление: появлении
энтузиазм: энтузиазмом
активный: активный
обустроить: обустройте
фактура: фактуре
лишь: лишь
относиться: относиться относящихся
дама: дамы
шелковистость: шелковистость
стрижка: стрижка стрижки стрижке
долго: долго
беззаветно: беззаветно
репутация: репутацией репутации
выводить: выводить
изящный: изящную
уникальный: уникальными
форум: форум форуме
кормить: кормите кормить
паспорт: паспорт
раковый: раковым
обсохнуть: обсохнет
начало: начала начало начале
расцвет: расцвета
покапризничать: покапризничать
обнаруживать: обнаруживают
продолжать: продолжайте
умилительный: умилительно
осложнять: осложняет
внешне: внешне
место: месте места
делаться: делаются
лично: лично
эпоха: эпоху
рейтинг: рейтинге рейтинг
этап: этапе
истерический: истерическом
крестьянин: крестьян
разработать: разработать
напротив: напротив
очаровательный: очарователен очаровательная
описание: описание
объявление: объявлений объявления
превосходный: превосходная
геном: геном
загородный: загородных
оттенок: оттенки
шотландия: шотландии
гигиена: гигиены
раствор: раствора
приступать: приступать
середина: середине
мочевой: мочевой мочевом
сырой: сырые
найти: найти
отметка: отметками
стоячий: стоячие
длинный: длинный
посмотреть: посмотрите
однако: однако
давать: давая
преданность: преданность
отличаться: отличаются
отсутствие: отсутствием
поэтому: поэтому
коричневый: коричневый
окружающий: окружающими
остаться: остаться останется
копирование: копирование
дружелюбный: дружелюбная дружелюбный
привыкать: привыкать
добрый: добрый
активность: активность
вооружиться: вооружившись
существовать: существует
насыщенный: насыщенный
основание: основания
мытищи: мытищах
дружелюбность: дружелюбность
отзыв: отзывах отзывы
порядок: порядку порядке
поездка: поездки
осанистый: осанистая
чистокровный: чистокровного
кошка: кошки
следовать: следует
дать: дайте
предположительно: предположительно
пластиковый: пластиковые
ванная: ванной ванную
пожилой: пожилых
поделиться: поделиться
золотисто-красный: золотисто-красный
внушительный: внушительных
уровень: уровня
пах: паха
ослабить: ослаблена
книга: книгу
промывание: промывании
называться: называлась называется
широкий: широкой
назад: назад
зона: зону
цвет: цвет цвета
отменять: отменяйте
еженедельный: еженедельном
интерес: интерес
мочь: могут можете
вывозить: вывозить
н: н
наталья: наталья
преодолеть: преодолеть
творог: творог
ухо: ушей уха уши
продавать: продают
ножницы: ножницами ножницы
профессиональный: профессионального
делать: делайте делать делает
основной: основные
нескрываемый: нескрываемым
интеллект: интеллект
охранный: охранные
многие: многие
проявление: проявления
величина: величины
средне: средне
вес: вес
уважение: уважение
неподдельный: неподдельная
помочь: помогут помочь
конец: конец
действие: действиях
недовольство: недовольство
линять: линяют
ежедневно: ежедневно
приучить: приучить
сон: сна
профессионализм: профессионализме
возить: возить
положить: положено положите
причина: причине
именно: именно
вопрос: вопросы
заметить: заметите
приобрести: приобретенным приобрести
неподходящий: неподходящие
перебежка: перебежках
продолжительность: продолжительность
собачка: собачках собачек собачка
независимый: независимого
мощный: мощными
вытянутый: вытянута
член: членов
отрастать: отрастающие
борный: борной
ранка: ранку
поранить: пораните
расположить: расположены
входить: входит входя
проживать: проживающими
отравиться: отравилась
десна: десны деснам
викторианский: викторианскую
золотисто-палевый: золотисто-палевый
отдых: отдыха
услуга: услугами
пройти: прошел
утром: утром
ожидать: ожидать
слегка: слегка
тот: те та тому
окружать: окружает
здравствуйте: здравствуйте
наряжать: наряжая
увеличивать: увеличивает увеличивать
фото: фото
сесть: сесть
достоверно: достоверно
подстилка: подстилкой
ощущаться: ощущаться ощущается
крепыш: крепыш
кончик: кончика кончики
приёмник: приемник
печенька: печеньки
вы: вами
яндекс: яндекс
шкодить: шкодит
количество: количество
декабрь: декабря
состав: состав
цитрусовый: цитрусовые
грызун: грызунов грызунами
дело: делом дело дела
гармонично: гармонично
выглядеть: выглядеть выглядели выглядит
строение: строение
хотеть: хотите
обозначать: обозначающих
череп: черепа
манеж: манеж
проводить: проводят
выраженный: выраженной
получить: получила
кровоостанавливающий: кровоостанавливающий
акс: акс
здоровье: здоровью здоровье
стараться: стараются стараться старайтесь
цифра: цифр
журнал: журнал
отличный: отличный отличным
неделя: недели неделю
подверженный: подвержен
демонстрироваться: демонстрироваться
нуждаться: нуждаются нуждаясь
серьёзность: серьезностью
панический: панический
покров: покров
фраза: фразу
нервничать: нервничать
соплеменник: соплеменником
горделивый: горделивая
совершенно: совершенно
вывести: выведена
контролировать: контролировать
особый: особым
малый: меньший
либо: либо
осанка: осанка
синеватый: синеватые
кипяток: кипятком
минута: минут
минимально: минимально
составить: составьте
резвость: резвость
простой: простых
фурор: фурор
неприемлемый: неприемлемо
укрывать: укрывает
светлеть: светлеет
классический: классическом
включать: включайте включать
очередной: очередного
титул: титулами
исследование: исследования
полтора: полутора
туалет: туалету туалета
тротуар: тротуара
шоколад: шоколад
оперативно: оперативно
присущий: присуща
суета: суеты
удалять: удалял удалять
остриё: острие
кто: кому
принести: принесете
плохо: плохо
энергичный: энергичен энергичны энергичных
условие: условиях
коготок: коготки
умиление: умиление
взросление: взросления
робость: робости
родить: рожден
выпадать: выпадать
темп: темпе
противопоказанный: противопоказаны
немой: нем
являться: являются является
перейти: перейти
сутки: сутки
продажа: продаже
из-за: из-за
проверить: проверьте проверенной
немалый: немалое
поведение: поведение
номер: номер номером
сочно-розовый: сочно-розовыми
груминг-салон: груминг-салонах груминг-салон
стандарт: стандарты
менее: менее
забава: забавам
шёрстка: шерсткой
поцелуй: поцелуями
оживлённый: оживленном
импровизированный: импровизированную
пользоваться: пользовавшиеся
команда: командам команда
артурович: артуровна
отказываться: отказывается
приобретать: приобретать
вести: ведут
слишком: слишком
невероятно: невероятно
одиночество: одиночеству
грациозный: грациозном
мой: моему
происходить: происходить происходит
стройный: стройными
вздутие: вздутий
нитрат: нитрат
связать: связано
мордочка: мордочка
виктория: виктории
сзади: сзади
ровно: ровно
морда: морда
подросток: подростков
крепкий: крепкая крепкими
роскошный: роскошную
беременный: беременна
рак: раком раку
капуста: капуста
распределить: распределите
снова: снова
оценка: оценке
гарантированно: гарантированно
появиться: появился
пора: пора порах
нагрузка: нагрузок
проявлять: проявляющий
рубль: рублей
качественно: качественно
попадать: попадают
исключить: исключить
беспокойство: беспокойства
смело: смело
чей: чей
вечером: вечером
мама: маму
удостовериться: удостовериться
правило: правило правила
игрушка: игрушки игрушка игрушку
красавец: красавец
горизонтальный: горизонтальная
зубной: зубной
слава: слава
образный: образные
предполагать: предполагают
десяток: десятков
неизвестно: неизвестно
подрасти: подрастет
пашкевич: пашкевич
весить: весит
три: трем трех
часть: часть
иметь: имеет иметь
обратиться: обратиться
наготове: наготове
встать: встать
мелатонина: мелатонин
стоимость: стоимость
последний: последнее
комнатно-декоративный: комнатно-декоративных
иначе: иначе
особенно: особенно
охотничий: охотничий
желательно: желательно
анастасия: анастасия
магазин: магазинах
ласка: ласкам ласки
нервозность: нервозностью
необходимый: необходимыми необходимые необходим
достаточно: достаточно
поддаваться: поддается поддаются
груминг: груминга
обязательно: обязательно
загривок: загривка
кроха: кроха
прилегать: прилегают
сложность: сложности
редко: редко
съёмный: съемном
производить: производят
специальный: специальные специальным специальной специальном
стресс: стрессом
мейнстрим: мейнстриме
длинношёрстый: длинношерстые длинношерстый длинношерстых
выдать: выданные
обстановка: обстановку
копание: копанием
несмотря: несмотря
купить: купить
часто: часто
доброжелательный: доброжелательной доброжелательны
переборчивый: переборчив
образоваться: образовались
елизавета: елизавета
наказание: наказание
спина: спина
понадобиться: понадобятся
ответить: ответить
мальтийский: мальтийские
голова: голова
преступление: преступления
прекрасный: прекрасного
случай: случаях случае
месяц-два: месяц-два
рождение: рождения
аляскинский: аляскинский
выбирать: выбирать
столетие: столетии столетия
вызвать: вызвала вызвано
характерный: характерен
поручить: поручить
кругозор: кругозор
причёска: прически
чадо: чад
нрав: нравом
кисломолочный: кисломолочных
кислота: кислотой
сердце: сердце
барсук: барсуков
индивидуальный: индивидуальные
судорога: судороги
непрерывно: непрерывно
уверенность: уверенность
далеко: далеко
буква: букв
одноклассник: одноклассники
резиновый: резиновый
маленький: маленьких маленькая
клайдесдейл-терьер: клайдесдейл-терьера
великолепный: великолепной
аристократ: аристократов
скай-терьер: скай-терьера
основатель: основателей
проснуться: проснулся
заживить: заживить
возможность: возможности
интересоваться: интересуется
против: против
недостаток: недостатка
преподнести: преподнесен
неусидчивость: неусидчивость неусидчивости
грудь: грудь
случайный: случайные
передний: передние передних
кроме: кроме
федерация: федерацией
позволить: позволит
среднее: среднем среднего
сегодня: сегодня
частый: чаще
поиск: поиск поисках
понизить: пониженных
коротко: коротко
встреча: встрече
грызт: грызт
зуб: зубы зубов
гордость: гордость
густо: густо
питание: питании
вязать: вязали
прародитель: прародителями прародителем
крайний: крайней
таковой: таковым
потребоваться: потребуется
скованность: скованность
официальный: официальное
компаньон: компаньоном
представить: представлено
мастер: мастера
острый: острыми
шампунь: шампунем
калория: калорий
салфетка: салфеткой
вдоль: вдоль
короткий: короткая короткой
общение: общении
орех: орехи
зрение: зрения
дисплазия: дисплазии
сбоку: сбоку
независимость: независимость
сородич: сородича сородичи
лакомство: лакомством лакомств лакомства
анна: анна
самонадеянность: самонадеянность
потребность: потребность
лис: лис
геркулесовый: геркулесовая
предок: предков
жизнь: жизни
приглашать: приглашают
уменьшить: уменьшив
абсолютно: абсолютно
круг: кругов
маламут: маламут
моцион: моциона
поместить: поместить
самый: самых самые
аппетит: аппетита
говорить: говорить
благодаря: благодаря
разведение: разведению
небольшой: небольшой небольшими
всё-таки: все-таки
двигаться: двигаться
клиника: клиники
затем: затем
уотерсайдский: уотерсайдские
рука: рукой
североамериканский: северо-американский
находить: находят
воспитывать: воспитывать
часы: часы
намёк: намека
англия: англию англия
видимый: видимой
успех: успехи
желудок: желудка
нужно: нужно
мимимишность: мимимишности
животик: животик
собачка-компаньон: собачку-компаньона
настойчивость: настойчивость
вызывать: вызывают
также: также
процесс: процесс
чистка: чистке чистки
ошпарить: ошпаренные
цель: цели
момент: моменты момент
кот: кот
уберечь: уберечь
разделить: разделена
порция: порциями
прогуливаться: прогуливаться
квартира: квартирах
придумывать: придумывают
черно-коричневый: черно-коричневого черно-коричневые
корпус: корпус
клык: клыки
изысканный: изысканных
нежный: нежные
детство: детства
прыжок: прыжок
обучить: обучить
плюшевый: плюшевые
кариес: кариес
элегантный: элегантен
понаблюдать: понаблюдайте
мёд: медом
трафик: трафиком
образовываться: образовывается
тёмный: темный
пропасть: пропасть
похвала: похвалы
сложно: сложно
американский: американском
область: области
стоить: стоит
очищать: очищайте
это: это
разный: разных
челак: челак
набрасываться: набрасывайтесь
любить: любит любят
прибылой: прибылые
ножницеобразный: ножницеобразный
вязка: вязка
выбор: выбору
одёжка: одежку
российский: российской
обучать: обучать
предназначить: предназначенные
вполне: вполне
требовательный: требователен
бескорыстный: бескорыстным
снижение: снижение
ряженка: ряженка
страх: страх
аккуратно: аккуратно
сидение: сиденье
осуществить: осуществить
подарок: подарок
признак: признаков
каша: каши
рассмотреть: рассмотрите
изменение: изменения
легко: легко
ватный: ватной
копчёный: копченые
превратить: превратить
живой: живую
графство: графству
заниматься: занимается
выносливость: выносливость
лента: ленту
громко: громко
решительный: решительным
мороз: морозы
достигнуть: достигла
регулярный: регулярной
помещение: помещение
британия: британии
сменить: смените
уверить: уверены
сода: содой
график: график
безопасность: безопасности
морковь: морковью
воздух: воздухе
колено: колена
покупка: покупке
проявить: проявит
расшататься: расшатаются
расчёсывать: расчесывать
выделить: выделите
локтевой: локтевых
якобы: якобы
подтверждаться: подтверждается
вакансия: вакансии
прямо: прямо
шея: шеи
телевизор: телевизор
сюжет: сюжеты
поводок: поводок поводка
разговор: разговор
шумный: шумном
прикус: прикус
разряд: разряду
состояние: состояние
объятие: объятиями
встречаться: встречается
постоянно: постоянно
генетически: генетически
разместить: разместите
сочетаться: сочетаются
выше: выше
ранний: раннем
диета: диету
выражаться: выражается
отверстие: отверстия
съесть: съесть
окрасить: окрашены окрашена
обойтись: обойтись
внести: внес
удобно: удобно
регион: регионах
случаться: случается
сливочный: сливочное
чересчур: чересчур
научиться: научиться
уравновесить: уравновешенной
жара: жару
избранник: избранника
колбаса: колбаса
изгиб: изгиб
выгул: выгулов
воля: воле
работа: работ
большинство: большинство
главный: главная
практически: практически
зубок: зубки
пропорция: пропорции
отнести: отнесите
купирование: купирование
ряд: ряд
модельный: модельные
упрямый: упрямого
подписываться: подписывайтесь
купироваться: купируется
завести: заведите
равномерно: равномерно
непродолжительный: непродолжительной
свод: сводом
аристократический: аристократических
самостоятельно: самостоятельно
товарищ: товарищ
шотландский: шотландских
хвост: хвоста хвост
вытеснять: вытесняйте
запретить: запрещено
очень: очень
обычно: обычно
достойный: достойное
особенность: особенности
сложный: сложен
бок: бокам
сонливость: сонливость
умение: умение
пузырь: пузыре
мытьё: мытье
постепенно: постепенно
страшно: страшно
шаг: шагом шаг
кличка: клички
довольно: довольно
прежде: прежде
измениться: изменившиеся
представление: представление
соотнести: соотнес
удивительный: удивительной
ощущение: ощущение
выставочный: выставочных
конечный: конечном
одновременно: одновременно
проект: проекте
сразу: сразу
число: числе
биться: бьется
образовывать: образовывая
своеобразный: своеобразный
беззубый: беззубым
фигурный: фигурная
перестать: перестало
спаниель: спаниель
почётный: почетном
кг: кг
энергичность: энергичность
кефир: кефир
нездоровый: нездоровых
минимальный: минимальная
риск: риск
линька: линька
идти: идти
вакцинировать: вакцинировать
туловище: туловище
страна: страна
облик: облике
комнатный: комнатной
йоркшир: йоркшир
внутренний: внутренней
свобода: свобода
узнать: узнаете
необыкновенный: необыкновенной
пупок: пупка
беспокоить: беспокоит
формирование: формирования
венгерский: венгерская
папа: папы
давно: давно
родитель: родителей
подробно: подробно
конечность: конечности
повсюду: повсюду
плоский: плоским
вследствие: вследствие
фотосессия: фотосессии
постараться: постарайтесь
коричнево-золотистый: коричнево-золотистыми
выдавать: выдающие
перегреваться: перегреваются
завлечь: завлечь
гораздо: гораздо
яйцо: яйцом
нету: нету
г: г
отважный: отважные
недуг: недуг
приём: приема
подражать: подражая
недобросовестный: недобросовестные
брокколи: брокколи
малогабаритный: малогабаритных
