велюровый: велюровой
позволить: позволила позволит
крутой: крутого круче
заметить: заметили
овощ: овощи
раскрытый: раскрытыми
ребёнок: ребенок детей ребенком детьми
ситуация: ситуациях ситуацию ситуации
похожий: похожая
упитанный: упитанным
баловать: балуйте
тело: тела телу телом
американский: американских американский американским американского
широко: широко
хозяйство: хозяйств
средний: средняя среднее средней
удивительно: удивительно
защита: защиту
параллельный: параллельные
дрессироваться: дрессируются
ясный: ясные
наверняка: наверняка
пищеварение: пищеварения
активный: активные активна активная активен активны
следить: следить следите
сколько: сколько
быть: будете будьте
приветствовать: приветствовать
название: название названия названии
кинологический: кинологический кинологическим
становитя: становитя
тон: тонах тона
собака: собаку собаками собакой собак собака собаке собаки
интенсивность: интенсивности
вывести: вывести выведенные
физический: физических физические физическому физическая
обсуждение: обсуждения
отношение: отношениях отношение
другой: другое другие других другими
дима: дима
цена: цена цены
удаваться: удается
жалкий: жалок
рельефный: рельефные рельефная
мальчик: мальчик
дегельминтизация: дегельминтизация
мастиф: мастифы
материал: материалов материала
природа: природы природе
удовольствие: удовольствием
трусость: трусости
напрямую: напрямую
мотивировка: мотивировке
туманный: туманного
манипуляция: манипуляцию
купировать: купированных купированный
массаж: массажа
воспитать: воспитали
любовь: любовь
стоять: стоят
качество: качествами качеств качества
сторона: стороны
внимательный: внимательной повнимательнее внимательным внимательного
волков: волков
остановить: остановить
дикий: дикими
россия: россия россию
раковина: раковины
карьера: карьеру карьеры
обратный: обратная
справиться: справиться
радужка: радужки
мероприятие: мероприятия
совершенствование: совершенствование
преобладать: преобладать
шея: шея
подходить: подходивший подходят
наблюдаться: наблюдаются наблюдаться наблюдается
отмечать: отмечают
развитой: развитым развитом развитой
бультерьер: бультерьер бультерьеры
шерсть: шерсть шерсти шерстью
взвешивать: взвешивала
некупированный: некупированными некупированных
частичный: частичный
влажный: влажные
выразить: выражены выражена
запрет: запрета
кальций: кальция
подготовиться: подготовиться
соответствовать: соответствуют соответствовать
третий: третий
воплотить: воплотившая
челюсть: челюсти
игра: игре игры игра
пятнистый: пятнистый
должный: должны должен должно должна
несложно: несложно
свет: свете
содержать: содержать содержащие
потерять: потеряла
возникнуть: возникнет
становиться: становиться
стаффордширский: стаффордширский стаффордширских стаффордширским стаффордширского
месяц: месяц месяца
выносливый: выносливы
терпеливо: терпеливо
столь: столь
сцена: сцены
отличаться: отличается отличающаяся
выраженный: выражен выраженными выраженной
терьер: терьером терьер терьера терьеры терьерам терьеров
выбрать: выбрали выбрать
важно: важно
дурной: дурная
хороший: наилучшим лучшей хорошие наилучших лучший хороший лучшие лучшее хорошей лучших
норма: норм
завести: заведя завести
история: история
сообразительный: сообразительны
достаться: достанется
щенок: щенка щенков щенятами щенки щенок щенку щенкам щенята
парка: парке
проявляться: проявляется проявляются
нормально: нормально
нежный: нежной
покупать: покупая
уравновесить: уравновешенный уравновешенной
попросить: попросите
раздражитель: раздражители
настолько: настолько
круглый: круглой круглые
заняться: занялись заняться
питомец: питомцев питомца
форма: форма формы
юг: югом
особый: особое особых особого особую
положительный: положительной
расстраиваться: расстраивайтесь
семья: семьи семью
понижаться: понижается
приятный: приятные
прыгать: прыгают
характеристика: характеристика
поблизости: поблизости
провести: проведенным
помощь: помощью
собрать: собрав
выраженность: выраженности
выпуклый: выпуклому
зарождение: зарождения
следующий: следующие следующем
война: войны войне
уверенно: уверенно
класс: классу
злобный: злобный
общение: общению
лай: лаи лай
коготь: когти
развеселить: развеселить
приблизительный: приблизительный
крайность: крайностям
спина: спине спины спина
систематически: систематически
быстро: быстро
развлечение: развлечениям
сужаться: сужается
роль: ролью
чисто: чисто
вырасти: вырасти вырастет
видео: видео
помимо: помимо
канат: канатом
признать: признана
принести: принесет принести
характер: характере характера характер
организовать: организовать
разрешаться: разрешается
внимание: внимания внимание
меню: меню
полностью: полностью
дом: домов дома доме
незапамятный: незапамятных
условие: условии условий условиях
самочувствие: самочувствием
возможный: возможные возможны
месячный: месячного месячному
точный: точную
пёс: псы псов пес пса
лна: лна
смелость: смелость
способный: способный способен
вакцинация: вакцинация
знание: знаний
владелец: владельца владельцев владельцы владелец владельцем
ветеринарный: ветеринарная ветеринарный ветеринарной
такой: таких такое такая такую
рваться: рвущегося
нужный: нужна нужный
мирный: мирными мирного мирной
выбор: выбором выбор
ваш: вашу вашей ваш вашего вашем ваша
рацион: рациона рационе рацион
изменять: изменяя
дать: дав дать
речь: речь
интернет: интернете
варёный: вареном вареные
раздумье: раздумий
содержание: содержание содержания
стать: станут стали станет
чистый: чистыми чистым чистые
девочка: девочка
присутствовать: присутствовать
опытный: опытного опытный
работа: работе работой работы
немного: немного
разъярённый: разъяренных
движение: движение движений
мощный: мощный мощная мощного мощные
составлять: составляет составляют
взращивание: взращивания
рекомендовать: рекомендуют
прокрас: прокрас
какой-то: какой-то
жить: живет
обнаружить: обнаружить
ноздря: ноздрями
слабак: слабаков
окрас: окраса окрас окрасе
задача: задачей задач
знакомство: знакомств знакомству
видимый: видимые
специальный: специальная специальные специальных специальной
пережить: пережитый
противоположный: противоположными
занимать: занимают
прививка: прививках
он: нему
связь: связь
мной: мнои
уделять: уделять уделяли
приобретение: приобретения
переносить: переносит
точно: точно
надёжный: надежного надежный
уокер: уокера
клуб: клуб клубом
выполняться: выполняются
финальный: финальный
вода: воде
ознакомительный: ознакомительный
внешность: внешность
какой: какому какие какого каких
добавить: добавить добавьте
прижать: прижатые прижаты
срок: сроки
длина: длине длины длина
грыжа: грыжу
радужный: радужной
блоха: блох
реестр: реестре
пока: пока
инстинкт: инстинкте инстинктами
создаваться: создается
сводистый: сводистые
маленький: маленький маленькими
амстафф: амстаффам амстаффов амстаффом амстаффа
профессиональный: профессиональных
добродушный: добродушных
состояние: состоянии состоянием состоянию
взаимодействие: взаимодействия
официальный: официальный
яйцо: яйца
выставочный: выставочной выставочную
север: севера
год: годах года лет год году
стремиться: стремящимся
возраст: возрасту возраста возрастов возрасте
скелет: скелет
давать: давать дают
выполнение: выполнения
естественный: естественных
сосуществование: сосуществования
бить: бьет
основный: основного основным
наследственность: наследственности
заниматься: заниматься
право: права
пит-класс: пит-класса пит-класс
плотно: плотно
посторонний: постороннему
определённый: определенные
причина: причина
лежать: лежит
стаффорд: стаффорды стаффордов
стаффордшир: стаффордшире стаффордшира
смотреть: см смотрите смотрят
друг: друзья другом друга
фотография: фотографии
инструмент: инструмент
препарат: препаратов
надолго: надолго
уход: уходе уход
хотеть: хотим хочет хотите хотел
набрать: набрал
знать: знать знает знаете
модернизировать: модернизировать
глазок: глазкам глазки
чёрный: черная черного
результат: результатов результат
поражать: поражать
збурлюк: збурлюк
страдать: страдают
высокий: высокая высокой высокий
питомник: питомники питомнике питомник
монстр: монстра
глаз: глаза глаз
квадратный: квадратной
нетрудно: нетрудно
связанный: связанных связанное
самый: самый самым самых самые
бойцовый: бойцовые бойцовых
закрепиться: закрепились
атлетичный: атлетичная
порок: порокам пороки пороками
повышенный: повышенного повышенных
рассказ: рассказам
веселие: веселья
пускать: пускать
морда: морды морда
сухо: сухо
илья: илья
бобтейл: бобтейл
поздний: позже
век: века
америка: америку
внести: внесены
оцениваться: оценивается
рычание: рычание
реакция: реакция реакциям
проявлять: проявляют проявлять
описываться: описывался
краткий: краткая
пхунсан: пхунсан
чистота: чистотой
врождённый: врожденная
язык: язык
компаньон: компаньона
отчаянный: отчаянная
оговориться: оговориться оговоримся
малыш: малышей малыши малыша
ветвь: ветви
исключительно: исключительно
небезопасный: небезопасной
биться: биться
первый: первом первые первого первый
игривость: игривость
запомниться: запомнится
купать: купать
эксперт: экспертов
спрос: спрос
драка: драки
умный: умный умные
японский: японский
факт: факт
фермерский: фермерских
вконтакте: вконтакте
рядом: рядом
устраивать: устраивая
впечатление: впечатление
массировать: массирует
девочкихотеть: девочкихочу
переход: переход переходом
двухцветный: двухцветный
тазобедренный: тазобедренных
приветствуюмн: приветствуюмне
чихуахуа: чихуахуа
ярко: ярко
потребовать: потребует
хозяин: хозяин хозяином хозяина
максимальный: максимальное
суп: супы
признавать: признавали
кожа: коже кожу кожа кожи
поинтересоваться: поинтересуйтесь
развитие: развитие развитием
животное: животных животным животного животными животные животное
различие: различия
один: одного одна одной одни
уяснить: уяснить
одинаково: одинаково
выведение: выведении
амстаффа: амстафф амстаффы
сша: сша
общий: общий
появление: появления
хозяйский: хозяйскими
принадлежность: принадлежность
сыр: сыром
чреватый: чревато
эстонский: эстонская
шпиц: шпиц
салфетка: салфетки
паразит: паразитами
парламент: парламент
основать: основана
хотя: хотя
прикрывать: прикрывают
натура: натуры
охранник: охранника
х: х
жидкий: жидкий
погибать: погибали
незначительный: незначительные
который: которую которое которой которая которых которым которые который
шерьстта: шерьстт
осмотр: осмотре
собственно: собственно
средневековый: средневековые
предрасположенность: предрасположенности
достижение: достижения
питбультерьер: питбультерьер питбультерьеров питбультерьера
размер: размеры размера
официально: официально
мера: меру мере
два: двум
сказать: скажет
элемент: элемент
информация: информация информации
масса: масса массу
большой: большое большого
наименование: наименованием
скосить: скошенный
воспринимать: воспринимайте
пригодный: пригодны пригодная
атаковать: атакует
будущее: будущем будущее
проводить: проводить
пиковый: пиковых
универсальность: универсальность
ребро: ребра ребер
кровавый: кровавые
авторитет: авторитет
генетический: генетической
кошка: кошкой кошки
пегий: пегий
язвочка: язвочек
конец: концу конца конце конец
сообразительность: сообразительность
крепкий: крепкие крепкий крепкая
щёчный: щечные
трещинка: трещинки
применять: применяя
мичиган: мичиган
ощупь: ощупь
солидность: солидность
планировать: планируя планируете
линия: линию линия
это: этим это
веко: веки
гель: гели
вылечить: вылечить
витамин: витамины
новый: новых новом
брат: брата
длинный: длинные длинный
противник: противников
любить: любили любят
воспитанный: воспитанный
пол: полу
советыкак: советыкак
полный: полной
просто: просто
мало: мало
поменяться: поменялась
разработка: разработкой
ароматизатор: ароматизаторов
ожирение: ожирением
избрать: избрал
выработать: выработаете
режим: режима
обратить: обратить
наделить: наделенный
домашний: домашней домашними
отправление: отправлением
низкий: низкая
момент: моментов моменты момент
территория: территории
считать: считают считать
психика: психике
социализация: социализацию социализация
холка: холка холке
успеть: успеете
собачий: собачьим собачьи
умеренный: умеренная
происхождение: происхождения
резец: резцы
готовый: готовы готов
считаться: считаться
лёгкость: легкость
пища: пищи пище пищу
трансформироваться: трансформировались
читать: читает
свой: своем своим своего своей своих
неприхотливый: неприхотливая
соотношение: соотношение
задний: задние
черта: черты черт чертой
агрессивный: агрессивный агрессивных
пререкание: пререкания
цель: целями цели целей
гончий: гончая
дрессировка: дрессировку дрессировка дрессировке
стандартный: стандартный
время: время времен времени временем
сука: суки сук сука
строительный: строительного
создать: созданный
шаловливость: шаловливости
маклак: маклаков
агрессивность: агрессивность
защищать: защищать
требовать: требует
день: дней дня день дни
вес: веса вес
наказание: наказания
разделение: разделению
лоб: лбу
деятельность: деятельности
превращать: превращайте
сила: сила
просмотр: просмотров просмотра
умение: умений
терпение: терпения
настоящий: настоящего
отдать: отдали
фенотип: фенотип
характерный: характерна характерной
сетчатка: сетчатки
охрана: охраны
маникюр: маникюр
рост: рост
единый: едином
порадовать: порадовать
ответ: ответа ответов ответ
вверить: вверенной
потомство: потомство
дух: духом
лицезреть: лицезреть
мышечный: мышечную
заставить: заставило
функция: функции
оценка: оценку оценки оценке
понять: понял понять
реклама: реклама
соответственно: соответственно
осознать: осознать
получить: получите полученных получена полученной получить получили
плоский: плоский
заводчик: заводчиком заводчиков заводчика заводчики
найти: найдут
нюанс: нюанс нюансов
небольшой: небольшую
неплохой: неплохим
бой: бой боях бои боям
необходимый: необходима
дисквалифицировать: дисквалифицирующим
мускулатура: мускулатурой мускулатура
нормализовать: нормализовать
рекомендоваться: рекомендуется
болезнь: болезнь болезни
танец: танцев
мочка: мочки мочка
спокойно: спокойно
проблема: проблемами проблемах проблема проблем проблемой
воспитание: воспитание воспитанием
континент: континент
явно: явно
грубость: грубость
лагерь: лагеря
называть: называемая
связать: связана связаны
блестящий: блестящая
правильно: правильно
добавлять: добавлять
сайт: сайту
процедура: процедур процедура
завершаться: завершается
объяснять: объяснять
специалист: специалисту специалисты
позволять: позволяет
недоброжелатель: недоброжелателя
закрепление: закрепление
реагировать: реагирует
жестокий: жестокие
мода: моду
серёгин: серегина
этот: эта этому этих
сухость: сухость
лишь: лишь
вариант: вариант варианты
навредить: навредить
недавно: недавно
репутация: репутацией
неподкупность: неподкупность
форум: форум форуме
посягательство: посягательств
подобрать: подобранных
предпочтение: предпочтение
немкаживт: немкаживт
паспорт: паспорт
минимизировать: минимизировать
данный: данный
проверить: проверенного
кошкабыть: кошкабыло
внешне: внешне
любитель: любители любителей
шампунь: шампуни
бойцовский: бойцовскими
неумение: неумению
место: месте
соблюдение: соблюдение соблюдением соблюдении
атлетический: атлетической
этап: этапе
поставить: поставлен поставлены
вчера: вчера
злоба: злобы
шоу-класс: шоу-класса
описание: описание
начало: начало начале
многое: многое
продажа: продажа
вероятность: вероятности
аста: аст
владимир: владимир
градация: градация
приступать: приступать
лопатка: лопатки
тенденция: тенденция
здоровье: здоровьем здоровье
округлый: округлые округлый
разноплановый: разноплановыми
бежать: бегущий
вынести: вынесет
летесть: летесть
однако: однако
обработка: обработка
поэтому: поэтому
выставка: выставкам выставке
медицина: медицина
случай: случаев случаях случае
копирование: копирование
короткий: короткий короткие короткая короткой
однотонный: однотонный
прекрасно: прекрасно
активность: активность
дружелюбность: дружелюбность
попасть: попали
тратить: тратить
подвижный: подвижные подвижны
отзыв: отзывах отзывы
разрешать: разрешают
палево-голубой: палево-голубой
крупный: крупных крупного крупные
заключаться: заключается заключалась
следовать: следует
стул: стул
немалый: немалой
мимо: мимо
шум: шум
широкий: широкий широкая
испуг: испуг
прямой: прямая прямые прямой
густой: густая
допустимый: допустимо
раздаваться: раздавались
некоторый: некоторую некоторые некоторой
американец: американец
умелый: умелая
назад: назад
породистый: породистого
собака-компаньон: собак-компаньонов
цвет: цвет цвета
наталия: наталия
кость: кости
мочь: могут
локоть: локти
роза: роза
телесный: телесный
самотёк: самотек
клещ: клещей
плавный: плавным
оставаться: оставались оставалось
порода: породы пород породу порода
хватать: хватает
всячески: всячески
голос: голоса
видеть: видеть
ухо: ушей ушами уши
творог: творог
последствие: последствия
направить: направленным
объявление: объявления
ласковый: ласковых
шалость: шалости шалостям
хвостик: хвостиком
основной: основные
регистрировать: регистрировали
подстригать: подстригайте
приглянуться: приглянувшегося
интеллект: интеллект
охранный: охранные
заключать: заключать
средне: средне
постоянный: постоянного
степень: степени степенью
полотенце: полотенцем
питание: питания питание
гр: гр
предать: преданная преданного преданный
нос: носа нос
слово: слов
именно: именно
серьёзно: серьезно
доля: долей
будущий: будущие
отклонение: отклонения
проворный: проворны проворные
энергия: энергия
улица: улице
ответственность: ответственность
продолжительность: продолжительность
май: мае
перекос: перекос
член: членов члены
затылочный: затылочный
вряд: вряд
любопытный: любопытен
пиво: пиво
расположить: расположены
оттенок: оттенок
говорить: говорят говорить говоря
найтись: найдется
воин: воин
отрыгивать: отрыгивает
нужда: нужды
зависимость: зависимости
бубен: бубнами
запретить: запрещенные запрещено
вещество: веществ
подчёркивать: подчеркивая
слегка: слегка
здравствуйте: здравствуйте
чемпион: чемпионами
английский: английской английский английские
остров: островах
фото: фото
вступать: вступайте
направление: направлением
собака-легенда: собакой-легендой
применяться: применяется
сам: самого самом саму
яндекс: яндекс
количество: количество
болеть: болеть
высокопередость: высокопередость
участие: участие
выглядеть: выглядеть выглядят выглядит
оставлять: оставлять
череп: черепа череп
рад: рад
лапа: лапы
получение: получение
относить: относят
взгляд: взгляде
верный: верным
двор: дворе
обязательный: обязательных
журнал: журнал
высота: высота
объяснение: объяснения
отвиснуть: отвисшими
стаффома: стаффом
запомнить: запомнить
делать: делать
новорождённый: новорожденные
насилие: насилие
определить: определить
клеймение: клеймения
удар: ударов
контроль: контроля
кормление: кормлением кормления
целиком: целиком
свирепый: свирепых
совершенно: совершенно
контролировать: контролировать
чрезмерно: чрезмерно
либо: либо
чемпионский: чемпионским
активно: активно
птичий: птичьего
мой: мое
бульдог: бульдоги бульдогами
белый: белого белый
профилактический: профилактические
образ: образом
надобность: надобностей
охота: охоте
формирование: формирование
совесть: совести
прививочный: прививочного
увидеть: увидеть
внимательно: внимательно
привезти: привезли
целостность: целостность
громкий: громче
принять: принял принять приняли
дешёвый: дешевле дешевый
лёт: лету
мощь: мощь
ознакомить: ознакомить
прилегать: прилегает
набрасываться: набрасываются
поплнить: поплнить
кобель: кобели кобелей
плохо: плохо
перекус: перекус
вести: ведет
миниатюрный: миниатюрную
ключ: ключом
дисплазия: дисплазией дисплазии
помета: помете
посещать: посещая
труд: труда
защитник: защитника
возникать: возникала возникающая
перейти: перейти
скрещивание: скрещивания
какой-нибудь: каких-нибудь
теменной: теменные
сутки: сутки
разный: разные разных
из-за: из-за
главное: главное
костяк: костяком костяк
поведение: поведение
гулять: гуляет
селекционный: селекционной
оболочка: оболочки
воспитывать: воспитывая
установленный: установленные
прохожий: прохожих
уровень: уровне
характерачтый: характерачто
тот: тех тому
составить: составить
успешный: успешной
обыденный: обыденной
упрёк: упрека
подходящий: подходящего
остро: остро
простой: прост
клетка: клетка
внешний: внешний внешнем
обстановка: обстановке
англичанин: англичане англичанина
одиночество: одиночеству
уделить: уделите
никто: никто
последний: последний последнее последние последнего
развить: развита
альбион: альбиона
удержать: удержать
собранный: собранные
достигнуть: достичь
успех: успехом
стандарт: стандарта стандартам
кой: коем
мордочка: мордочка
сзади: сзади
атрофия: атрофия
прогулка: прогулках прогулок
компактный: компактны
отрицательный: отрицательных
глупость: глупости
пигментировать: пигментированные
второй: втором
схватка: схватки
объединить: объединенный
психический: психическую
мускулистый: мускулистая мускулистый
устойчивый: устойчивого устойчиво
рыже-голубой: рыже-голубой
копыто: копыт
важный: важных важны
нагрузка: нагрузок
зарегистрировать: зарегистрировала
экспертный: экспертной
гнойничковый: гнойничков
рубль: рублей
появиться: появились
спереди: спереди
исключить: исключить
тридцать: тридцати
разведение: разведения
опасность: опасность
слабо: слабо
испытывать: испытывает
слава: слава
пренебрегать: пренебрегать
подключаться: подключаются
любой: любые любых любом любому
идти: идет идти
визит: визит
весить: весит весить
обидчик: обидчика
глубокий: глубокая
иметь: имеет иметь имеют
встать: встать
мясокостный: мясокостная
стоимость: стоимость
измениться: изменившуюся
особенно: особенно
убирать: убирает
отметина: отметины
желательно: желательно
иноходь: иноходью
жёсткий: жесткая
собака-убийца: собаками-убийцами
предугадать: предугадать
строго: строго
несложный: несложен несложных
окончание: окончания
принцип: принцип
тяжёлый: тяжелее
достаточно: достаточно
принимать: принимали
мягко: мягко
обязательно: обязательно
договор: договор
передаваться: передаваться
привести: привел привело
сделать: сделали сделано сделает
объёмный: объемная
число: числа
мука: мука
именитость: именитостью
отметка: отметки
приспособить: приспособлен
кремовый: кремового
популярность: популярность
понимать: понимать
получиться: получилось
купить: купить купите
часто: часто
гражданский: гражданской
плотный: плотные
растить: растить
склонность: склонность
рассудительность: рассудительность
находиться: находятся
ушко: ушки
материнский: материнском материнского
заболевание: заболеваний
войти: вошли
седить: седит
желание: желание желания
интересный: интересен
ниша: нишу
расширяться: расширяется
голова: голова
прекрасный: прекрасного
скоблёный: скобленое
критика: критики
недостаток: недостатки недостатками
выбирать: выбирать
корпус: корпусу
задаток: задатками задатках задатки
сухой: сухих
услышать: услышать
питбуля: питбуля питбулей
оказаться: оказались
крыться: кроется
создание: созданием
тщетно: тщетно
эпитет: эпитетами
интуиция: интуиция
входить: входить
оппонент: оппонент
воспоминание: воспоминания
угол: углы
крупа: круп
справляться: справляется
мысль: мысли
правильный: правильным правильное
человек: человек человеком люди
эффект: эффект
весь: всем веси
усовершенствование: усовершенствованием
одноклассник: одноклассники
скорее: скорее
путём: путем
приобретать: приобретает
волосок: волоски
кабан: кабанами
однозначно: однозначно
сочетать: сочетали
случайный: случайные
сильный: сильной сильна сильный сильные сильным
передний: передние
чётко: четко
мясо: мясо
удивление: удивление
среднее: среднем среднего
трубчатый: трубчатые
природный: природными
сегодня: сегодня
напрочь: напрочь
живот: животе живота
разделять: разделяли
держаться: держится
частый: чаще
порода-предшественник: пород-предшественников
поиск: поиск
поразительный: поразительную
слышный: слышно
коротко: коротко
зуб: зубы зубов
диапазон: диапазоне
закисание: закисания
самоутверждение: самоутверждения
объясняться: объясняется
развлекаться: развлекаться
крайний: крайней
полезный: полезны
применение: применением
белые: белые
половой: половая
глухота: глухоту
нарушение: нарушением
окончательно: окончательно
отнести: отнесен
щётка: щеткой щетка
тигровый: тигровый
светлый: светлые
набирать: набирали
потребность: потребность
назвать: назвали
контракт: контракту
злость: злость
предок: предков
вовсе: вовсе
затеять: затеянной
жизнь: жизни
остальной: остальном
абсолютно: абсолютно
аллергический: аллергическим
забывать: забывайте
средство: средства
отмереть: отмершие
вычёсывание: вычесывания
благодаря: благодаря
отметаться: отметаются
гласить: гласит
курьёзно: курьезно
современный: современная
клиника: клиники
стаффа: стафф
вид: виде вид
длительный: длительных
амстафа: амстафа
запах: запаха
карантин: карантина
иной: иные
неприятный: неприятного
выдержать: выдержанный
сторожевой: сторожевыми
торчать: торчащих
готовить: готовя
обтирать: обтирать
нужно: нужно
мимимишность: мимимишности
спокойный: спокойной
также: также
экстерьер: экстерьера
процесс: процесс
покраснение: покраснением
покупка: покупки покупке
любимец: любимца любимец
помочь: поможет
съесть: съеденную
шёрстка: шерстка
собакакоторать: собакакоторая
свидетельствовать: свидетельствует
отвислость: отвислости
нижний: нижней
поведенческий: поведенческого
прошлое: прошлого
почувствовать: почувствует
крупяной: крупяные
обратиться: обратившись
ход: ходу
круп: крупу
жевательный: жевательные
умеренно: умеренно
начинать: начиная
ежедневный: ежедневных
суета: суету
изначально: изначально
высоко: высоко
агрессия: агрессию
команда: команда
сверхусилие: сверхусилий
тёмный: темный
безоговорочно: безоговорочно
порог: порог
сложно: сложно
складка: складки
крипторхизм: крипторхизм
крайне: крайне
щенок-девочка: щенкам-девочкам
стоить: стоит
завоевать: завоевали
предлагать: предлагаемая
возбуждение: возбуждения
интересно: интересно
ножницеобразный: ножницеобразный
неумелый: неумелым
зависеть: зависит
щенячий: щенячьего
квартира: квартиры
исходить: исходя
страх: страха
кормить: кормить
предназначить: предназначенные
кандидатура: кандидатурой
вполне: вполне
рогов: рогов
смочь: сможет
милый: милейшим
невозможно: невозможно
амстаффапоть: амстаффапотому
любящий: любящего
отработать: отработана
нелишний: нелишним
угроза: угрозу
счастливый: счастливое
понаблюдать: понаблюдать
признак: признаков
каша: каши
представлять: представляет
использование: использование
легко: легко
многий: многих
колебаться: колеблются
рынок: рынка
лента: ленту
бык: быками
твёрдо: твердо
ошибочно: ошибочно
основательно: основательно
исключение: исключением
непререкаемый: непререкаемым
очевидный: очевидно
сложность: сложностей
нежно-голубой: нежно-голубого
подумать: подумает
отличный: отличные
победа: победы
обмен: обмен
чуять: чуять
раздражительность: раздражительности
страсть: страсти
клиент: клиентам
медведь: медведями
проплешина: проплешин
выход: выход
вакансия: вакансии
угощение: угощение
прямо: прямо
перерасти: перерастет
вовремя: вовремя
настойчиво: настойчиво
продукт: продукты
площадка: площадки
стереотип: стереотипа
осознанно: осознанно
прикус: прикус
выделить: выделить
просматриваться: просматривается
генетически: генетически
наш: нашу
выше: выше
грудной: грудная
пытаться: пытающегося
молоко: молоко молока
стерелизованный: стерелизованна
окрасить: окрашены
обойтись: обойтись
мигрант: мигранты
управлять: управлять
большинство: большинстве большинства
штат: штате
кабель: кабели
избранник: избранника
играться: играется
о: обо
пройти: пройти
вздутие: вздутие
душевный: душевного
главный: главная
практически: практически
ежемесячно: ежемесячно
катаракт: катаракта
рейтинг: рейтинг
мышца: мышцы
недопустимый: недопустимы
ряд: ряд
важность: важность
подписываться: подписывайтесь
ринуться: ринувшиеся
гигиенический: гигиенических
оправдать: оправдавшая
недостаточно: недостаточно
равномерно: равномерно
означать: означает
самостоятельно: самостоятельно
прибегать: прибегают
использовать: использовать
постановка: постановка
брид-класс: брид-класса
очень: очень
немало: немало
аппетит: аппетит
поддаваться: поддаются
поводок: поводка
терьеризация: терьеризация
исправить: исправить
доверить: доверишь
каков: каково
узнать: узнайте узнаете
наиболее: наиболее
наоборот: наоборот
агент: агент
ущемить: ущемить
постепенно: постепенно
избежать: избежать
прогноз: прогноз
кличка: клички
правило: правила правил
отреагировать: отреагировать
прежде: прежде
изучить: изучить
удосуживаться: удосуживались
персональный: персональными
дыбомприжать: дыбомприжатая
возможность: возможность
касаться: касается
остаться: осталась
подсознательный: подсознательном
вольереоб: вольереобе
адекватный: адекватной
копия: копию
гипоаллергенный: гипоаллергенные
вырастить: вырастить вырастите
проект: проекте
сразу: сразу
рождение: рождении
борьба: борьбе
чистка: чистку
дмитриев: дмитриев
пора: пор
кг: кг
насколько: насколько
городской: городской
необходимость: необходимости
блюдо: блюда
кефир: кефир
смочить: смоченным
минимальный: минимальная
линька: линька
хрящ: хряще
страна: страна
низко: низко
изменить: изменил
устойчивость: устойчивость
наедине: наедине
сустав: суставов
особенность: особенность
использоваться: использовались
специализировать: специализированном
трус: труса
отметить: отмечено
корм: кормов
давно: давно
родитель: родителей
тонкость: тонкость
нянька: нянькой
подробно: подробно
поймать: поймал
бугор: бугор
конечность: конечности
безудержный: безудержная
представитель: представители
расставить: расставлены
являться: является
хвост: хвост
губа: губы
зуд: зудом
роман: романов
г: г
недобросовестный: недобросовестные
несочетаемый: несочетаемые
запрещать: запрещают
шаг: шаг
казаться: казалось
линейно: линейно
