свирепый: свирепого
психически: психически
процесс: процессе процесс
ценовый: ценовую
верный: верные верными
салаватович: салаватович
дисквалификация: дисквалификация
использовать: используя используйте использовали использовать
упитанный: упитанным
кинолог: кинологов кинологам
пигментация: пигментацию
кровь: крови кровь
приобретать: приобретают приобретали приобретать
стоять: стоять стоят
широко: широко
фу: фу
средний: средняя средней
улизнуть: улизнуть
скот: скота
необходимость: необходимость
агрессия: агрессия агрессию агрессией
полотенце: полотенце
здоровый: здоровых здоровыми здорового
красивый: красивых
добрый: доброго добрый доброе добрые
наверняка: наверняка
подарить: подарили
включаться: включаются
чёрный: черный черная черного черную
использоваться: используются используется
сколько: сколько
бегать: бегая бегать
отвар: отваром
сравнение: сравнения сравнении
послушный: послушные
название: название названия
собака: собаку собаками собакой собак собака собаках собакам собаке собаки
корсоподобный: корсоподобного
настоящий: настоящих настоящий настоящие
состоять: состоит
больший: большими большие большей
пугливый: пугливому
ноздря: ноздри
игрушка-канат: игрушки-канаты
обсуждение: обсуждения
ваш: вашему ваше вашей ваш вашего вашем
влечь: влечь
цена: цена
рыба: рыбу
скакательный: скакательный скакательных
зачастую: зачастую
внести: внесла
выжть: выжла
заметка: заметку
псиный: псины
подушечка: подушечки подушечками
мастиф: мастифы мастифах мастиф мастифов
приготовление: приготовление
природа: природы природе
вкрапление: вкрапления
материал: материалов
подшёрсток: подшерстком подшерсток подшерстку
быть: будучи будьте будут
казаться: кажется казалось
погибнуть: погибнуть
порок: пороком пороки
отражение: отражение
дисквалифицировать: дисквалифицирован дисквалифицирующие
олений: оленьего
частый: частом
поведение: поведения поведении поведению
харизматичный: харизматичны
пастуший: пастушьих
качество: качествами качестве качеством качества
любовь: любовь любовью любви
внимательность: внимательность
сторона: стороны сторону
хороший: хорошую хорошего лучшего хорошее
пятно: пятнами
множество: множества
положительный: положительных
город: городах городом городу
зато: зато
россия: россия россии
растянутый: растянутым
пясть: пясть
чудом: чудом
морда: морде морды морда
обратный: обратная
доминантный: доминантные
услуга: услугам услуг
чуткость: чуткостью
особый: особые особой
ради: ради
корректив: коррективы
искать: искать
отвлечь: отвлечь
контроль: контролем контроля
грань: грани
команда: команду командами команды команда
охранный: охранных охранными охранные
активничать: активничать
шея: шея
назвать: названному назвать
темпераментный: темпераментные
гарантировать: гарантирует
судить: судит
шерсть: шерсть шерсти шерстью
материк: материку
поверхность: поверхности поверхность
обладать: обладающая обладают обладает
напоминать: напоминая
выразить: выражены
высокий: высоких высокая
составить: составлен составит
поспрашивать: поспрашивайте
челюсть: челюсти челюсть
бабочка: бабочки
должный: должны должен должно должна
воспитание: воспитания воспитание воспитании
враг: врагов
подрастить: подращенного
прошедший: прошедшей
эпилепсия: эпилепсией
лечить: лечит
посадить: посажен посадить
пострадать: пострадало
начать: начнет начать
заходить: заходящая
повязать: повязать
вердикт: вердикт
вельша-корги: вельш-корги
человек: людям людей человека люди
относиться: относится относятся
поселить: поселить
месяц: месяц месяца
выносливый: выносливы
некоторый: некоторых некоторую некоторая некоторые
спустя: спустя
плёнка: пленка пленку
ромашковый: ромашковым
итальянский: итальянской итальянских итальянские итальянского итальянский
включая: включая
охранять: охраняли охраняя охраняет охранять
гипертиреоз: гипертиреоз
важно: важно
способность: способностях способность
заложить: заложены заложено
многий: многим многими многих
история: история истории
лечение: лечению
радость: радости
рукавица: рукавицу
выполнение: выполнение выполнения
щенок: щенка щенков щенки щенок щенке щенку
сурово: сурово
парка: парке
властность: властность
проявляться: проявляется
вывод: вывод
необходимый: необходимое необходимыми
пространство: пространстве пространством
подлинный: подлинного
никакой: никакой никаких
попросить: попросите
наш: наших нашей наши
настолько: настолько
проявлять: проявляет проявлять
задний: задняя задние
телохранитель: телохранители
каждый: каждого каждый
младший: младшим
голова: голове головы голова
заболевание: заболеванию заболеваниям заболеваний заболеваниями
семья: семьи семью семья
камнеобразование: камнеобразования
испытание: испытанием
досуг: досуг
нередко: нередко
выбрать: выбранного выбрать выбранным
характеристика: характеристика характеристикам
гигант: гигант гиганты гигантов
этот: этими эта этих
выставка: выставках выставок выставке
такой: таком таких такое такие таким
помощь: помощью помощь
дом: дому дом дома доме
недешёвый: недешевы
эмоция: эмоции
нос: носу носа нос
причина: причинам причину
перестать: перестать
следить: следили
выступать: выступает
год: годы года лет год году
пол: пола
война: войны
страховать: страхует
кормление: кормлении кормления
редкий: редким
менять: меняя
болезнь: болезнями болезнь болезней болезни
находиться: находилась находясь находится
чей-то: чьем-то
посторонний: постороннего посторонние
дальний: дальними
мальчик: мальчика
документ: документах документе документов
значит: значит
стать: стала стали стал станет став
образовать: образующих
развитой: развито развитые развитыми
маска: маска маской
палец: пальцы пальцами
считать: считает
быстро: быстро
помогать: помогая помогает
параллельный: параллельное
первый: первой первые первого первый первая первую первых
другой: другому другую другие других другим
представитель: представителям представителя представитель представители
удаться: удалось
поколение: поколения поколение
диск: диск
раз: раза
видео: видео
помимо: помимо
заполнять: заполняйте
подойти: подойдет
воспринимать: воспринимая воспринимает
свисать: свисают
доброта: доброта
характер: характере характера характеру характер
психический: психическое психического
моновыставка: моновыставках
боковой: боковые
внимание: внимания внимание
защищаться: защищаться
очередь: очередь
полностью: полностью
возможный: возможные возможного
оценка: оценок оценке
гость: гости гость гостям
зоомагазин: зоомагазине
пёс: псы псов псам пес пса псом
домашний: домашних домашними
тело: телу
передвигаться: передвигаются
участвовать: участвовали
нужный: нужна нужен
неизменный: неизменным
нарушитель: нарушителей
атлетичный: атлетичный
титанический: титанические
лопатка: лопатками
называть: называют называемый называемым
перевалить: перевалила
содержание: содержание содержания
ген: гены
традиционный: традиционных
сера: серы
щека: щекам
гигантский: гигантских
немного: немного
корма: кормах
походка: походка походкой
переплестись: переплелись
предать: предан преданными преданного предадут
южнорусский: южнорусская
мощный: мощный мощные
составлять: составляет
предсказуемый: предсказуем
характеризоваться: характеризуется характеризуются
рекомендовать: рекомендуют
физиологический: физиологические
человечество: человечество
косточка: косточку
опуститься: опустившимися
численность: численность
запах: запахов запах
оставаться: остаются остается
окрас: окраса окрас окрасом окрасов
предел: пределы
ветеринар: ветеринару ветеринар ветеринарам
допускать: допускает
покупка: покупкой покупке
намерение: намерения
масло: масло
перечень: перечне
территория: территорию территории
он: нему
связь: связь
уделять: уделять
точно: точно
выраженный: выраженная выраженную
трещина: трещин трещины
светло-серый: светло-серыми
прививка: прививкой прививок
внешность: внешность внешности
найти: нашел найти
корсо: корсо
острый: острую
владелец: владельцев владельцы
сливка: сливки
длина: длине длины длина
налёт: налет
условие: условием
частный: частном
проходить: проходить
непрошеный: непрошеные непрошеным
жилистый: жилистые
полный: полная
система: систему системах
состояние: состоянии состояния
белый: белыми
аллергия: аллергии
слёзный: слезных
объект: объектами объекта
свинцовый: свинцовыми
растительный: растительное
дважды: дважды
злой: злого
давать: давать дают давайте
знать: знаешь знать знает
член: члена членам членов члены
становиться: становясь становятся
эктопаразит: эктопаразитов
признание: признания
блоха: блохах
предмет: предметы
многопрофильный: многопрофильной
распространяться: распространяться распространяется
заниматься: заниматься
препарат: препаратом
плотно: плотно
достояние: достоянием
жидкий: жидкие
печально: печально
сапог: сапога
поле: поле поля
подобрать: подобрать
питомец: питомцу питомца питомцем
бывать: бывают бывает
крупный: крупный крупная крупных крупные крупным
смотреть: см смотрите
сходиться: сходятся
друг: друзья друзьях друга друзьями
племенной: племенную племенное
отпадать: отпадает
дорожка: дорожек
лёгкий: легкий
фотография: фотографии
широкий: широкие широким широкую широкая
изображение: изображениями
рбер: рбер
надолго: надолго
современный: современные современной современных
уход: уходе уход
период: периода периоды период
удивительный: удивительные удивительным
позвонок: позвонку
помнить: помните
страдать: страдать страдают
опорно-двигательный: опорно-двигательного
дать: данной даст дало
ряд: ряде
незаметный: незаметен
сужаться: сужаясь
питомник: питомники питомниках питомнике
угрожать: угрожать
переносить: переносят
обидеть: обидят
череп: черепом черепа
глаз: глаза глазом глаз глазу
квадратный: квадратной
жирный: жирные жирных
решать: решать
серьёзный: серьезным
целый: целые
отмереть: отмершую отмершей
корм: корм корма
археологический: археологические
самый: самым самыми самых
толстой: толстая
профилактика: профилактики
упругий: упругими
буквально: буквально
делаться: делался
поскольку: поскольку
охота: охотах охоте
покупать: покупать покупайте
существо: существо
простой: простой
краткий: краткая
недобрый: недобрые
сильный: сильная сильного сильные
отношение: отношение отношении отношению
жировой: жировую
вкупе: вкупе
место: место
консультация: консультация консультации
исключительно: исключительно
малоподвижность: малоподвижности
ребёнок: ребенка дети ребенком детьми
весь: весь всей всем всеми
игривость: игривость
эксперт: экспертов
купать: купать купая
гордость: гордостью
ранний: раннего ранних
красный: красными
критически: критически
отвечать: отвечают
забывать: забываем забывайте
вконтакте: вконтакте
сохранять: сохранял сохранять
постоянный: постоянной постоянном
свет: свет
глистогонка: глистогонка
рядом: рядом
впечатление: впечатление
помахать: помашите
трудный: трудным
двигаться: двигаются
атлетический: атлетическим
ласковый: ласковы ласковое
экономить: экономить
дог: догу доги догов дог
усвояемость: усвояемости
выражение: выражением
хозяин: хозяин хозяином хозяину хозяевам хозяев хозяина хозяева
мес: мес
лишённый: лишенные
суп: супы
типичный: типичная
животное: животных животным животными
один: одного одно одному
житель: жителем
появление: появления появлению
потускнеть: потускнеет
охотничий: охотничьих
спокойный: спокойным спокойными
причм: причм
основать: основана
впечатлять: впечатляют
сустав: сустава сустав суставов
хотя: хотя
нижний: нижняя нижнюю
интуитивно: интуитивно
х: х
обманчивый: обманчиво
вид: видами вида виду вид
близкий: ближайших
общий: общее
бедро: бедре
неприятный: неприятных
ворс: ворса
имущество: имуществом
форма: форму формы
осмотр: осмотре
серый: серая
порода: породам породы пород породу порода породой
империя: империи
безропотно: безропотно
предрасположенность: предрасположенности предрасположенность
множественный: множественными
квартира: квартире
врач: врачей
размер: размеры
вор: вору вора
грозить: грозить
внезапный: внезапная
проживать: проживает
сотня: сотен
информация: информация
телосложение: телосложение
защитный: защитную
защитник: защитников
сохраниться: сохранилось сохранились сохранившихся
зуб: зуба зубы зубам зубов
физический: физического физическое физическому физической
охранник: охранников охранниками
италия: италия италии
проводить: проводить
распространение: распространению
пробежка: пробежками
влить: влив
входящий: входящего
создавать: создавать
очередной: очередной
авторитет: авторитет
остальной: остальных
активный: активного активным
ниже: ниже
выбор: выбор
улица: улицы
грациозно: грациозно
обнаружить: обнаруженных
крепкий: крепкие крепкое крепкая крепки крепкими
депигментация: депигментацию депигментация
сухой: сухой сухие сухую
дикий: диких
природный: природной
отзываться: отзываются
среди: среди
любой: любое любой любом любыми
взяться: возьмитесь
крупа: крупы
линия: линию линия
это: этим это
выпас: выпаса
рельефный: рельефной
веко: веки
применяться: применяются применяется
преодоление: преодолении
новый: новых новую
длинный: длинные длиннее длинный длинным длинная длинными
считаться: считается считаются
молосский: молосских
кто: кем
норма: нормы
тряпочка: тряпочку
внушать: внушать
приложить: приложившему
загрязнение: загрязнения
пройтись: пройтись
совместный: совместные
уста: уст
вынести: вынесен
тибетский: тибетские тибетский
подсунуть: подсунут
покрывать: покрывают
душ: душем
какой-то: каким-то какое-то
час: часа
обратить: обратить
умный: умных умны умной умные умная
гулять: гуляя гулять
величественный: величественных
выдата: выдат
достигать: достигающий достигает
мировой: мировой
низкий: низкая
умиление: умиления
камень: камень камни
усилие: усилия
пропорциональный: пропорциональная
локоть: локтей
продолжаться: продолжалось
добавить: добавьте
прогулка: прогулки прогулок
профиль: профиля
социализация: социализацию
вычёсывать: вычесывать
поход: походах походы
холка: холка холке
стереотип: стереотип
черта: чертах черты чертами
травля: травлях
умеренный: умеренная
соответствовать: соответствующую
происхождение: происхождения
необходимо: необходимо
вотсап: вотсап
готовый: готовы готовых готового готов готовый
понимать: понимают понимающее
деньга: деньги
утвердить: утвержденный
малый: меньшее
кан: кане
агрессивный: агрессивный агрессивную агрессивен
ситуация: ситуация ситуации
кобель: кобеля кобели кобелей
тщательно: тщательно
деятельность: деятельность
оставлять: оставляйте оставляя оставляет
развлечение: развлечение
лакомство: лакомство лакомства
дрессировка: дрессировка дрессировке дрессировки
предплечье: предплечья
нервный: нервную
время: время времена времен времени
сука: суки сук
раскрыть: раскрыты
агрессивность: агрессивность
ушной: ушной
суровый: суровый суровые
нм: нм
день: дней дня день дни
вес: веса вес
они: ими ними
просмотр: просмотров
приглядывать: приглядывали
задолго: задолго
признавать: признают
знакомство: знакомстве
проникать: проникая
взаимопонимание: взаимопонимание
речной: речную
исчезнуть: исчезли
мера: мере
распознать: распознать
калужский: калужская
например: например
несколько: несколько
превосходно: превосходно
охрана: охраны
грызть: грызть грызет
век: век веками веков
рост: рост
сила: силы силой
точный: точное
твёрдый: твердые
к: ко
положительно: положительно
четвртом: четвртому
соответственно: соответственно
реклама: реклама
уроженец: уроженцев уроженцем
мелковатый: мелковаты
обнаруживаться: обнаруживаться
мягкий: мягкая
линять: линяет
взаимность: взаимностью взаимности
итальянец: итальянца итальянцах итальянцев итальянцы итальянец
отложение: отложений
качественный: качественные
мускулатура: мускулатурой
плохой: плохой плохом плохие
второй: второй
ум: умом
непосредственно: непосредственно
рекомендоваться: рекомендуется
явно: явно
понятно: понятно
лгкий: лгкий
малыш: малыш малыша
потомок: потомков потомок потомки
наследственный: наследственных наследственная
бульон: бульоны
выводить: выводили
боевой: боевые боевых
хватка: хватку
кровообращение: кровообращение
кардиган: кардиган
бережно: бережно
красота: красотой
сайт: сайту
вымирание: вымирания
родословная: родословной
позволять: позволяет
понять: понять
благодарно: благодарно
апеннины: апеннин
реагировать: реагирует реагируют
дорогой: дорогое
сорт: сортов
недуг: недугов
чайный: чайной
кожа: кожа кожей
длительный: длительными длительное длительного
лишь: лишь
что-то: что-то
наверное: наверное
пытаться: пытается пытаясь
неагрессивный: неагрессивные
ризеншнауцер: ризеншнауцер
выносливость: выносливости
итальяно: итальяно
опытный: опытные
репутация: репутацией
тот: теми те тех тому той
грабитель: грабитель
свободолюбивый: свободолюбивы
перевоспитать: перевоспитать
форум: форум форуме
оберегать: оберегать
угроза: угроза угрозу
недопустимый: недопустимым
протяжение: протяжении
гладкий: гладкой
требовать: требуемое требуют требуйте
солнечный: солнечных
паспорт: паспорт
хотеть: хотят хочу
расцвет: расцвета
воплощение: воплощение
вытирать: вытирайте
бонатти: бонатти
элементарный: элементарной
домовладение: домовладения
порой: порой
внешне: внешне
мощность: мощностью
шампунь: шампуни
три-четыре: три-четыре
дешёвый: дешевые
молокопродукты: молокопродукты
резкий: резких
желудок: желудок
обработка: обработки
побывать: побывать
резиновый: резиновую
проглистогонить: проглистогонить
видеть: видя видите
выводиться: выводилась
оценить: оценившему
продольный: продольных продольные
величие: величием
значительно: значительно
шоу-класс: шоу-класса
трусливый: трусливому
описание: описание
игра: игр игры игрой
предательство: предательство
начало: начало начале
впалый: впалая
многое: многое
удивлять: удивлять
слабый: слабее
присущий: присущи присуща
подниматься: поднимается
военный: военных
короткий: короткое короткие короткая короткой
прилегание: прилеганием
собачий: собачьих
составляться: составляется
глубоко: глубоко
однако: однако
римский: римской
покладистый: покладистыми
иноходь: иноходь
отличаться: отличаются
который: которой которого которых которые который
преданность: преданность
уравновесить: уравновешен
соотноситься: соотносится
устраивать: устраивать
поэтому: поэтому
являться: являлись являются является
непослушание: непослушание
случай: случаев случаях случае случай
копирование: копирование
дружелюбный: дружелюбная дружелюбен
трудно: трудно
прекрасно: прекрасно
достоинство: достоинств
активность: активность активности
существовать: существует
чистоплотность: чистоплотности
основание: основания оснований
дружелюбность: дружелюбность
равный: равна
голод: голодом
мама: мамой
презентабельный: презентабельно
проникнуть: проникшего проникшему
тратить: тратить
отзыв: отзывах отзывы
говориться: говорится
четырнадцатый: четырнадцатой
поинтересоваться: поинтересоваться
заявиться: заявятся
нужда: нужд
кошка: кошки
следовать: следует
толкнуть: толкнуть
письменный: письменные
животный: животному
шум: шум
надёжный: надежные надежной
предупредить: предупредить
натуральный: натуральные
процедура: процедуры
наблюдать: наблюдать наблюдают
славный: славную
официальный: официальном официальной
уровень: уровня уровне
ввиду: ввиду
предотвратить: предотвратит
показать: покажет
верхний: верхние
переживать: переживаете
прямой: прямая
густой: густая
средне-серый: средне-серыми
подсказать: подскажите
тигровый: тигрового тигровых
мать: матери
пожалеть: пожалеет
назад: назад
преимущественно: преимущественно
наносить: наносят
пожалуйста: пожалуйста
комок: комком комок
цвет: цвет
решить: решили
мочь: могут можете
минимум: минимум
скопиться: скопившейся
поздоровиться: поздоровится
джованни: джованни
готовка: готовки
приобрести: приобретете приобрести
всячески: всячески
творог: творог
сопровождать: сопровождали
объявление: объявления
доктор: доктора
сделать: сделать сделано сделало
основной: основные
действовать: действовать
дополнительный: дополнительным
слушаться: слушаясь
простимулировать: простимулирует
интеллект: интеллект
многие: многие
чужое: чужого
протирать: протирайте
уважение: уважение
выполнять: выполняют выполнять
степень: степени
зелный: зелный
конец: конец концам концы концах
попытаться: попытается
называться: называется
ежедневно: ежедневно
перегон: перегона
фрагментарный: фрагментарная
свой: своим свой свое своего своей своих своему свои
пропустить: пропустить
беспричинный: беспричинную
сметана: сметану
именно: именно
прятаться: прячется
мучиться: мучиться
обвиснуть: обвисшие
угловатый: угловатый
последний: последних последнего последней
отдалить: отдаленных
отсутствовать: отсутствуют отсутствует
бараний: бараний
продолжительность: продолжительность
оказать: оказали
протирание: протирания
влажный: влажной влажную
захотеть: захочет
спортивный: спортивными
отлично: отлично
расположить: расположенные
преимущество: преимущество
страна: страны страна
следующий: следующему
паста: пасту
скрещивать: скрещивать
зубной: зубную зубной
сезонный: сезонной
взрослеть: взрослеть
развитие: развития развитию
зависимость: зависимости
отдых: отдыха
умысел: умысла
осень: осенью
подход: подход
никак: никак
принимать: принимать
слегка: слегка
умственный: умственной
огромный: огромный
здравствуйте: здравствуйте
император: императору
иметься: имеются
обращаться: обращаться обращаются
фото: фото
летний: летней
маленький: маленького маленькие меньше маленькая
обрадоваться: обрадуется
вы: вами
регулярный: регулярном регулярную
выделяться: выделяются
сам: самого самих самом
расстановка: расстановку
яндекс: яндекс
бордосский: бордосскому
спокойствие: спокойствие
обитать: обитают
гармонично: гармонично
нечаянно: нечаянно
вперёд: вперед
барьер: барьеров
защитить: защищенным
неудобство: неудобства
нрав: нрав
удалять: удаляющие
чистота: чистоты
педагогический: педагогических
получить: получила получить получит
лапа: лапы лап
ухо: ушах уши
собрать: собраны собравшие
дороговизна: дороговизны
здоровье: здоровью здоровья здоровье
нахождение: нахождении
экстерьер: экстерьеру
премиум-класс: премиум-класса
журнал: журнал
неделя: недели неделю
четыре: четыре
высота: высота высотой
игривый: игривые
евразия: евразии
передаваться: передавались
ось: оси осей
делать: делать делает делали
семенник: семенники
внешний: внешнему
нуждаться: нуждаются нуждаюсь
лишать: лишайте
вкусный: вкусное
пища: пищу
уживаться: уживаются
обычный: обычной обычное
покров: покров
сэкономить: сэкономить
сложение: сложением
заводчик: заводчиков заводчика заводчики
пантера: пантер
опекать: опекать
вовлекать: вовлекают
совершенно: совершенно
скитаться: скитались
чрезмерно: чрезмерно
либо: либо
активно: активно
нападать: нападает
моющий: моющие
совет: совет
образ: образом
овальный: овальной овальные
древний: древнего
предпочитать: предпочитают
неопытный: неопытных
выработать: выработали
показатель: показатель
неосведомлнный: неосведомлнным
обеспечивать: обеспечивают
молниеносно: молниеносно
местность: местностях
зверь: зверя
бублик: бубликом
мимика: мимикой
туалет: туалету
прилегать: прилегает прилегая
жёсткость: жесткости
разлука: разлуку
взрослый: взрослые
движение: движения движений
чужой: чужим чужой
перекус: перекус
поставить: поставленных
ревность: ревность
разнообразие: разнообразие
придать: придав
взросление: взросления
коричневый: коричневых коричневого
перейти: перейти
кельтский: кельтскими
реально: реально
из-за: из-за
быстрый: быстрее
долгий: долгую долгие
регулярно: регулярно
главное: главное
кан-корсо: кане-корсо
эгоистичный: эгоистичны
ниццоля: ниццоли
прохожий: прохожих
датировать: датированы
опровергать: опровергают
обнаруживать: обнаруживать
попечение: попечении
знающий: знающие
вопрос: вопросе вопросу вопрос
ветеринарный: ветеринарный
бова: бов
жить: живете
глядеть: глядя
рыжий: рыжих
наклонить: наклоненным
иной: иной
улучшить: улучшить
грудь: груди грудь
клетка: клетка
цель: целью цели целей
бескомпромиссный: бескомпромиссных
область: область
отсутствие: отсутствие
вести: ведут
слишком: слишком
невероятно: невероятно
одиночество: одиночеству
национальный: национальным
развить: развита
хвалить: хвалить
коготь: когтями
родитель: родителя родителей
начинаться: начинаться
стандарт: стандарта стандарт
падение: падения падению
благоговение: благоговение
перловка: перловку
рука: рук рукой
выдать: выдать
мелкий: мелкие
метис: метиса
значительный: значительным значительное
плюс: плюсы
терпеть: терпит
лосниться: лоснится
закисание: закисание
отклонение: отклонением
тёмный: темнее
подобный: подобные
ложка: ложке
копчёность: копчености
придерживаться: придерживаться
мускулистый: мускулистая
небольшой: небольшие
различный: различными различные
появиться: появился
поведенческий: поведенческие
разный: разным разных
дорого: дорого
загружать: загружайте
взять: возьмет
упоминание: упоминания
акцент: акцент
неплохо: неплохо
родоначальник: родоначальниками
молодой: молодом
загрустить: загрустить
сообразительность: сообразительностью
опасность: опасность опасности
красавец: красавец
английский: английскому
воспаление: воспаления
наличие: наличии
блестящий: блестящей блестящие
шерстяной: шерстяной
неподдельный: неподдельное
варьироваться: варьируется
тысяча: тысячу
аномалия: аномалии
собственный: собственному
встречать: встречать
размашистый: размашистая
александрович: александрович
веять: веет
готовность: готовностью
жилище: жилище
недокорм: недокормом
часть: часть
чеснок: чеснок
иметь: имеет иметь имеют
непревзойдённый: непревзойденными
железный: железную
обратиться: обратиться
рентген: рентген
спасибо: спасибо
стоимость: стоимость
смыться: смоется
нависнуть: нависла
особенно: особенно
желательно: желательно
предугадать: предугадать
возле: возле
нравиться: нравится
достаточно: достаточно
поддаваться: поддается поддаются
подтянутый: подтянуты
обязательно: обязательно
грязь: грязи
международный: международной
выпускать: выпускают
ответ: ответов ответ
доминировать: доминировать
кроха: кроха
сложность: сложности
кан-корс: кане-корсе
распространить: распространенным
ватсап: ватсап
бдёр: бдер
интересовать: интересует
расположение: расположение
даваться: давалось
свинина: свинину
выпуклый: выпуклая
плата: плату
возраст: возраста возрасте
свёрнутый: свернутый
мошонка: мошонку
объёмный: объемная
страница: страниц
специальный: специальные специальную специальной
памятник: памятники
присутствие: присутствии
орган: органы
обстановка: обстановку
поводок: поводке
охотно: охотно
вывести: выведенной
несмотря: несмотря
вальяжный: вальяжными
дойти: дошли
голодный: голодный
сладость: сладости
купить: купить
часто: часто
плотный: плотные плотным плотной
предок: предок предков предками
склонность: склонность
эра: эры
оказаться: оказаться
товарищ: товарища
победитель: победителем
отлавливать: отлавливать
допускаться: допускаются
формат: форматом
наказание: наказание
боксёр: боксером
завести: завести
минимальный: минимальным
регистрация: регистрацию
вертикально: вертикально
спина: спина
простительный: простительно
причск: причску
непременно: непременно
растворение: растворения
признак: признаком
корпус: корпусу корпус
висеть: висящие
задаток: задатками
глазной: глазных
уметь: умели
недостаток: недостаткам
рассчитывать: рассчитывать
функция: функцию функцией
живой: живой
проявить: проявлена проявившему
поощрение: поощрение
увлечь: увлечена
тонкий: тонкому
дисплазия: дисплазию дисплазии
самоотверженность: самоотверженность
косоглазие: косоглазие
сельхозугодье: сельхозугодий
мысль: мысли
ватный: ватный
безупречный: безупречной
обтянутый: обтянута
начнт: начнт
опаска: опаской
комплекс: комплексы
определять: определяя
одноклассник: одноклассники
реакция: реакцию
вс: вс
узнать: узнать
неоценимый: неоценимую
правда: правда
исчислять: исчисляемую
грозный: грозному
чистить: чистить
ушко: ушками
случайный: случайные
передний: передние
чётко: четко
навык: навыки навык
мясо: мясо
историк: историками
равносторонний: равностороннего
гордый: гордых
пэт-класс: пэт-класс
позволить: позволит
откровенно: откровенно
перчатка: перчатку
самобытность: самобытность
символический: символическую
светло-рыжий: светло-рыжего
треугольник: треугольника
сегодня: сегодня
чувство: чувство
отдельный: отдельным
профессиональный: профессиональным
поиск: поиск
участие: участия
отход: отходом
плоский: плоская
укреплять: укрепляют
встреча: встрече
тазобедренный: тазобедренного
мало-мальски: мало-мальски
вообще: вообще
античность: античности
выполнить: выполнит
смышлёный: смышленых
таковой: таковым
себя: собой
белые: белые
цепь: цепь
выглядеть: выглядят выглядит
всякий: всякая
болезненно: болезненно
лежать: лежать
орех: орехи
зрение: зрения
правильный: правильный
единомышленник: единомышленники
чрный: чрного
попросту: попросту
промывать: промывайте
присмотреться: присмотритесь
потребность: потребность
периодически: периодически
влиять: влияет
главный: главным главная
вред: вред
вздутие: вздутием
средство: средство средства
недокус: недокус
вовсе: вовсе
селекционный: селекционная
китайский: китайскому
шиферный: шиферными
линька: линьки линька
жизнь: жизни жизнь
два: двух
абсолютно: абсолютно
овчарка: овчарка
весить: весят
продолжать: продолжать
едва: едва
мешать: мешает
говорить: говорить говоря
благодаря: благодаря
нанести: нанести
выходить: выходя
девочка: девочки
рана: раны
выпуклость: выпуклость
плечо: плечи
минус: минусы
впервые: впервые
удиться: удатся
важный: важном
группа: группы
бульдог: бульдогу
тщательность: тщательностью
воспитывать: воспитывать
большой: большом
антисептик: антисептик
молоссова: молоссов
железа: железы
волнистый: волнистая
относительно: относительно
нужно: нужно
придомовый: придомовую
мимимишность: мимимишности
настойчивость: настойчивость
вызывать: вызывают
также: также
толчок: толчок
усмотрение: усмотрению
наброситься: набросится
лук: лук
любимец: любимца любимец
помочь: поможет
момент: моменты
сюда: сюда
ослабевать: ослабевать
задача: задач
весна: весной
риск: риском
почувствовать: почувствует почувствуют
особенность: особенностях особенности
оставить: оставит
элегантность: элегантность
летопись: летопись
живот: живота
престиж: престижа
отсюда: отсюда
радмир: радмир
изучить: изучите
отличать: отличавших
обучить: обучить
рим: рима
заводить: заводят
лоскуток: лоскутком
отар: отарами
привести: привести
служить: служили
высоко: высоко
уравновешенность: уравновешенность
складка: складки
крайне: крайне
стоить: стоит
срочно: срочно
столетие: столетиями столетий
согревать: согревать
ножницеобразный: ножницеобразный
вязка: вязка
зависеть: зависит
реальный: реальная
стараться: стараясь старайтесь
порка: порок
дворовый: дворовым
исходить: исходя
сведение: сведению
избыток: избыток
печальный: печальных
этап: этапах
вполне: вполне
дрессура: дрессуры
радовать: радует
добиться: добились
устояться: устоявшийся
снять: снять
любить: любят
невозможно: невозможно
убрать: убрать
втирать: втирают
начинать: начинайте
страх: страх
своевременно: своевременно
массажный: массажную
расти: расти
чистка: чистки чистку
нелишний: нелишним
тренировка: тренировка
дворцовый: дворцовые
воздерживаться: воздерживаться
птичка: птички
использование: использование
легко: легко
расчск: расчску
неторопливый: неторопливыми
генетический: генетическом
лента: ленту
производитель: производителей
окупиться: окупится
выворот: выворотом
словно: словно
тряпка: тряпкой
проветривание: проветривании
сходу: сходу
известно: известно
мороз: морозы
клещ: клещах
бельмо: бельмо
тип: типа
счтить: счту
пойти: пошло
конкретный: конкретных
отличный: отличные отличными
слюни: слюни
уверить: уверены
объмный: объмная
последовательный: последовательными
общаться: общается
график: график
что-либо: что-либо
расчёсывать: расчесывать
пристраиваться: пристраиваются
эластичный: эластичные
передовой: передовой
заплатить: заплатить
интуиция: интуицией
спешить: спешат
вакансия: вакансии
собрат: собратья
приучать: приучайте
усердие: усердием
продукт: продукты
произноситься: произноситься
портить: портящим
производиться: производится
заворот: заворотом
прикус: прикус
приходиться: приходится
крыло: крыльями
запястье: запястье
добродушный: добродушные
парикмахер: парикмахеров
постоянно: постоянно
корректировать: корректировать
сказать: скажешь
темно-рыжий: темно-рыжего
выделение: выделений
верховодить: верховодить
лишить: лишена
рысь: рысь
чистокровный: чистокровных
голень: голени
состоятельный: состоятельные
выше: выше
грудной: грудная
сочетаться: сочетаются
переходящий: переходящие
пшено: пшено
усыплять: усыплять
серьзный: серьзным серьзный
цениться: ценились
регион: регионах
мускулистость: мускулистость
покрыть: покрытые
какой-нибудь: какого-нибудь
сигнализация: сигнализации
крайний: крайний
отважность: отважность
практически: практически
сутки: суток
вишнёвый: вишневым
рейтинг: рейтинг
пропорция: пропорции
переносица: переносица
золотой: золотой
избавиться: избавиться
проход: проход
купирование: купирование
аппарат: аппарата
смиренно: смиренно
подписываться: подписывайтесь
чемпион: чемпиона
кошачий: кошачьего
смех: смеха
самодеятельность: самодеятельностью
читать: читаешь
означать: означает
самостоятельно: самостоятельно
тёмно-серый: темно-серыми
элегантно: элегантно
раб: рабами
повседневный: повседневный
гнойный: гнойных
хвост: хвоста хвост
стоящий: стоящий
запретить: запрещено
брид-класс: брид-класса
наклонный: наклонными
очень: очень
обычно: обычно
особь: особей
ладить: ладит
немало: немало
возрождение: возрождения
возрожднный: возрожднной
собака-гладиатор: собак-гладиаторов
будка: будку
удача: удачу
толстый: толстый
наоборот: наоборот
инстинкт: инстинкт
избежать: избежать
круп: крупом
шаг: шагом
частичный: частичную
кличка: клички
правило: правила
генофонд: генофонда
довольно: довольно
купировать: купировать
держать: держать
прежде: прежде
подкосить: подкосило
удаление: удаления
узда: узде
касаться: касается
скрытый: скрытую
четвероногий: четвероногого
самочувствие: самочувствие
материнский: материнским
помыть: помойте
дело: деле
одновременно: одновременно
причислять: причисляют
проект: проекте
задешево: задешево
число: числе
продать: продадут
склонный: склонны
придавать: придающая
кг: кг
городской: городской
вносить: вносите
уверенный: уверенная
сплошной: сплошных
дешв: дешвых
сидеть: сидеть
среднее: среднего
изогнутый: изогнутые
чувствовать: чувствуешь
рацион: рацион
действительно: действительно
туловище: туловище
темперамент: темперамент
щитовидный: щитовидной
гарантия: гарантии
банный: банные
стая: стае
играть: играет
москва: москвы
низкосортный: низкосортные
беспокоить: беспокоит
причём: причем
венгерский: венгерская
сносить: сносит
показывать: показывать
представить: представить
плюсна: плюсны
уезжать: уезжать
событие: события
нянька: нянькой
далёкий: далеких
загибаться: загибается
конечность: конечности
оба: оба
полноправный: полноправного
губа: губы
доллар: долларов
борзая: борзыми
элитный: элитных
середина: серединой
размеренный: размеренными
способный: способны
собеседник: собеседника
неукоснительно: неукоснительно
приём: приема
скомандовать: скомандуйте
роман: роман
