радость: радостью радости
иметь: имели имеет имеют
конкуренция: конкуренции
попытка: попытке попытки
существование: существование
внести: внести
ситуация: ситуациях ситуацию ситуациями
тело: тела
американский: американских американскому американский американским американские американского
кровь: крови кровь
стоять: стоять стоят
широко: широко
средний: средняя среднее средние средними средний
популярность: популярности популярностью
защита: защиту
залом: заломом
сколько: сколько
ветеринарный: ветеринарного
склонный: склонен
осмотр: осмотра осмотре
название: название названием названия
свежий: свежий свежим свежем
максимальный: максимальным
ограничиваться: ограничивалась
погоня: погоню
пообещать: пообещав
домой: домой
собака: собаку собаками собак собака собакам собаке собаки
округлый: округлой округлый
настоящий: настоящих
хороший: лучшим хорошей
возникать: возникают
физический: физических физическим
обсуждение: обсуждения
предпочтительный: предпочтителен предпочтительны
другой: другое другие другими
ваш: вашему вашим ваши вашей ваш вашего вашем
миска: миску
английский: английских английский
цена: цена
рыба: рыбу
материал: материалов
удовольствие: удовольствием
племенной: племенные
здравствуйтетрой: здравствуйтетрое
организация: организации организацией организаций
анонимный: анонимный
обратить: обратите обратил
владелец: владельцам владельцев владельцем
слабохарактерный: слабохарактерным
размер: размерам размеров размеры размерами размером
внезапный: внезапным
резец: резцов резцы
качество: качествами качестве качества
любовь: любовь любви
воришка: воришке
дисквалифицировать: дисквалифицирующие
полтора-два: полтора-два
инстинкт: инстинкты
стоящий: стоящими
катастрофа: катастрофах
джорджия: джорджии
выраженный: выраженный выражен выраженным выраженные
россия: россия
сбалансированный: сбалансированным
национальный: национального
обратный: обратная
америка: америки
радужка: радужки
представитель: представителей представителям представителями представители
безупречный: безупречными
отвлечь: отвлечь
начинающий: начинающих
шея: шея шеи
блеск: блеском
выплеснуть: выплеснуть
открыть: открыть
шерсть: шерсть шерсти
компаньон: компаньоны компаньона компаньонами
документ: документы
пресекать: пресекайте
кальций: кальция
челюсть: челюсти челюстям челюстей
зарегистрировать: зарегистрирован зарегистрирована зарегистрированы
должный: должны должен должна
воспитание: воспитания воспитание воспитании воспитанию
тип: тип типу типа типы
разводиться: разводились
пропорциональность: пропорциональностью
исключение: исключение
класс: класса
сторож: сторож сторожами
энергия: энергию
документально: документально
человек: людям людей человеку люди
согласиться: согласитесь
относиться: относится относились относятся
месяц: месяц месяца месяцев
большой: большой
участок: участки участков
ценность: ценность
отличаться: отличается отличалась отличаются отличались
рычать: рычит рычать
амбулейя-чемпион: амбулей-чемпионов
история: история
навыкате: навыкате
редкий: редкое
тягота: тягот
кинологический: кинологических кинологической
камера: камеры
щенок: щенка щенков щенки щенком щенок щенку щенкам щенят
беречься: берегитесь
внимательный: внимательны
успешно: успешно
опрятный: опрятным
новый: новые новую новым новому
дикий: дикие диких
слава: славу
каждый: каждого каждой каждые каждый
форма: форма форму формы
выдвигаться: выдвигается
семья: семьи семье
благородный: благородное благородной благородного
определение: определению
нередко: нередко
напряжение: напряжения
отвести: отведена
устрашать: устрашающего устрашающие
определнный: определнные определнных определнным
характеристика: характеристика характеристики характеристиками
быть: е будьте
выставка: выставках выставок
всеобщий: всеобщему
хитрый: хитрый
выставочный: выставочные выставочный
чрный: чрный
экземпляр: экземпляры экземпляров
заселять: заселять
самодисциплина: самодисциплина
нос: носу носа нос
полицейский: полицейских
заводчик: заводчик
около: около
зарождение: зарождения
роды: родов
следующий: следующие
год: годы годам лет год
пол: пола
акита-ин: акита-ину
пятно: пятна
джонсон: джонсона
очаровательный: очаровательного
домашний: домашнее домашними
заворот: заворот
внушительный: внушительный внушительные
тяга: тяга
порода: породе породам породы породами породу порода породой
отнестись: отнеситесь
нуждаться: нуждались нуждаются нуждается
спина: спине
погулять: погуляем
палец: пальцы
популяризация: популяризации популяризацией
яичко: яичек
сужаться: сужается
удаться: удалось удастся
раз: раза
видео: видео
помимо: помимо
гетерохромия: гетерохромия
начать: начать
течка: течка
защищать: защищая защищать
внимание: внимания вниманию внимание
улица: улицу улицах улице
требование: требованию
находиться: находясь
смелость: смелость смелости
расстояние: расстояние
жестокость: жестокость
царить: царила
участвовать: участвовали
нюх: нюху
близкий: поближе
нужный: нужна нужной
цениться: ценилось ценилась ценится
рацион: рациона рацион
усваиваться: усваивается
содержание: содержание содержанием содержания
девочка: девочка
колония: колонию колоний
отправиться: отправьтесь отправятся
представление: представления
основа: основой
слово: слово
сужение: сужение
заключнный: заключнным
пропорция: пропорциями
проявить: проявил
рельефный: рельефная
огромный: огромного
ноздря: ноздрями
одинаковый: одинаков
уснт: уснт
обхват: обхват
связь: связь
милый: милым
представлять: представляли
приобретение: приобретения приобретению
угол: углом угол
превышать: превышать
прыгать: прыгать
внешность: внешность
какой: какому какими каких
племна: племн
лоб: лба лоб
прогулка: прогулкам прогулку прогулки прогулок
великолепие: великолепии
от: ото
рабочий: рабочий рабочие рабочего
морда: морду морды мордой морда
приземистый: приземистые
подойдт: подойдт
обладать: обладают
наружу: наружу
жалобный: жалобными
яйцо: яйца
пасовать: пасует
дважды: дважды
давать: давать
игрище: игрищ
протирать: протирать
быков: быков
гремучий: гремучая
право: права праву
обычный: обычными
плотно: плотно
дойдт: дойдт
валерий: валерия
критический: критических
питомец: питомцу питомец питомцы питомца питомцем
крупный: крупный крупных крупного крупными крупные крупным
смотреть: см смотрите смотрел
друг: друзья друг другом друга другу друзьями
таганский: таганская
еда: едой
фотография: фотографии
широкий: широкие широкий широким шире широкими
километр: километр
ассоциация: ассоциациями
сумма: суммы сумму
уход: уходе уход
чтко: чтко
голубой: голубой
охранный: охранными охранные
знать: знать
отпугивать: отпугивает
помнить: помните
высокий: высокая высоким высокий
питомник: питомники питомниках
становиться: становитесь становится
верхний: верхней
поджимать: поджимает
глаз: глаза глаз глазами
правильный: правильными правильного правильном правильное
квадратный: квадратной
тактика: тактику
самый: самый самое
задорный: задорные
собственный: собственном
рычание: рычания
воротник: воротнике
девочкапроблема: девочкапроблема
корм: корм
вопреки: вопреки
человеческий: человеческой
век: века век веками
неприятный: неприятными неприятных
оскал: оскала
остальной: остальными остальное
поскольку: поскольку
прочий: прочие прочими
проявлять: проявляют проявлять
охотничий: охотничьи
существо: существо
краткий: краткая
весьма: весьма
выплата: выплаты
свой: своими своим свой своей своих своему свои
долгий: долгое долгие
отношение: отношение отношению
заболевание: заболеваниям заболевания
вкупе: вкупе
масса: массы массой
малыш: малышей малыш малыша
исключительно: исключительно
отметить: отметить
весь: весь всей всем
эксперт: экспертов
направить: направлены
недостаточность: недостаточность
драка: драки
справка: справку
вконтакте: вконтакте
постоянный: постоянной
старый: старый
рядом: рядом
скотт: скотта
вызвать: вызовет
пигментация: пигментацией пигментация
отменный: отменную отменным
сочетать: сочетает
сочетание: сочетание сочетании
переход: переход
веслый: веслый
дать: дать
корректный: корректной
тазобедренный: тазобедренных
ярко: ярко
примечательный: примечательны
роль: роль
компенсироваться: компенсировалось
хозяин: хозяин хозяином хозяину хозяина
далкий: далких
обойтись: обойдутся
средство: средств
животное: животных животным животного животными животное
сырой: сырую
фасоль: фасоль
сша: сша
длина: длины длина длину
побеждать: побеждали
спокойный: спокойным
выбрать: выбрать
амбуля: амбули амбуль амбуля амбулей амбулю
облик: облик
пс: пс
основать: основана
классический: классические классический классической
хотя: хотя
нижний: нижняя
запрыгнуть: запрыгнуть
х: х
недюжинный: недюжинная
проводить: проводили проводить
растение: растениями
искать: ищет
свый: свом
проведт: проведт
отличный: отличное отличные отличными
избежать: избежите избежать
который: которую которыми которой которого которая которых которые который
убить: убить
витамин: витаминов
пасть: пасть
необузданный: необузданный
проблема: проблемы проблема проблемой
закон: закон закона
познакомиться: познакомиться
серый: серая серый
середина: середины
глубокий: глубокие
выработка: выработку
перчатка: перчатка
мраморный: мраморный
квартира: квартире квартиры
наджный: наджный
малый: малейшие меньшим
соблюдать: соблюдайте
питбультерьер: питбультерьером
информация: информация
амнистия: амнистию
поставить: поставлена поставлены
расчистка: расчистке
любой: любую любое любой любом
будущее: будущем будущего
трижды: трижды
поиск: поисков поиск
передний: передними передние передних
негативно: негативно
выбор: выбор
истина: истину
забыть: забыв забыли
характер: характера характер
родословный: родословную родословная
окрас: окрас окрасы
бело-рыжий: бело-рыжий
юг: юга
воспринимать: воспринимать воспринимают
вплоть: вплоть
ладить: ладят
положиться: положиться
сухой: сухой
половина: половина
ребёнок: детям ребенком детьми
водный: водные
габарит: габариты
среди: среди
дом: дом доме
превосходить: превосходит
формирование: формированием
затруднительный: затруднительными
линия: линию линия линий линии
это: этим это
веко: веки
колено: колени
вскоре: вскоре
крепкий: крепким крепкое
брат: брата
считаться: считается считались
молосский: молосских
собаковод: собаководов
равняться: равняться
воспитанный: воспитанный
загрязнение: загрязнения
полный: полной полного
загривок: загривком
свободный: свободную
аллергия: аллергия
ключевой: ключевая
сполна: сполна
ничто: ничем
вырасти: вырастет вырос
развитый: развитый
покупатель: покупатели покупателю
вид: видом вида виду виде вид
освежать: освежающий
подпалина: подпалинами
собираться: собираетесь
тысяча: тысяч
режим: режима
вперд: вперд
скот: скотом
звать: зовут
независимый: независимый
улечься: уляжется
месячный: месячная
низкий: низкая
неоднократно: неоднократно
отсутствовать: отсутствовать
выгулеприходиться: выгулеприходится
добавить: добавьте
сильный: сильного сильные сильными
сложённый: сложены
травля: травлях травлей
умеренный: умеренная
происхождение: происхождения
периодичность: периодичности
задуматься: задуматься
необходимо: необходимо
готовый: готовы готов готовые
терьер: терьер
выходец: выходцы выходцев
первоначальный: первоначальные
задний: задние задними
лихой: лихих
дверь: дверь
асимметрия: асимметрия
разгром: разгрома разгром
черта: черты черте черта
агрессивный: агрессивный
кобель: кобеля кобели кобелей
генетика: генетики
вожак: вожака
пройдт: пройдт
бульдог: бульдога бульдогов бульдоги бульдог бульдогу
недорого: недорого
дрессировка: дрессировка
предплечье: предплечья
стандартный: стандартный стандартных стандартного стандартной
время: время времени
обходиться: обходились
сука: суки сук сука
отдельно: отдельно
агрессивность: агрессивность
осмотрительность: осмотрительностью
требовать: требует
включать: включают включать
день: дней дня день
противный: противном
сила: сила силы силу силе
просмотр: просмотров просмотра
взрослый: взрослого
использовать: используйте использовать
параллельно: параллельно
служебный: служебными
неожиданно: неожиданно
характерный: характерна характерны
речной: речную
мера: мере
потенциальный: потенциальную потенциальному потенциальных
отдельный: отдельные
клиновидный: клиновидную
вверить: вверенное
рост: рост
котон-де-тулеар: котон-де-тулеар
ответ: ответа ответов ответ
голова: головы голова
ежедневный: ежедневным ежедневных
потомство: потомство
согласно: согласно
собачий: собачьими собачьих собачьи собачий
экономический: экономическая
напоминать: напоминают
резко: резко
карапуз: карапуз карапуза
вычсывания: вычсывания
соответственно: соответственно
осознать: осознать
мясо: мясом мясо
реклама: реклама
выделять: выделяют
бой: бой боя боями бои
мускулатура: мускулатурой мускулатура
эксперимент: эксперимент
девяностый: девяностых
нестабильность: нестабильности
демонстрация: демонстрацию
парк: парк
выносливость: выносливостью выносливости выносливость
рекомендоваться: рекомендуется
мочка: мочки
готовить: готовим
спокойно: спокойно
имущество: имущество
привыкнуть: привыкнуть
достигать: достигает
протянуть: протянутую
здоровый: здорового здоровым здоровые
блестящий: блестящая
умалять: умаляло
голый: голый
оба: обоих
лапа: лапами лапы
сайт: сайту
мясной: мясной
выстраивать: выстраивают
длинный: длиннее длинный
родословная: родословной
щенячий: щенячьей
спа-процедура: спа-процедурам
активный: активный активным
мощный: мощная мощного мощные
понять: понять
конечность: конечностями конечностей конечности
мопс: мопса
стачиваться: стачивались
дорогой: дорогое
поднимать: поднимайте
ценный: ценное
питьевой: питьевая
этот: эта этих
лишь: лишь
вариант: вариант варианты
долго: долго
называть: называемый
экстерьер: экстерьер
ведение: ведения
форум: форум форуме
стоп: стопом
предпочтение: предпочтение
хотеть: хотят хотели
начало: начала начало начале
нисколько: нисколько
приемлемый: приемлема
образовать: образуя образует образуют
боль: боль
капля: капли
просьба: просьба
кругленький: кругленькую
место: месте
нежность: нежности
питать: питают
напротив: напротив
значительно: значительно
обеспечить: обеспечен
земля: земли землях
описание: описание
неукротимый: неукротимый
слабый: слабее слабая
потребоваться: потребоваться
состояние: состояния
показательный: показательные показательную
оттенок: оттенки оттенок
ускорить: ускорить
военный: военных
второй: второго
здоровье: здоровьем здоровье
владение: владения
найти: найти
однако: однако
голень: голеней
преданность: преданность преданности
бело-тигровый: бело-тигровый
поэтому: поэтому
орлов: орлова
многий: многими
коричневый: коричневый
случай: случаев случаях случае
копирование: копирование
нужда: нужду
короткий: короткий короткие короткой
придавать: придавали придают
безуспешный: безуспешными
захватить: захватить
активность: активность
подверженный: подвержены
закрытый: закрыта
дружелюбность: дружелюбность
печальный: печальный
равный: равна
незнакомец: незнакомцам
мама: мамой
прошмыгнуть: прошмыгнуть
плавно: плавно
отзыв: отзывах отзывы
телосложение: телосложению
смышлный: смышлным
рогатый: рогатым
кошка: кошки кошками
ореховый: орехового
коммуникабельность: коммуникабельность
отсутствие: отсутствии отсутствие
шум: шум
ярость: ярости
преклонный: преклонного
прочить: прочим
процедура: процедуры
отличие: отличие
щткать: щтку щтки
отразиться: отразиться
влажный: влажный
придться: придтся
значение: значение значения
выжить: выживших
назад: назад
преимущественно: преимущественно
планировать: планируете
покалечить: покалечить
поначалу: поначалу
цвет: цвет цвета
кость: кости
лечение: лечения
глазнка: глазнки
сердце: сердца
мочь: могут мог
локоть: локти
игра: играх
роза: роза
оставаться: оставались остается
америнаский: америнаский
завершиться: завершился
ухо: ушей уши
целое: целом
объявление: объявления
делать: делайте делать делают
сделать: сделать сделано сделало
основной: основные
результат: результатах
регистрировать: регистрировали
вода: вода воду
приоритетный: приоритетны
интеллект: интеллект интеллекту интеллектом
пробежка: пробежку
настороженно: настороженно
культура: культуры
вес: вес
устремляться: устремляясь
зелный: зелный
конец: конец
команда: командой команда
питание: питания
потратиться: потратиться
возраст: возраст возраста возрасте
коренастый: коренастый
лишний: лишнее
разведение: разведение
именно: именно
должник: должники
тмной: тмной
умирать: умирали
чрезмерный: чрезмерная
продолжительность: продолжительность
приходиться: приходилось
остаться: оставшийся
фермер: фермеры
член: членов
отлично: отлично
страна: страны страна
достат: достат
затылочный: затылочный
вряд: вряд
стать: стать станет
принадлежать: принадлежит
бобовый: бобовые
останавливать: останавливает
прийтись: пришлось
сохранять: сохранять сохраняют сохраняет сохраняли
продавец: продавца
озлобиться: озлобиться
система: системе
никак: никак
утром: утром
слегка: слегка
проявление: проявлениям
тренд: тренд
тмно-коричневый: тмно-коричневого
фото: фото
показать: показать
жестокий: жестокой
дерзать: дерзайте
маленький: маленького
м: м
вы: вами
пёс: пса
предъявить: предъявить
яндекс: яндекс
сопеть: сопит
напряжнный: напряжнная
спокойствие: спокойствие
полцентнер: полцентнера
угроза: угрозами угрозу
дуэт: дуэте
участие: участие
помт: помта
звериный: звериной
выглядеть: выглядеть выглядят
нечаянно: нечаянно
ребнка: ребнка
привычка: привычек
череп: черепа череп
неудобство: неудобства
прямой: прямую прямой
нрав: нрав нравом
социализация: социализации
сравнение: сравнении
отклонение: отклонение
холка: холке
вытянутый: вытянутый вытянутую
относить: относят
двор: дворе
официальный: официальной
журнал: журнал
умный: умного
четыре: четыре
высота: высота высоты
приготовиться: приготовьтесь
ответственно: ответственно
отвиснуть: отвисшими
фарш: фарш
треугольный: треугольная
иммунодефицит: иммунодефицит
неровный: неровная
внешний: внешнему внешним внешний
скучать: скучает
градус: градусов
огонь: огонь
благодарный: благодарен
уживаться: уживаются
покров: покров
болезнь: болезни
умение: умением
приятный: приятным
отказаться: откажитесь
кормить: кормят
кровавый: кровавых
один: одной одному
подходящий: подходящими
думать: думать
сторона: сторона сторону
совершенно: совершенно
приобретать: приобретая
охранять: охраняемые
помогать: помогают
белый: белого белый
весомый: весомые
символ: символа
скоординировать: скоординированные
привезти: привезли
сжатый: сжаты
безграничный: безграничную
двух-трх: двух-трх
полтора: полутора
немногие: немногие
рассматривать: рассматривать
амбуля-девочка: амбуля-девочку
послушный: послушный
корпус: корпуса корпусу корпус
плохо: плохо
глухота: глухота
движение: движения
терпение: терпение
перекус: перекус
висеть: висящими
сородич: сородичами
резкий: резкое
неокрашенный: неокрашенные
запрещать: запрещал
несокрушимый: несокрушимую
грозный: грозный
развитой: развитой
броситься: броситься
перейти: перейти
переезд: переездом
сходство: сходств
тюрьма: тюрем
сгодиться: сгодится
проверить: проверенных
главное: главное
послать: пошли
коготь: когтей когтях
большинство: большинством большинстве
менее: менее
тот: тех тому той
разделить: разделили
бова: бов
покрывать: покрывать
чистый: чистым чистой
недостойный: недостойными
болезненный: болезненной
создать: создаст
собрат: собратьев
город: городов
усугубить: усугубит
одиночество: одиночеству
приливать: приливали
дружелюбие: дружелюбие
стандарт: стандарта стандарту стандарт
кой: коем
молочный: молочными
мелкий: мелкие
путаница: путаницы
объясняться: объяснялась
подписание: подписания
привет: привет
схватка: схватки схватке
подобный: подобные
мускулистый: мускулистая
небольшой: небольшие
спровоцировать: спровоцировать
оценка: оценке
рубль: рублей
появиться: появились
жажда: жажду
импозантный: импозантная
разбавлять: разбавляйте
вечером: вечером
оказаться: окажется оказаться оказались оказалось
жить: жила живут
неплохо: неплохо
отражаться: отражается
трх: трх
опасность: опасность опасности
уверенность: уверенности уверенность
слабо: слабо
ляшенко: ляшенко
шерстяной: шерстяной
варьироваться: варьируется
витаминно-минеральный: витаминно-минеральным
южный: южный
скрывать: скрывает
тучный: тучный
часовой: часовую
стоимость: стоимость
некипячёный: некипяченой
подойти: подойдут
самочувствие: самочувствии
иначе: иначе
особенно: особенно
отметина: отметины
автоматически: автоматически
вынужденно: вынужденно
достаться: доставшимися
выводить: выводите
своевременный: своевременного
такой: такого таким
трусливо: трусливо
хладнокровие: хладнокровие
достаточно: достаточно
затея: затеи
костный: костной
титул: титул
понимать: понимает
доминировать: доминировать
выступление: выступления
прилегать: прилегают
сложность: сложности
нарушить: нарушить
бдёр: бдер
инцидент: инцидентов
психический: психической
свинина: свинину
избавить: избавят
мошонка: мошонку
угощать: угощать
заложить: заложена
косвенно: косвенно
нагрузка: нагрузках нагрузкам
неделя: неделю
узник: узники
возвращение: возвращении
переходить: переходят
храбрый: храброго
диск: диски
лишать: лишать
европа: европы
подарить: подарит
пять: пять
надеяться: надеялись
поводок: поводке поводок
обстоятельство: обстоятельствах
англия: англии
руби: руби
белок: белков
несмотря: несмотря
купить: купить купили
плотный: плотный
часто: часто
пользоваться: пользуется
улучшение: улучшению
заняться: займитесь
первый: первый первых
живой: живое
допускаться: допускаются
проходить: проходит
некоторый: некоторое
желание: желание
сабина: сабина
грудной: грудной
отдаваться: отдавалось
что: чему
разводить: разводили
причина: причины
период: периоды период
предать: преданный
окрасить: окрашен
лужа: луж
злодей: злодея
завоевать: завоевал
басенджи: басенджи
клуб: клубы
верность: верность
наличие: наличие
клетка: клетки
наигранный: наигранными
косоглазие: косоглазие
наименование: наименования
тянуть: тянуть
выдержать: выдержать
одноклассник: одноклассники
укорачивание: укорачивания
славиться: славится
бесцеремонный: бесцеремонный
вс: вс
кожный: кожные
трудолюбие: трудолюбию
прививкичип: прививкичип
дисплазия: дисплазия
ведомство: ведомств
медный: медные
софия: софия
случайный: случайные
кроме: кроме
хлеб: хлеб
взять: взять
амбулев: амбулев
трубчатый: трубчатые
навык: навыками
защитный: защитном
держаться: держится
частый: чаще
накопиться: накопившуюся
отход: отходом
идеальный: идеальный
зуб: зубы
очертить: очерченной
волосок: волосков
душа: душ
себя: собой
суждено: суждено
помощь: помощь
общительный: общительный
определять: определяли
представить: представлен
тигровый: тигровый
атлетический: атлетическому
труба: трубы
ранний: раньше
потребность: потребность
килограмм: килограммов
смесь: смесь
периодически: периодически
горох: горох
порок: пороки
уметь: умеет
живт: живт
повод: повод
занять: занял
предок: предков
вовсе: вовсе
достигнуть: достигли
линька: линьки линька
доводить: доводили
жизнь: жизни жизнь
два: двух
современный: современных
ложный: ложными
забывать: забывайте
южанин: южанам
рука: руку рукой
наполнять: наполнять
скакательный: скакательных
самоотверженный: самоотверженного
благодаря: благодаря
уйти: уйти
праздник: празднику
плечо: плечи
длительный: длительных
оттого: оттого
впервые: впервые
воспитывать: воспитывать
наш: нашего
шоу: шоу
нужно: нужно
мимимишность: мимимишности
поймт: поймт
настойчивость: настойчивость
также: также
настроение: настроение
виднеться: виднеться
иностранный: иностранным
спутник: спутники
момент: моменты момент
свидетельствовать: свидетельствует
сквозь: сквозь
площада: площад
кончик: кончику
клык: клыки
депигментация: депигментация
умеренно: умеренно
оставлять: оставляет
изначально: изначально
высоко: высоко
агрессия: агрессию
ответственный: ответственному
уравновешенность: уравновешенность
подходить: подходят
смочь: смогут
лакомство: лакомства
сложно: сложно
складка: складки
любимый: любимую
стоить: стоит
массивный: массивные массивной
эпилепсия: эпилепсия
любимец: любимец
правительство: правительство
любить: любит
разводчик: разводчики
заслужить: заслужил
ножницеобразный: ножницеобразный
зависеть: зависит
порка: порок
усилие: усилиям
вполне: вполне
заставлять: заставлять
способный: способен
исход: исход
отстаивать: отстаивать
колонист: колонистам
невероятный: невероятным невероятную
допускать: допускайте
проварить: проваренном
позволять: позволяйте позволять
легко: легко
проект: проект проекте
манера: манера
сохранить: сохранить
лента: ленту
бык: быками
специальный: специальную специальный
содержать: содержали
неотваренный: неотваренные
обстановка: обстановка
шрстка: шрстка
дефект: дефектом дефектам
почтный: почтный
слепота: слепота
помещение: помещение
устраивать: устраивает
уверить: уверены
снизиться: снизилась
безопасность: безопасности
подтверждать: подтверждали
главный: главную главная
воздух: воздухе
передаться: передаться
игрушка: игрушку
чутьм: чутьм
подоконник: подоконник
пит-бульдог: пит-бульдог
заплатить: заплатить
локтевой: локтевых
продукт: продуктами продукты
желать: желая
вакансия: вакансии
прямо: прямо
вычсывать: вычсывать
уверенный: уверенному
этап: этапа
тридцать: тридцать
сбежать: сбежать
находить: находили
покладистость: покладистостью
прикус: прикус
забавно: забавно
знакомство: знакомство
начинаться: начинается
конверт: конверт
покорить: покорила
воинственный: воинственных
рысь: рысь
чистокровный: чистокровных
сей: сей
независимость: независимости
таковой: таковой
выше: выше
испанец: испанцев
скалиться: скалиться
единственный: единственное
уводить: уводят
ватный: ватные
вместе: вместе
ещ: ещ
посадить: посажены
навалиться: навалиться
пройти: пройти пройденный
применение: применение
комнатный: комнатными
катаракт: катаракта
сутки: суток
полгода: полугода
кокер-спаниель: кокер-спаниель
рейтинг: рейтинг
организовать: организованы
уникальный: уникальна
похвастать: похвастать
цель: целей
возникнуть: возник
независимо: независимо
подписываться: подписывайтесь
соответствие: соответствием
чемпион: чемпиона
неприхотливый: неприхотлива
недостаточно: недостаточно
появляться: появлялись
переносить: переносить
резиновый: резиновая
вновь: вновь
травить: травлю
бесстрашно: бесстрашно
комплекс: комплексом
запретить: запрещено
придерживаться: придерживайтесь
привлекать: привлекает
особь: особей
очень: очень
несладко: несладко
минута: минуту
особенность: особенности
тврдость: тврдость
нога: ногах
подразделяться: подразделяется
кличка: клички
правило: правила
француз: французов
купировать: купировать
прежде: прежде
держать: держать
список: список
касаться: касается
закрепиться: закрепилось
откликнуться: откликнулась
премоляр: премоляра
переполнять: переполняли
терпеть: терпят
федеральный: федеральный
горшок: горшки
врожднный: врожднная
отдать: отдать
натягивать: натягивать
удержать: удержите
джорджинский: джорджинский
кг: кг
демонстрировать: демонстрировали
вариативность: вариативность
необходимость: необходимости
темперамент: темперамента
чувствовать: чувствуешь
секатор: секатор
идти: идти
обводка: обводки
превосходный: превосходными превосходному
обладатель: обладателей
тмный: тмные
ход: ход
штопор: штопором
индейский: индейских
берег: берегов
прекрасный: прекрасные
справлять: справлять
осложнять: осложняла
развитие: развитию
сустав: суставов
использоваться: использовались
развить: развитая
незаменимый: незаменимыми
основание: основанием
наблюдательность: наблюдательностью
глубина: глубине
умело: умело
бросаться: бросается
оценить: оценит
вывести: вывели
бугор: бугор
охрана: охране
ожидание: ожидании
расставить: расставлены
являться: является
слух: слухом
хвост: хвост
последний: последней
губа: губы
принимать: принимают
трусливость: трусливость
манёвр: маневрами
кит: кита
жлтый: жлтый
допустимый: допустима
площадка: площадок
сердечный: сердечная
натянутый: натянутым
безупречно: безупречно
неопущение: неопущение
лежать: лежащий
диана: диана
уделить: уделить
свидетельство: свидетельство
шаг: шаг
палочка: палочки
