движение: движениями движение движения движении
радость: радостью
попытка: попытке
существование: существование
овощ: овощи
противник: противника
тело: тела
выпадать: выпадает
мучной: мучное
средний: средняя среднее средних средней средние
популярность: популярности популярность
смириться: смириться
опыт: опыт опыта опытом
необходимость: необходимость необходимости
напоминать: напоминали
агрессия: агрессия агрессии
майорский: майорский
здоровый: здоровых здоровый здоровой
пугать: пугает пугающие
четвероногий: четвероногих четвероногого
восходить: восходит
следить: следить
участвовать: участвовать
отбор: отбор отбору
красный: красный
сколько: сколько
своевременный: своевременной своевременное
склонный: склонен склонны
предоставить: предоставить предоставьте
название: название названием названия
роль: роли роль
прошлое: прошлое
неравный: неравной
растительный: растительного
утрехтский: утрехтский
перерасти: переросли
переставлять: переставляя
справляться: справляются справлялись
физический: физических физические
обсуждение: обсуждения
предпочтительный: предпочтителен
приветствоваться: приветствуется
оно: оно
чувствительность: чувствительность
английский: английских английского
цена: цена ценой
дозировка: дозировки
рыба: рыбу рыба
псиный: псины
подушечка: подушечки подушечек
вмешательство: вмешательство
мастиф: мастифы мастифа мастиф мастифов
материал: материалов материалом
перевод: переводе
поперечно: поперечно
быть: будучи е будь
щетина: щетиной
испания: испания испании
казаться: кажется
предотвратить: предотвратить
представлять: представлял
обратить: обратите
мальорский: мальорский мальорского
владелец: владельцам владельца владельцев владельцу владельцы
книга: книги
регулярный: регулярное регулярный
указывать: указывали
анатомия: анатомия
стоять: стоят
любовь: любовь
морской: морская
сторона: стороны
испанец: испанцы испанцев испанцами
игра: игру игр играх игры
инстинкт: инстинкты
активизироваться: активизируется
ускоренный: ускоренному
субпродукт: субпродукты
поголовье: поголовье
холка: холку холки холке
россия: россия россии
тореадор: тореадора
раковина: раковины
миска: миска
забыть: забудьте
услуга: услугам
обратный: обратная обратную
каталанский: каталанского
приблизить: приближена
маленький: маленьким маленькие меньше мала
великобритания: великобритании
длительный: длительные длительных
размер: размеров размерах размеры размерами размеру
радужка: радужки
первоначальный: первоначальный
воздержаться: воздержаться
предварительно: предварительно
начинающий: начинающими
представитель: представителей представитель представители
получить: получивших получить
охранный: охранных охранные
занятие: занятий
шея: шея шеи
предплечье: предплечий
отмечать: отмечают
вкус: вкусом
дальнейший: дальнейшее дальнейшем
шерсть: шерсть шерсти
выразить: выражены выражена
запрет: запрета
кинолог: кинологи кинологом кинологу
качество: качеств качестве качество качествам качества
источник: источника
челюсть: челюсти
небольшой: небольшого небольших небольшую небольшим
должный: должны должен
воспитание: воспитания воспитание воспитании воспитанию воспитанием
нетипичный: нетипичные
случайно: случайно
проживать: проживало
кукурузный: кукурузного
главный: главной главная
наполнить: наполненная
цилиндр: цилиндра
исключение: исключение
король: король
проконсультироваться: проконсультироваться
посадить: посажен посажены
смочить: смоченные
разница: разницу разница
долголетие: долголетия
дсон: дсны
человек: людям людей человеку человек
месяц: месяц месяца
питомец: питомцами питомцев питомец питомцам питомца питомцем
относиться: относится относиться относятся
терпеливо: терпеливо
тонкий: тонкий
завезнный: завезнные
столь: столь
некоторый: некоторых некоторым
элемент: элементами
шрстный: шрстного шрстный
требоваться: требовалось
включая: включая
залом: заломов
обязательный: обязателен
привть: привл
гильотинный: гильотинного
путм: путм
важно: важно
превратиться: превратится
формула: формулы формулу
жесткошрстный: жесткошрстных
способствовать: способствует
щёлочь: щелочей
история: история истории
щенок: щенка щенков щенки щенок щенкам
таить: таят
видно: видно
белок: белка
выгул: выгул
перро: перро
успешно: успешно
тампон: тампоны
проявлять: проявляет проявляют
телохранитель: телохранители
подразумевать: подразумевал подразумевает
инфекция: инфекциями
форма: форма форму формы
голова: голове головы голова
чувствовать: чувствуют чувствуете
кисломолочный: кисломолочные
семья: семьи семью семья
насыщенный: насыщенные
определение: определению
льняной: льняного
выпуклый: выпуклые
характеристика: характеристика
стоп: стоп
исключить: исключите
выставка: выставках выставки выставке
несколько: несколькими нескольких
помощь: помощью помощи помощь
чрный: чрный чрную
экземпляр: экземпляры
выступать: выступает
заводчик: заводчик заводчиком заводчика заводчики
около: около
роды: родов
год: годы лет год гг году
пол: пола
пятно: пятна
война: войны войне
возлагать: возлагали
удалить: удалите
камень: камня камень
залог: залог
перевоспитание: перевоспитанию
зкс: зкс
коготь: когти когтей
тщательный: тщательной тщательного тщательном
кандидат: кандидатов
стать: стала станут стали стало стать станет
появление: появление появления появлению
вывернуть: вывернуты
диктовать: диктовать
маска: маска
возможный: возможных возможные возможное возможна
балеар: балеары
яичко: яичек
менять: меняет
первый: первой первые первого первый первую
сужаться: сужается
основное: основном
ложка: ложку
помимо: помимо
видео: видео
выносливый: выносливым
полноценный: полноценного
защитить: защитить
стремиться: стремятся
организовать: организовать
конструктор: конструктор
меню: меню
полностью: полностью
очередь: очередь
вода: воды воде
президент: президент
смысл: смысл
компания: компании компанией
способный: способно способен
передвигаться: передвигаются передвигаться
колоссальный: колоссальные
распространнный: распространнным распространнное распространнному
капуста: капусту
позаботиться: позаботьтесь
пятнадцать: пятнадцать
чай: чай
робкий: робкое
косточка: косточками косточек
рацион: рациона рацион
собака: собаками собак собака собакам собаке собаки
называть: называют называемую
служить: служат
содержание: содержание содержанием содержания
одобрительный: одобрительную
дегельминтизация: дегельминтизации
вливаться: вливаются
когтереза: когтереза
важный: важен важный
представление: представления представлений
аналог: аналог аналогов
регистрация: регистрация
универсальный: универсальными универсальные
мощный: мощный мощной мощная мощными мощные
получать: получая получают
рекомендовать: рекомендуют
рельефный: рельефная
путь: путь
окрас: окраса окрас окрасу
запомнить: запомните запомнить
ветеринар: ветеринару
хайме: хайме
арагонский: арагонским арагонский
ушной: ушные ушными
занимать: занимают занимает
обхват: обхват
территория: территорию территории
связь: связь
обернуться: обернуться
поиск: поиски поиск
приподниматься: приподнимаются
выделять: выделять выделяют
пиренейский: пиренейских
польша: польши
угол: углом
тракт: тракта
количество: количествах количеством количество количестве
прослеживаться: прослеживается
минимум: минимуму
тмный: тмный
майоркский: майоркского майоркский майоркских майоркские
верный: верных верного
частный: частном
племенной: племенная племенной
избавить: избавите
пока: пока
осмотр: осмотру осмотр
процесс: процессы
жилистый: жилистые
индейка: индейки
барселона: барселоне
морда: морду морды морда
взаимодействие: взаимодействия
подойдт: подойдт
программа: программа
яйцо: яйца
вязка: вязки вязку
многочисленный: многочисленной многочисленные многочисленных
погода: погода
покраснение: покраснения
нежность: нежностью нежность
старый: старую
уровень: уровнем уровня
стиль: стиля
быков: быков
складка: складку складки
привычный: привычных
подтянутый: подтянута
плотно: плотно
причина: причина причиной
проверить: проверить
уважать: уважают
питьевой: питьевой
ликвидировать: ликвидировать
формировать: формируют
дурной: дурного
птица: птиц
бывать: бывают бывает
крупный: крупный крупных крупнее крупную крупному крупнейшем крупные
смотреть: см
крепко: крепко
иммунитет: иммунитетом
превышать: превышает
замедлить: замедленного
свинина: свинина
фотография: фотографии
широкий: широкие широкий широким шире широкая широкое
помогать: помогает
дания: дании
окружность: окружность окружностью
достигать: достигая достигает достигают
молосса: молосса молоссы
уход: уходе ухода уход
современный: современные современного современных
создание: создания
титул: титулом титулах
губа: губа
вариант: вариантов вариант варианты
выработка: выработки
результат: результат результатом
незаметный: незаметен
питомник: питомники питомниках питомников
пара: пары пара
возникнуть: возникла
взрослый: взрослой взрослыми взрослых
благоприятно: благоприятно
отдавать: отдавать
выбирать: выбирайте выбирая
глаз: глаза глаз
связанный: связанных
рогатый: рогатый
позиция: позицию
затруднять: затрудняя
корм: корм кормом корма
вопреки: вопреки
самый: самым
сопровождение: сопровождении
часть: части часть частям
дый: дого
элитный: элитной
травля: травле травли
поинта: поинты
век: века веке веками
майорк: майорка
неприятный: неприятными неприятного
упоминаться: упоминаются
мир: миром миру
слово: словом
поскольку: поскольку
охотничий: охотничьи
арена: арену
краткий: краткая
выбраковать: выбракованные
весьма: весьма
компаньон: компаньона
вой: воем
профилактический: профилактической профилактический
любой: любого любой любом
отношение: отношение отношений отношению отношения
заболевание: заболеваниям заболеваний
желательный: желательны
место: место
образовать: образующая образуя
малыш: малышей малыша
приводить: приводит
вассал: вассалом
сородич: сородичам
край: края
отметить: отметить
эксперт: экспертов эксперта
купать: купать
подвергаться: подвергались подвергаются
вконтакте: вконтакте
финляндия: финляндии
рядом: рядом
впечатление: впечатление
профилактика: профилактика
великан: великан
кровожадность: кровожадности
создать: создать
сочетать: сочетает сочетают
специалист: специалистом специалист специалиста
видный: виден видны
особь: особями особи
обрамлять: обрамляющая
примечательный: примечательны
быстрый: быстрому
обойтись: обойдутся обойтись
шубка: шубки
закруглнный: закруглнные
животное: животных животным животного животные животное
сырой: сырую сырая
фасоль: фасоль
уникальный: уникальная
одинаково: одинаково
пропорциональный: пропорциональна
спрессовать: спрессованных
сша: сша
земля: земле
чреватый: чревато чреваты
склонность: склонностью склонность
характер: характером характер
делить: делят
длина: длины длина
шпиц: шпиц
воцариться: воцарившуюся
спокойный: спокойным спокойные
светлый: светлая светлый
выбрать: выбрать
грамотный: грамотной
надломить: надломлены
кусочек: кусочки
скула: скулы
пс: пс
желание: желании
кровать: кровать
защитный: защитный
городской: городскому
основать: основана основали
впечатлять: впечатляют
хотя: хотя
положить: положил
нижний: нижняя нижними
продукт: продуктов продукты
охранник: охранника
стачиваться: стачиваются
х: х
расстояние: расстоянии
определиться: определитесь
погибать: погибали
общепринятый: общепринятой
деформация: деформацией
сомкнутый: сомкнутой
внешний: внешних внешний
включать: включавшую включает
установить: установить установит
который: которую которое которой которого котором которая которым которые которому который
миозит: миозит
анфас: анфас
жареный: жареную
атмосфера: атмосферу
одержать: одержал
грубый: грубых
знакомиться: знакомится
порода: породам породы пород породу порода породой
жестокий: жестокий жестокие жестокому
середина: середины середине
пластичность: пластичностью
глубокий: глубокие
площадь: площади
мраморный: мраморный
квартира: квартире
аллергия: аллергию аллергия
плод: плоды
информация: информация
местный: местными
хэндлера: хэндлера
друг: друг другом друга
отдать: отдадите
защитник: защитников
масса: масса массе
человеческий: человеческих человеческое
натуральный: натуральный натуральной натуральных натуральную натуральному
тесный: тесный
пищеварительный: пищеварительного
палец: пальцами пальцев палец
будущее: будущем будущим будущего
увеличить: увеличит
отправиться: отправится
проводить: проводить
сначала: сначала
спинка: спинка
универсальность: универсальность
клуб: клуба
передний: передними передние передних
ниже: ниже
приложить: приложить
такой: такое такого таким
конец: концу конец
ежедневный: ежедневный ежедневному
крепкий: крепкие крепким крепкая крепкой крепких
подходящий: подходящий подходящими подходящим
пожилой: пожилая
вздрнуть: вздрнутой
сухой: сухой сухие сухая
идеальный: идеальными
польза: пользу
низкий: низким низкая
ребёнок: детям детей
габарит: габариты габаритами
семейный: семейная
среди: среди
дуга: дуги
неагрессивный: неагрессивны
спать: спать
тычок: тычками
равномерный: равномерным
линия: линию линия линии
последовательно: последовательно
колено: колени
новый: новых новую новыми новой
бомба: бомбу
разведение: разведении
сформировать: сформированы
молосский: молосских молосской молосские
подход: подходе подход
психологически: психологически
полный: полной полным
затылочный: затылочного
просто: просто
вырасти: вырастет
недуг: недугам
чуткий: чуткий
выйти: выйти
одиночество: одиночестве одиночеством одиночеству
частый: частые частых чаще
вынужденный: вынужденным вынужденном
бульдожий: бульдожью
тысяча: тысяч
принять: принято
мужественный: мужественных
час: часа часов
учитывать: учитывая
проследить: проследите
сертификат: сертификат
вперд: вперд
вписать: вписали
фрукт: фрукты
чета: чета
неконтролируемый: неконтролируемый неконтролируемые
мировой: мировой
темперамент: темпераменту
сука: суками суки сук суку
заменить: заменить
женский: женского
окружающие: окружающим
сердце: сердцем сердце
усилие: усилия
бык: быка быку
контакт: контакт
локоть: локтей локти
добавить: добавьте
здоровяк: здоровяка
прогулка: прогулки прогулок
обязанность: обязанностями
предрасположенность: предрасположенность
жилой: жилых
собачий: собачьим собачьих
умеренный: умеренная
происхождение: происхождения происхождение
резец: резцы
задуматься: задуматься задумались
трусоватость: трусоватость
необходимо: необходимо
мм: мм
крестец: крестце
остановиться: остановитесь
заблуждение: заблуждению заблуждение
задний: задние задних задней
звоночек: звоночки
колония: колонией
бдра: бдра
редкий: реже редких
незаменимый: незаменимым
ситуация: ситуация
кобель: кобеля кобели кобелей кобелями
вакцинация: вакцинации
разрез: разрез
набор: набору
ничтожно: ничтожно
дрессировка: дрессировка дрессировки
время: время времени временем
прикрыть: прикрыв
оттаивать: оттаивает
плохой: хуже
трусливый: трусливых
агрессивность: агрессивность
остров: острова островов
устроить: устроить
великолепный: великолепные великолепным
полость: полость
нежеланный: нежеланного
защищать: защищать
требовать: требует требуют
день: дней дня день
вес: веса вес
наносить: наносили
балеарский: балеарский балеарские балеарских
другой: другие других
жлтая: жлтая
американский: американский американского
хозяин: хозяином хозяина хозяева
ротовой: ротовая
использовать: используйте использовали использовать
высокий: высоким высокий
терпение: терпения терпением
мастиф-охранник: мастифы-охранники
радикальный: радикальный
избежание: избежание
речной: речную
неприспособленный: неприспособленными
мера: мере
категория: категории
комфортно: комфортно
потенциальный: потенциальную потенциальных
отдельный: отдельные
соответствовать: соответствующий
участник: участниками участниках участникам
следующий: следующим
маникюр: маникюр
проверять: проверяйте
рост: рост роста
скрытый: скрыты
согласно: согласно
правильный: правильном
функция: функции
охранно-бойцовый: охранно-бойцового
реклама: реклама
соответственно: соответственно
окружающий: окружающему
наклон: наклоном
дождться: дождтся
базовый: базовые базовым
снисходительность: снисходительностью
флегматичный: флегматичный
закрепить: закреплены закреплена
мускулатура: мускулатурой мускулатура
второй: второй
ягода: ягоды
пик: пике пик
процедура: процедуру процедур процедуры
покладистый: покладистым покладистыми
рекомендоваться: рекомендуется
пигментация: пигментация
обращать: обращая
займт: займт
смахивать: смахивающими
конус: конуса
один: одно одной одну одному
атаковать: атаковать
западный: западной
работа: работы работа работу
повредить: повредить
одиннадцать: одиннадцать
дружелюбный: дружелюбны дружелюбная дружелюбный
уменьшаться: уменьшалась
влиять: влияют
правильно: правильно
добавлять: добавлять
неосторожный: неосторожное
неизгладимый: неизгладимое
метис: метисы
лапа: лапами лапы
задача: задачу
сайт: сайту
мой: мои
родословная: родословной
позволять: позволяет позволяйте
активный: активный активен активны активными
занять: занять
получаться: получаются
внутренний: внутренних
число: числу числе
скрываться: скрывается
дорогой: дорогое
кожа: кожа кожи
купировать: купированные
лишь: лишь
досуг: досуга
медведь: медведей
долго: долго
борзая: борзых
железный: железным
европейский: европейскому европейских
домашний: домашним
форум: форум форуме
немецкий: немецкого немецкие
ка-де-бестиара: ка-де-бестиар
предпочтение: предпочтение
супружеский: супружеская
белка: белки
искусство: искусстве
паспорт: паспорт
последствие: последствиям последствиями
действие: действия
желза: желз
тяжело: тяжело
живой: живых
розовидный: розовидная
портовый: портовых
небрежный: небрежное
пигментировать: пигментирована
мясо: мяса мясо
верхний: верхними верхние верхняя
показ: показа
значительно: значительно
догадываться: догадываются
шоу-класс: шоу-класса
описание: описание
начало: начало началу начале
мужской: мужского
пространство: пространство
оценивать: оценивать
стандарт: стандартом стандарта стандарту стандарт
состояние: состояния
скрестить: скрестили
подниматься: поднимается
оттенок: оттенки оттенок
агрессивный: агрессивных агрессивное
параллельный: параллельна параллельны
налта: налта
доверительный: доверительные
травильный: травильных
гигиена: гигиены
приступать: приступать
драка: дракой
плут: плут
здоровье: здоровьем здоровье
округлый: округлые
намеренный: намеренной
зубной: зубного зубную зубной
стоячий: стоячие
глубоко: глубоко
длинный: длинный
жестковатый: жестковатая
принести: принесла
однако: однако
коллектив: коллектив
удивительный: удивительное
удобный: удобной удобный
состоять: состоять
внушительный: внушительные внушительную
дело: делу деле
преданность: преданность
разрешение: разрешению
отличаться: отличаются отличались
поэтому: поэтому
нежирный: нежирной
пилочка: пилочка
ультиматум: ультиматума
копирование: копирование
кровавый: кровавый кровавых кровавого
победа: победу
активность: активность
основание: основания основание
дружелюбность: дружелюбность
ощупывание: ощупывание
равный: равна
незнакомец: незнакомцам незнакомцу
доступ: доступ
премоляр: премолярами
неплотный: неплотная
плавно: плавно
спортивный: спортивных
отзыв: отзывах отзывы
заключаться: заключается
кошка: кошки кошкам
нбе: нбе
хэндлинга: хэндлинге хэндлинга
толкнуть: толкнуть
животный: животному
шум: шум
висячий: висячие
постав: поставом постав
уборка: уборки
крайний: крайнем
преследовать: преследуете
показать: покажет
баланс: баланс
аристократ: аристократами
тврдый: тврдые
отличие: отличие
минимальный: минимальной
щткать: щтку щтки
представительный: представительные
тигровый: тигрового тигровый
допустимый: допустимо допустимы допустима
придться: придтся
актуально: актуально
испанский: испанских испанские испанское испанского
преимущественно: преимущественно
цвет: цвет цвета
резвиться: резвясь
клиника: клинику клинике
кость: кости
интерес: интерес
осторожно: осторожно
дом: дома доме
хороший: лучшие
выходить: выходил
принятие: принятия
формат: формата форматом
смена: смены
видеть: видеть видят видит
зазубрить: зазубренные
заусеница: заусеницы
огромный: огромную огромным
справка: справки
объявление: объявления
сделать: сделать сделано
бульдог: бульдогов бульдоги бульдог
говядина: говядины
основной: основные
награда: наградах
полова: половой
диагональ: диагонали
мячик: мячик
родитель: родителями
интеллект: интеллект
конечность: конечностей конечности
помочь: помогут поможет
благородный: благородный
питание: питания
спросить: спросите
швеция: швеции
помощник: помощниками
возраст: возраст возрасте
ежедневно: ежедневно
шишка: шишка
нос: носа
житель: жителями жители
разделна: разделн
свой: своим своей свои
жировой: жировой
банный: банный
добрый: доброе добрым
немногочисленный: немногочисленных
дополнение: дополнением
вопрос: вопросах
признак: признакам
именно: именно
разработать: разработали
умирать: умирали
улица: улице
продолжительность: продолжительность
плотный: плотными
усилить: усилит
влажный: влажной
вещь: вещами
курс: курс
лидер: лидере
благоприятствовать: благоприятствует
расположить: расположенные расположены
близкий: близких близкое
трезво: трезво
гладиатор: гладиаторов
завоеватель: завоеватель
дисквалифицировать: дисквалифицируют
выяснение: выяснение
зуб: зубами зубы зубов
опустить: опущен
полугодовалый: полугодовалый
шампунь: шампунь
пройдоха: пройдоха
развитие: развития
почтный: почтным
зависимость: зависимости
альмохадский: альмохадскими
никак: никак
слегка: слегка
тот: те тех тому той
оберегать: оберегали
любимый: любимая любимого
больший: большую
насадка: насадку
бутилировать: бутилированной
купание: купание
солдат: солдаты
фото: фото
прибылой: прибылых
безоружный: безоружный
заострить: заострена
староанглийский: староанглийские староанглийских
ласковый: ласковыми
ран: ран
яндекс: яндекс
почитаться: почитался
арагонец: арагонцами
сладкое: сладкое
инородный: инородных
обращение: обращение
ротвейлер: ротвейлер
барабанный: барабанные
дефект: дефект дефектов
сосед: соседа соседей
грызун: грызунов
собственный: собственной
помт: помта
участие: участие
резиновый: резиновые
ребнка: ребнка
оставлять: оставлять оставляли
собаковод: собаководы собаководами
череп: черепа череп
рыцарь: рыцарь
выхаживать: выхаживали
подпольный: подпольном
социализация: социализации
сравнение: сравнении
атака: атаку
подсолнечный: подсолнечного
поведение: поведением поведение
отклонение: отклонение
делать: делая делать делает делают
поочердно: поочердно
первичный: первичному первичные
фрисби: фрисби
скрыть: скрыть
относить: относят
экстерьер: экстерьеру
взгляд: взгляде
журнал: журнал
тяжлый: тяжлые
четыре: четыре
сдержать: сдержанные
кадебошка: кадебошка
высота: высота высотой
удлиннный: удлиннным удлиннными
укорачивать: укорачивайте
предстоять: предстоит
государство: государств
минута: минуты
нуждаться: нуждаются нуждается
фундамент: фундамент
уголок: уголков
определить: определить
пища: пищу
отсутствие: отсутствия отсутствие
пищеварение: пищеварение
еженедельно: еженедельно
покров: покров покрова
болезнь: болезни
вызвать: вызвать
приятный: приятным
уточнение: уточнения
доминировать: доминирующую
малый: меньшей малейшее
начинать: начинать
новороссийскийкинологическийцентр: новороссийскийкинологическийцентр
смываться: смывается
кислота: кислот
идея: идеями
привезнный: привезнные
овальный: овальной овальными
гляделка: гляделки
подвижность: подвижностью
заметный: заметна заметны
очевидный: очевидное
радоваться: радоваться
подсушивать: подсушивающим
дешёвый: дешевле
наклонный: наклонный
нюанс: нюансов
селекция: селекции
обучить: обучил обучить
подвес: подвеса
прилегать: прилегает прилегают
немногие: немногие
пусть: пусть
воспитанный: воспитанного
пахнуть: пах
охрана: охраной
дать: данные
корпус: корпуса корпусу корпус
подвижный: подвижны
недюжинный: недюжинной
перекус: перекус
сумма: сумму
диморфизм: диморфизм
сушить: суши
труд: труда
этап: этап
грозный: грозный
жирный: жирное
броситься: броситься
перейти: перейти
чрной: чрной
своенравный: своенравны
ваш: вашей ваш вашего
из-за: из-за
дог: догов дог
стереотип: стереотипов
своенравие: своенравие
англичанин: англичан англичане
частица: частиц
закончиться: закончиться
воспитывать: воспитывая
собранный: собранными
рыхлый: рыхлая
весомый: весомый
менее: менее
увеличение: увеличением
ген: генов
ветеринарный: ветеринарный ветеринарной ветеринарную
бова: бов
иной: иной
чистый: чистым
прим: примом
вторгнуться: вторгнется
принадлежность: принадлежности
во-вторых: во-вторых
команда: командам команда
тотализатор: тотализаторе
грудь: груди
клетка: клетка клетке
ка-де-бый: ка-де-бо
зоопаста: зоопастах
невероятно: невероятно
европа: европе
копчный: копчную
последний: последний последнем последние последнего
долгий: долгие
оливковый: оливкового
сильный: сильном сильный сильным
родословный: родословная
опытный: опытном
комок: комок
реестр: реестр
аппенцеллер: аппенцеллер
разъярнный: разъярнному
отвага: отвагу
шанс: шансы
образование: образованию
посредством: посредством
отрицательный: отрицательных
веслой: веслой
суждение: суждение
метод: методов
спина: спины спина
удаться: удастся
схватка: схватки
некрупный: некрупные
соответствие: соответствие соответствием
компактный: компактную
появиться: появилось появился появились
густой: густой
лояльно: лояльно
прямоугольный: прямоугольного
спровоцировать: спровоцировать
оценка: оценке
бой: боях
состояться: состоялась
рубль: рублей
спереди: спереди
охота: охоты охоту
развить: развить
окантовка: окантовкой окантовку
сложный: сложнее
архипелаг: архипелаг
мочка: мочка
акцент: акцент
опасность: опасность
слабо: слабо
игрушка: игрушки игрушка
декоративный: декоративных
внимание: внимание
наличие: наличии наличие
варьироваться: варьируется
переходный: переходный
общение: общение общении
улыбак: улыбаки
язык: языка
склад: складов
променад: променад
скотоводческий: скотоводческих
короткий: короткие короткая
заварить: заваренный
иметь: имеет имеют
обратиться: обратиться обратитесь
достоинство: достоинствах
стоимость: стоимость
подойти: подойдут
вычсываться: вычсывается
сопоставлять: сопоставляют
поддерживать: поддерживать
особенно: особенно
желательно: желательно
вынужденно: вынужденно
организация: организацией
личный: личное
вычсывать: вычсывают
окончание: окончания
отсутствовать: отсутствует отсутствующими
возле: возле
кадебошечка: кадебошечка
возникновение: возникновению
строптивость: строптивости
употребление: употребление
помещение: помещений
обязательно: обязательно
договор: договор
варный: варная
приобретение: приобретением приобретение
кабанов: кабанов
редко: редко
сочетаться: сочетается
москва: москве
прибегать: прибегая
нагрузка: нагрузках
неделя: неделю
показатель: показателей
специальный: специальные специальных специальный
привести: привели привело
зоомагазин: зоомагазина
переходить: переходят переходит
диск: диски
защитно-караульная: защитно-караульной
повреждение: повреждением
обстановка: обстановку
любитель: любителей
мальоркин: мальоркин
поставить: поставили поставлены поставленный
презентабельный: презентабельный
несмотря: несмотря
купить: купить
часто: часто
вирусный: вирусных
прямой: прямые прямой
перспективный: перспективных
подкормка: подкормок
наречь: нарекли
ушко: ушки
обнажать: обнажают
славиться: славился славятся
предел: пределах
товарищ: товарища
победитель: победителем
страна: странах страна
допускаться: допускаются
чередование: чередование
комплекс: комплексов
награждать: награждая
грудной: грудной грудная
понадобиться: понадобятся
вытянуто: вытянуто
свежий: свежем
механический: механической
ниша: нишу
расширяться: расширяется
период: периоды период
отзываться: отзывался
предать: преданный
случай: случаях случаи случае
кончик: кончики кончику
болезненный: болезненными
совпадать: совпадают совпадает
предок: предки предков
аджилить: аджилити
недостаток: недостатки
лежак: лежаком лежак
точка: точку
паразит: паразитов
ухо: уши
зазор: зазор
аналогичный: аналогичная
недоверчивость: недоверчивость
зенненхунд: зенненхунд
нрав: нравом
сохранять: сохраняют
лоб: лоб
этот: этих
оказаться: оказались
потребность: потребности потребность
одну-два: одну-две
промышленный: промышленный
поощрение: поощрение
слезоточивость: слезоточивости
бровь: брови
диаметр: диаметры
бугор: бугра
шерстинка: шерстинки
сражение: сражении
крупа: круп
эффект: эффект
настоять: настояв
ребнкома: ребнком
выраженный: выраженную выраженного
одноклассник: одноклассники
реакция: реакцию
фанатичный: фанатичную
вс: вс
кожный: кожные
озлобить: озлобленный озлобленного
лосьон: лосьон
дисплазия: дисплазия
мочь: можете
сопереживать: сопереживать
возможность: возможности
коса: косой
разворачиваться: разворачиваются
чистить: чистить
сам: самом
случайный: случайные случайным
безответственность: безответственность
навык: навыки
мавр: маврами
нейтральный: нейтральным
наблюдаться: наблюдается
успешный: успешная
взять: взять
зрелищный: зрелищным
позволить: позволит
трубчатый: трубчатые
олений: олений
водный: водных
гребень: гребни
щенячий: щенячьем
коррида: корриды корриде
подшрсток: подшрсток
профессиональный: профессиональным
квадратный: квадратного
численность: численности
слышный: слышно
сталкиваться: сталкиваются
парка: парку
закисание: закисания
потребоваться: потребуется
себя: собой
углевод: углеводов
молосс-пастух: молоссами-пастухами
белые: белые
суждено: суждено
запастись: запаситесь
бордоский: бордоских
веслый: веслые
мальорк: мальорка мальорки
болезненно: болезненно
загрязнение: загрязнению
дичь: дичь
направление: направлении
зрение: зрения
лишиться: лишился
океанический: океаническая
независимость: независимость
интересовать: интересовали
будущий: будущему
ранний: раньше
периодически: периодически
горох: горох
порок: пороки
условие: условиями условия
бестия: бестия
средство: средство средства средством
повод: повод
недокус: недокус
репутация: репутацию
генофонд: генофонд
линька: линьки линька
жизнь: жизни
делиться: делились
два: двух
подписать: подписанный
собаковод-новичок: собаководов-новичков
овчарка: овчарка
развлечение: развлечения
едва: едва
скакательный: скакательных
ознакомиться: ознакомьтесь
отказаться: отказаться
благодаря: благодаря
телосложение: телосложением
короткошрстный: короткошрстные
померанский: померанский
затем: затем
постоянный: постоянном
рука: рукой
вид: виде вид
плечо: плечи
оттого: оттого
перегонять: перегоняет
впервые: впервые
запах: запаха
большой: большом
борозда: бороздой
молоссова: молоссов
флегматик: флегматиками
супер-премиум: супер-премиум
шоу: шоу
нужно: нужно
массивный: массивная массивной
мимимишность: мимимишности
вызывать: вызывают
также: также
диетический: диетическую
умный: умная
идеал: идеале
планировать: планируют
чистка: чистке
строптивый: строптивым
момент: моменты момент
зарегистрировать: зарегистрировали
посильный: посильное
по-бульдожий: по-бульдожьи
официальный: официальных
клык: клыки
живот: живота
резкий: резким
витаминный: витаминных
поясница: поясница
квадрат: квадрату
член: члену
освободить: освободили
наследство: наследство
карело-финский: карело-финская
жевательный: жевательные
умеренно: умеренно
бульдогообразный: бульдогообразный
тугой: тугая
высоко: высоко
ранее: ранее
подходить: подходят
проявиться: проявятся
лакомство: лакомства
сложно: сложно
устойчивый: устойчивые
крипторхизм: крипторхизм
новичок: новичкам
область: области
событие: событиям
стоить: стоит
очищать: очищайте
это: это
сторожевой: сторожевые сторожевым
перенять: переняли
ножницеобразный: ножницеобразный
достойный: достойные
зависеть: зависит
совместить: совместить
лайк: лайка
сведение: сведению
вспомогательный: вспомогательного
заканчиваться: заканчиваются
неполный: неполную
походка: походку
эмаль: эмали
участок: участком участке
смочь: сможет
проморозить: промороженная
обработка: обработке
любить: любят
подобрать: подобран
корректироваться: корректируется
удовлетворять: удовлетворяет
хозяйство: хозяйствах
отстаивать: отстаивать
профиль: профиль
настойчивый: настойчивы
уделить: уделили
массажный: массажную
сила: силой силу
служба: службы
угроза: угрозу
какой: какую
собрать: собрать
использование: использование
слизистый: слизистая
легко: легко
десятка: десятками
ограничиться: ограничилось
манера: манера
устраивать: устраивают
свежеть: свежей
лента: ленту
хотеть: хотели
словно: словно
свыше: свыше
ценовой: ценовой
премиум: премиум
воспитать: воспитать
ошибочно: ошибочно
покрывать: покрывающие
добавка: добавки
тип: типа
слаженный: слаженной
произвести: произвести
прародитель: прародителей
выглядеть: выглядит
отличный: отличные
половина: половине
ям: ям
многое: многом
неправильный: неправильного
воздух: воздухе
покупка: покупке
кадебо: кадебо
свести: сведите
пасти: пасти
сдержанность: сдержанность
во-первых: во-первых
избегать: избегать
якобы: якобы
желать: желая
вакансия: вакансии
любимчик: любимчиков
резина: резины
приобрести: приобрела
возвышаться: возвышающийся
бойцовый: бойцовых
селекционер: селекционеров селекционеры
находить: находили
поврнут: поврнута
возвращение: возвращения
прикус: прикус
встревожить: встревожено
знакомство: знакомство
цель: цель
план: плане
совладать: совладать
специализироваться: специализируются
одной-двуха: одной-двух
выделение: выделений
голень: голени
общество: общество
уничтожать: уничтожали
зрелый: зрелые
сезонный: сезонные
выше: выше
молоко: молоко
окрасить: окрашены окрашена
цениться: ценились
строить: строить
палевый: палевый
ватный: ватные
плавный: плавный
вместе: вместе
тревожный: тревожные
уравновесить: уравновешенной уравновешенная
научиться: научиться
столетие: столетия
каждый: каждому
специя: специями
ещ: ещ
изгиб: изгиб
нападт: нападт
сгладить: сгладить
конфликт: конфликту
отдалить: отдалены
пройти: пройти
большинство: большинство
применение: применение
вздутие: вздутие
практически: практически
утруждать: утруждали
родство: родство
рейтинг: рейтинг
мышца: мышцы
проблема: проблем
избавиться: избавиться
проход: проход
овладеть: овладеет
треть: трети
независимо: независимо
подписываться: подписывайтесь
чемпион: чемпиона
недостаточно: недостаточно
присутствие: присутствие
обидчик: обидчику
типично: типично
причудливый: причудливо
хвост: хвоста хвост
запретить: запрещено
очень: очень
обычно: обычно
добродушный: добродушного
ослабеть: ослабевших
показаться: покажется
проточный: проточной
класс: классов
поддаваться: поддаются
проявить: проявили
вина: виной
умение: умение
прочий: прочую
лечь: ляжет
слуховой: слуховой
увечье: увечья
избежать: избежать
кличка: клички
кипячный: кипячной
теория: теории
правило: правила
королевство: королевство
минимизировать: минимизируйте
довольно: довольно
прежде: прежде
настаивать: настаивают
усовершенствовать: усовершенствовать
надбровный: надбровные
лай: лаем
скот: скот
жестокость: жестокостью
половой: половую
удаление: удаления
составить: составит
касаться: касается
естественный: естественным естественный
армия: армией
побеспокоить: побеспокоив
проверка: проверку
втираться: втирается
бдительный: бдительных
молосс: молосс
цельный: цельное
проект: проекте
канада: канаде
соление: соленья
проблемный: проблемных
преткновение: преткновения
кг: кг
нарушать: нарушая
доминирование: доминирование
прививать: прививала
вычсывание: вычсывание
курица: курицы
самец: самец
хрящ: хряще
туловище: туловище
перепонка: перепонки
низко: низко
предусматривать: предусматривала
чужак: чужака
выстроить: выстроит
встречаться: встречались встречаются
бонус: бонусом
расположиться: расположились
стая: стае
ориентироваться: ориентируйтесь
сустав: суставов
использоваться: использовались
ответственный: ответственном
тонко: тонко
громкий: громким
плюсна: плюсны
бойцовский: бойцовское
кормление: кормление
ожидание: ожидании
выделяться: выделялись
слой: слой
огородить: огороженным
принимать: принимают
выбор: выборе
гепатопатия: гепатопатия
рысью: рысью
основный: основных
сон: сне
масло: масла
закономерный: закономерным
столовая: столовую
ярость: ярость
г: г
телятина: телятины
демодекоза: демодекоз
неопущение: неопущение
серьзный: серьзные
сопутствовать: сопутствующие
скоротать: скоротать
улучшение: улучшения
палочка: палочки
