спокойный: спокойного спокойнее спокойны спокойные спокойном
туалет: туалет туалету туалета
верный: верные
овощ: овощи овощами
колебаться: колеблется
американский: американских
широко: широко
популярность: популярности
фу: фу
средний: средняя среднее средней средние средний
агрессия: агрессия агрессии агрессией
далёкий: далекими подальше
устать: устали
нанести: нанесенной
следить: следить следят
удар: удар
чёрный: черный черного
использоваться: используются используется
сколько: сколько
трехцветный: трехцветный
лохматый: лохматая
энтропия: энтропия
больший: наибольшим большим большая большие
знак: знаком
послушный: послушные
название: название названия
собака: собаку собак собака собакам собаке собаки
хороший: лучшим хороших хорошем хорошей
палевый: палевого палевых
прощать: прощают
физический: физических физическими физическое
прикус: прикусе прикус
обсуждение: обсуждения
наследственность: наследственностью
округлить: округленной округлен
оставаться: оставаться
цена: цена
сказать: скажите
колесить: колесил
никто: никому
диск: диска
содержаться: содержится
чувствительный: чувствительные
приравниваться: приравнивались
материал: материалов
удовольствие: удовольствием
чистота: чистоту
твёрдость: твердость
оставить: оставить
завезти: завезены
идеальный: идеальные идеальными идеальных
полуторамесячный: полуторамесячного
необычайно: необычайно
резец: резцов
передний: передняя передние
терпеливый: терпеливые
изучить: изучив
любовь: любовь
превосходство: превосходства
пятно: пятнами пятна
субпродукт: субпродукты
справить: справить
покровительственно: покровительственно
побегать: побегать
россия: россия россию
берн: берне берн берны бернов берна
вред: вреда
морда: морде морды морда
раковина: раковины
стенка: стенки
обратный: обратная
итог: итоге
компактный: компактный
маленький: маленьким маленькое
следующий: следующих
римлянин: римляне римлян
тон: тоном
фен: фен
представитель: представителей представители
грыжа: грыжа
шея: шея шеи
блеск: блеском
овчарка: овчарки овчарок овчаркам овчарка
городской: городская
стричь: стричь
получать: получать
шерсть: шерсть шерсти шерстью
компаньон: компаньоны
место: местами месте
поверхность: поверхности
приемлемый: приемлемых
бургдорфский: бургдорфский
применять: применять
логинов: логинова
челюсть: челюсти
игра: игре игр играх
должный: должны должно должна
основополагающий: основополагающую
свет: свете
содержать: содержать
врождённый: врожденным
творог: творога
уступать: уступают
сегодняшний: сегодняшних
ниша: ниши
человек: людям людей человека
пастуший: пастушья пастушьи
относиться: относится относятся
питомец: питомцами питомцев питомцу питомец питомца
месяц: месяц месяцы месяцев
участок: участки участков
прогений: прогения
некоторый: некоторых некоторые некоторым
равно: равно
нога: ног ноги ногах
легенда: легенду
важно: важно
иллюзия: иллюзию
расчёсывать: расчесывают расчесывать
история: история
ватный: ватного ватную ватные
брать: брать
сделать: сделал сделано
щенок: щенка щенков щенки щенок щенку щенкам
взрослый: взрослое взрослой взрослого взрослые взрослых
щека: щека
прилегать: прилегающем
гид: гидов
избыточный: избыточное
белок: белка
тягать: тягать
борозда: борозда
выгул: выгул выгуле
мокнуть: мокнущая
настолько: настолько
банан: банана
задний: задняя задние задних
крупяной: крупяных
голова: голове головы голову голова
обучение: обучении обучению обучение
высохнуть: высохнет
кисломолочный: кисломолочные
семья: семьи
вводиться: вводится
лужайка: лужайках
ласковый: ласковый ласковые
чувство: чувством чувств
рьяно: рьяно
выпуклый: выпуклые
воронка: воронки
характеристика: характеристика
гигант: гигант гиганты
быть: е будут
руб: руб
чужой: чужих
носочек: носочки
зарождение: зарождения
купание: купания
год: годы годах года годам лет год году
коттедж: коттедж
пол: пола
густой: густую
выдающийся: выдающимся
соя: соя
кормление: кормлении кормление
заворот: заворот
коготь: когти
сжечь: сжечь
тяга: тяга тяге
сероватый: сероватый
значит: значит
орган: органами органов
осуществлять: осуществлять
двухмесячный: двухмесячного двухмесячных двухмесячный
палец: пальцы
быстро: быстро
саблевидный: саблевидный
входить: входят входить
незнакомец: незнакомца незнакомцам
раз: раза
видео: видео
дом: домом дома
защитить: защитить
разрешаться: разрешается
внимание: внимания внимание
меню: меню
вода: воды водой
смысл: смысл
условие: условии условиях
обаятельный: обаятельный
улица: улицу
зоомагазин: зоомагазине
домашний: домашних домашними
гиподинамия: гиподинамия
способный: способно способны
каждый: каждой каждым каждый каждая
малоактивный: малоактивной
владелец: владельца владельцев
небольшой: небольших небольшую небольшие
такой: таких такое
неизменный: неизменным неизменная
бесконечно: бесконечно
рацион: рациона рацион
содержание: содержание содержанием содержания
трёхмесячный: трехмесячных
объект: объектом объект
собственный: собственного
немного: немного
конура: конуру
составлять: составляет составлять
благосклонно: благосклонно
поселковый: поселковый
охрана: охрану
дисциплинированность: дисциплинированности
массивный: массивный
натуральный: натуральном
ноздря: ноздрями
искренний: искреннее
окрас: окраса окрас окрасу
кстати: кстати
подчиняться: подчиняется
крестьянин: крестьяне
он: нему
связь: связь
сформировать: сформировать сформирован
польша: польши
система: система
угол: углом угол углов
прыгать: прыгать
внешность: внешность
номер: номеров
подурачиться: подурачиться
радужный: радужной
бедро: бедра
пока: пока
стать: стали стало стал стать
жильё: жилья жилье
состояние: состоянии
бурный: бурным
покладистый: покладистые
перестать: перестанет
белый: белыми белых белый
член: член членом членов
улыбка: улыбкой улыбка
вязка: вязки
возбудить: возбужденного
реальность: реальность
дважды: дважды
давать: давать
выгуливать: выгуливаете выгуливать выгуливают
природный: природные
естественный: естественных
спонтанный: спонтанных
бернский: бернская бернской бернский бернских бернского бернским бернские
анус: ануса
лишний: лишние лишним
альберт: альберт
стресс: стрессы
повестись: поведутся
район: районах районе
родительница: родительницей
признак: признаки
приговор: приговор
симпатия: симпатии
мочить: мочить
подтон: подтоном подтон
смотреть: см смотрите смотреть
клещеобразный: клещеобразный
друг: друзья
лёгкий: легкий легкую легкого легкие
осматривать: осматривать
фотография: фотографии
солнце: солнце
помогать: помогает помогающие
невзирая: невзирая
приготовить: приготовленные
расти: растут
уход: уходе уход
период: периода периоды период
сон: сну
качественный: качественном
дать: данной дал давшее
высокий: высокая
особь: особь особями особи особям особей
питомник: питомники питомника питомниках питомнике
пара: пары пару
находиться: находиться находящейся
глаз: глаза глаз глазах глазами
проказа: проказы
самый: самый самым
застеклить: застеклен
кукуруза: кукуруза
тушить: туша
повышенный: повышенного
человеческий: человеческой
часть: части часть частей
вниз: вниз
поздний: позже
век: века
упругий: упругими
семимесячный: семимесячных
поскольку: поскольку
прочий: прочие
тапочки: тапочки
пользоваться: пользуются пользовались
краткий: краткая
рыба: рыб
отношение: отношение отношения
случайный: случайной случайные
заболевание: заболеваниям заболевания заболеваний
морской: морских
поощрить: поощрить
уделять: уделяйте
ветвь: ветви
норвежский: норвежский
приживаться: приживаются
сушка: сушкой сушки
эксперт: экспертов
купать: купать
направить: направлены
резвый: резвые
факт: факт
отвечать: отвечают
удаление: удаление удалению
предпочитать: предпочитающим
вконтакте: вконтакте
просмотр: просмотр просмотров
проявление: проявление проявления
наклонить: наклонены
палка: палку
совершать: совершают
переход: переход
тазобедренный: тазобедренных
разновидность: разновидности
чихуахуа: чихуахуа
заходить: заходить
разведение: разведением
ярко: ярко
роль: роль
животное: животных животным животного животными животные животное
один: одного одна одной
усваивать: усваивают
сани: саней
характер: характером характера характер
волос: волос
длина: длины
выбрать: выбрать
экземпляр: экземпляров
поход: походе походах
бойцовский: бойцовские
оценить: оцените оценили
счёт: счет
основать: основана
допустить: допустим
шёрстный: шерстного шерстный
хотя: хотя
напрыгивать: напрыгивает напрыгивать
требование: требованием
эталонный: эталонная эталонный
рельефный: рельефный
х: х
планировать: планирует
умудрить: умудренные
больной: больнее
корова: коров
становление: становлении
непослушание: непослушания
доставлять: доставлять
проблема: проблемы проблем проблемой
малый: меньшие
середина: середины
температура: температурой
темперамент: темпераментом темперамент
двойной: двойная
квартира: квартире квартира квартирах
размер: размеры размера
мера: меру мере
сырой: сырым сырые
информация: информация
подходить: подходит
будка: будка
отросток: отростки
сустав: суставы суставов
вьющийся: вьющаяся
охранник: охранников
ребро: ребра
мытьё: мытья
приподниматься: приподнимается
специалист: специалистов
кошка: кошкой кошки кошку кошками
интеллект: интеллекте интеллект
изделие: изделий
яблоко: яблока
конец: концу конце конец
крепкий: крепкие крепкий
вплоть: вплоть
ладить: ладят
зенненхунд: зенненхунда зенненхундам зенненхунды зенненхунд зенненхундов
ребёнок: детям детей ребенком
кончик: кончик
сравнительно: сравнительно
среди: среди
затылок: затылка
сухарь: сухари
лапа: лапах лапами лапы лап лапа
подушечка: подушечками
серьёзный: серьезных серьезной
проточина: проточины
веко: веки
знакомый: знакомых
помочь: помогло
считаться: считается считаются считались
нянька: няньками
загрязнение: загрязнения
подвижный: подвижных
загривок: загривком
коричневый: коричневым
рука: руки рук
просто: просто
наблюдаться: наблюдаться
закрутить: закрученный
провинция: провинции
кудрявый: кудрявым
дискомфорт: дискомфорта
малыш: малышам
структура: структура
удаляться: удаляются
низкий: низкая
лесополоса: лесополосе
угостить: угостить
территория: территории
женский: женского
пропорциональный: пропорциональная
выражение: выражение
добавить: добавьте
прогулка: прогулки
происхождение: происхождения
бернец: бернцев
упряжка: упряжке
лобный: лобной лобная
наследственный: наследственные
исчезать: исчезают
необходимо: необходимо
капризный: капризны
удлинённый: удлиненной удлиненные
первый: первые первый первых
деньга: деньги
двухлетний: двухлетнего
пища: пищи
лундехунд: лундехунд
свой: своем свой своего своих свои
проявляться: проявляться
редкий: реже
асимметрия: асимметрия
агрессивный: агрессивный
тщательно: тщательно
дрессировка: дрессировка дрессировки дрессировкам
винодел: винодел
время: время времени
сука: суки сук
трехразовый: трехразовое
прямой: прямым прямая прямые прямой
агрессивность: агрессивность
ушной: ушной
плечо: плеча
перевозка: перевозки
десерт: десерт
урок: уроки
другой: другие других другими другая другим
кусаться: кусаться кусается
использовать: используйте использовать
слух: слуха
избежание: избежание
регистрационный: регистрационных
фирменный: фирменным
алина: алина
малышев: малышева
например: например
несколько: несколько
своеобразный: своеобразным
сетчатка: сетчатки
превосходно: превосходно
рост: рост
потомство: потомство
газета: газеты
лыжник: лыжника
строгий: строгим
правильный: правильном правильной
сложный: сложные сложнее
коврик: коврики
ругать: ругать
к: ко
реклама: реклама
мясо: мясом мясо
практиковать: практиковать
свойственно: свойственно
швейцарский: швейцарские
шалость: шалостей шалости
мускулатура: мускулатурой
полагаться: полагается
выраженный: выраженным
вкус: вкус
выразить: выражена
рекомендоваться: рекомендуется
мочка: мочки мочка мочку
спокойно: спокойно
воспитание: воспитание воспитании
учиться: учатся
контактировать: контактировать
соорудить: соорудить
работа: работы
проводиться: проводится
потомок: потомков
называть: называемая
плачевно: плачевно
сам: самой
который: которыми которого котором которых которые который
оба: обоих
изводить: изводить
сухой: сухие
посадить: посадить
приносить: приносит
сайт: сайту
черно-палевый: черно-палевого
выбор: выбора
получаться: получаются
настя: настя
паста: пастой
крупный: крупная крупных крупными крупные
лишь: лишь
течка: течки
вариант: вариант
долго: долго
поймать: поймать
уважать: уважающие
выводить: выводить
видоизменить: видоизмененная
шертенляйба: шертенляйб
треугольный: треугольной
швейцария: швейцария швейцарии
форум: форум форуме
протяжение: протяжении
белка: белки
троп: тропам
неприятность: неприятностей
дружелюбный: дружелюбные дружелюбная
боль: боль
подвиг: подвиги
спутница: спутница
скоро: скоро
резкий: резких
ходить: ходим ходить
ровный: ровные
докучливый: докучливые
варена: вареной
шоу-класс: шоу-класса
описание: описание
начало: начало
многое: многое
мужской: мужского
встречаться: встречаться встречался
подниматься: поднимается
военный: военных
владимир: владимир
лопатка: лопатки
второй: второго
округлый: округлые
сочетать: сочетала
налёт: налета
озаботиться: озаботиться
венгрия: венгрии
сидеть: сидело
приятельский: приятельские
германия: германии
внушительный: внушительные внушительных
играть: играть
становиться: становится становятся
дождаться: дождался
поэтому: поэтому
четыре: четырех
отказ: отказ
случай: случаев случаях случае случай
копирование: копирование
короткий: короткий короткие короткая
нужда: нужду
воспринимать: воспринимают
добрый: добрый добрые
прекрасно: прекрасно
заниматься: занимаемся занимались
активность: активность
подверженный: подвержены
основание: основания
переутомлять: переутомлять
карта: картой
русский: русская
дружелюбность: дружелюбность
уважение: уважении
побаловать: побаловать
насыщенный: насыщенного
плавно: плавно
отзыв: отзывах отзывы
обладать: обладающие
юный: юном
следовать: следует
доходить: доходить
мимика: мимики
оплошность: оплошности
отсутствие: отсутствии отсутствия отсутствие
шум: шум
любознательный: любознательны любознательные
висячий: висячие
перчаткишарф: перчаткишарф
уровень: уровня
пшеница: пшеница
допустимый: допустимо допустимый
внушение: внушения
широкий: широкой
назад: назад
пожалуйста: пожалуйста
оттенок: оттенка оттенок
поиск: поиском поиск поисках
сеттер: сеттер
тормозить: тормозить
онкологический: онкологическим
интерес: интерес
мочь: могут
возраст: возрастом возраст возраста возрасте
свобода: свободу
порода: породы пород порода
заполучить: заполучить
хватать: хватает
сопровождать: сопровождали
целое: целом
объявление: объявления
параметр: параметрами
располагаться: располагаются
частное: частного
основной: основные
опыт: опытом
ф: ф
батарея: батарей
охранный: охранные
преобладать: преобладающий
неправильный: неправильный
вес: вес
выполнять: выполняют выполнять
го: го
полотенце: полотенцем
потчевать: потчевать
чемпион: чемпионов
линять: линяют
ежедневно: ежедневно
приучить: приучить
позволять: позволяют
нос: носа
круповой: круповой
по-настоящему: по-настоящему
какой-либо: какой-либо
банный: банный
кипячёный: кипяченой
йод: йодом
подходящий: подходящая подходящих
серьёзно: серьезно
чрезвычайно: чрезвычайно
повреждение: повреждения
отклонение: отклонения
рот: рта рот
грамотно: грамотно
отдалить: отдаленных
добродушный: добродушный добродушной
продолжительность: продолжительность
молодой: молодые
переводить: переводят
вещь: вещами
захотеть: захочет
расположить: расположенные
цюрихский: цюрихского
дотягивать: дотягивают
кричать: кричать
снисходить: снисходящие
прибор: приборов
выставляться: выставлялись
опустить: опущен
говорить: говорят говорю
шампунь: шампунь
молочный: молочной
цвет: цвета
остеохондроз: остеохондроз
сформулировать: сформулировал
линия: линий линии
развитие: развития
манеж: манежа
основный: основным
результат: результате
одежда: одежду
отучать: отучать
хозяйский: хозяйское
современный: современной
череп: черепу череп
лужа: лужу
принимать: принимать принимают
слегка: слегка
здравствуйте: здравствуйте
несложный: несложные несложной
фото: фото
толчок: толчком
питание: питание
допускаться: допускается
лечение: лечении
потреблять: потреблять потребляемых
применяться: применяется
два: две
наказание: наказаний
яндекс: яндекс
нежный: нежных
количество: количество количестве
состав: состав
обожать: обожают
уголок: уголок
обитать: обитают обитать
дворняга: дворнягам
участие: участие
резиновый: резиновые
остальной: остальным
сварить: сваренным
вперёд: вперед
отталкиваться: отталкиваться
ухо: уха уши
путешествие: путешествиям
нрав: нрав
социализация: социализации
мёрзлый: мерзло
ставить: ставить
альпийский: альпийских
спина: спиной спины
породистый: породистых
окружающий: окружающую
собрать: собраны
холка: холке холкой
смочь: смогли
двор: дворе
бесполезно: бесполезно
журнал: журнал
резаться: режутся
неделя: недели недель неделю
высота: высота
игривый: игривые
лень: лень
делать: делать
ограниченный: ограниченном
морковь: морковь
дюрбах: дюрбах
нуждаться: нуждаются
насилие: насилие
постав: постав
сужаться: сужающийся
научить: научите
уживаться: уживаются
порядок: порядка
покров: покров покрова
бинт: бинтами
превосходный: превосходные
подобрать: подобранном
нужный: нужные
болезнь: болезни
взрослеть: взрослеют
кормить: кормят
заводчик: заводчиков
древний: древние
зона: зоны
либо: либо
балкон: балкона балконе
начинать: начинать начинайте
активно: активно
поднять: поднять
оптимальный: оптимальной
невозмутимо: невозмутимо
образ: образом
европейский: европейских
настороженный: насторожен
ваш: ваши ваш ваших
чехословакия: чехословакии
дисквалификация: дисквалификации
превратить: превратили
перебегать: перебегающую
проявить: проявить
нагрузка: нагрузке нагрузках нагрузками
рассматривать: рассматривать
сквозняк: сквозняке
корпус: корпуса корпус
кобель: кобели кобелей
перерыв: перерывах
скакательный: скакательные
терпение: терпение
перекус: перекус
недостаточный: недостаточный
заметно: заметно
упрямство: упрямства
умиление: умиление
батман: батманов
такт: такта
день: дня день
пелёнка: пеленки
римский: римских
немой: нем
пират: пират
развитой: развитой
перейти: перейти
купить: купленные купить
сутки: сутки
из-за: из-за
поведение: поведение
опознавательный: опознавательные
рудиментарный: рудиментарные
оболочка: оболочки
прищемить: прищемите
прыжок: прыжков
менее: менее
тот: тех
перегибать: перегибают
дефект: дефектов дефектам дефектами
жёлтый: желтого
горный: горным
палочка: палочку палочки
улучшить: улучшить
команда: командам команд команды команда
хозяин: хозяевам хозяев хозяина
грудь: груди грудью
длинный: длинную длинная длинной
километраж: километраж
внешний: внешний
вольер: вольеры вольере вольер
костяк: костяк
флегматичный: флегматичным флегматичнее
слишком: слишком
одиночество: одиночеству
будущее: будущего
поощрение: поощрения
эффектный: эффектным
умный: умные умная
комок: комок
потерпеть: потерпеть
отучить: отучить
подшёрсток: подшерсток
бесстрашие: бесстрашие
мина: мин
стандарт: стандарта стандарт
кой: коем
посредством: посредством
пик: пик
атрофия: атрофия
спрос: спросом
габарит: габаритов
гигиена: гигиена
подросток: подростков
стадия: стадии
мускулистый: мускулистая мускулистые
квартирный: квартирных
туфля: туфли
отправление: отправление
оценка: оценке
хотеть: хочу
отрезвить: отрезвит
сказываться: сказывается
излишний: излишне излишнюю
неплохо: неплохо
принять: принят принять
определённый: определенную
постный: постное
правило: правило правилах правила
салон: салонах
переусердствовать: переусердствуйте
выпадение: выпадение
здорово: здорово
любой: любые
раздвоенность: раздвоенность
удалять: удаляют
приоткрывать: приоткрывая
невозмутимый: невозмутимые невозмутимый
стоимость: стоимость
чистый: чистом чистой
тонус: тонус
фрагмент: фрагментов
поддерживать: поддерживать
просыпаться: просыпается
особенно: особенно
любопытный: любопытный
желательно: желательно
анастасия: анастасия
превращаться: превращаться
раскраса: раскрас
делить: делить
достаточно: достаточно
наскакивание: наскакиваний
обязательно: обязательно
ответ: ответов ответ
почка: почек
интересовать: интересует
тренировка: тренировки
отметка: отметки
обстановка: обстановку
хайма: хайм
ношение: ношения
поводок: поводке
охотно: охотно
форма: формы
иметь: иметь имеют
несмотря: несмотря
кусать: кусает кусать
часто: часто
поставить: поставлены
спорт: спорт
вопрос: вопросом
немудрёный: немудреные
рекорд: рекордом
уважаемый: уважаемым
войти: вошедшее
целесообразный: целесообразнее
наслать: нашли
вкрутую: вкрутую
грудной: грудной
жирность: жирности
вытеснить: вытеснены
разводить: разводили разводить
блестящий: блестящую
запасаться: запасаться
залом: заломы
рождение: рождения
выбирать: выбирать
ветеринарный: ветеринарной
лоскут: лоскутов
высыхание: высыхания
начать: начал начнете
этот: этих
провокация: провокации
наличие: наличие
мудрый: мудры
потребность: потребностей потребность
килограммовый: килограммовая
непреодолимый: непреодолимая
усвоить: усвоить
калория: калории
родить: рожденные
английский: английский
весь: всем
безалаберный: безалаберны
патология: патологии
совмещать: совмещать
одноклассник: одноклассники
запрет: запретов
появление: появлению
приобрести: приобрели
дисплазия: дисплазия
правда: правда
таскать: таскать
собака-добряк: собаки-добряки
кроме: кроме
навык: навыки навык
объятие: объятья
взять: взять
суть: сути
активный: активными
пасти: пасли
частый: чаще
предать: преданные
польза: пользы
направление: направлению
летний: летнее
равняться: равняется
прийтись: пришелся
пробовать: пробуют
общий: общего
понизить: пониженной
зуб: зубы зубов
вообще: вообще
диапазон: диапазоне
молосса: молоссы
рискованный: рискованный
развлекаться: развлекаться
неярко: неярко
стандартный: стандартное
белые: белые
цепь: цепь
выглядеть: выглядят
влага: влагу
заставить: заставить
окончательно: окончательно
продукция: продукции
миндалевидный: миндалевидные
сторож: сторожа
нормальный: нормального
зрение: зрения
ранний: раньше
радость: радость
периодически: периодически
желток: желтком
порок: пороки
предок: предков предками
недокус: недокус
остевой: остевой
жизнь: жизни жизнь
создавать: создавая
тело: тело
сильно: сильно
едва: едва
постоянный: постоянные
всё-таки: все-таки
тепловой: тепловой
вид: виде вид
прогревать: прогревает
видеть: видит
пожилой: пожилой
молоссова: молоссов
цветной: цветная
нужно: нужно
мимимишность: мимимишности
настойчивость: настойчивость
также: также
формальность: формальностью
процесс: процесс
покупка: покупки покупке покупка
момент: моменты момент
сюда: сюда
заморозить: замороженное
прошлое: прошлого
несущий: несущим
продолжать: продолжает
положить: положенном
заметный: заметны
поясница: поясница
испачкаться: испачкаться
наследство: наследство
стоить: стоить стоит
пупочный: пупочная
исключение: исключения
здоровый: здоровое
высоко: высоко
экзема: экзема
уравновешенность: уравновешенность
ошейник: ошейника
лакомство: лакомства
крипторхизм: крипторхизм
область: области
это: это
сторожевой: сторожевые
отгораживать: отгораживают
добраться: добраться
чистопородность: чистопородность
ласка: ласку
любить: любит любят
прибылой: прибылые
ножницеобразный: ножницеобразный
филе: филе
зависеть: зависит
миролюбивый: миролюбивым
межсезонье: межсезонье
обучать: обучать
ограничивать: ограничивающий
показатель: показатели
ньюфаундленд: ньюфаундлендом
вполне: вполне
заканчиваться: заканчиваются
приспособить: приспособив
санки: санки
попадание: попадания
стараться: старайтесь
профиль: профиль
качество: качества
вкусный: вкусные
ощутимый: ощутимого
отдельный: отдельных
легко: легко
многий: многих
выносливость: выносливость
сохранить: сохранить
вызывать: вызывать вызывает
лента: ленту
экономичный: экономичный
здоровье: здоровье
сочетание: сочетании
глубокий: глубокой
основательно: основательно
котироваться: котировались
интенсивно: интенсивно
смочить: смоченного
обязательный: обязательной
затмевать: затмевает
альпы: альп
подворачиваться: подворачивается
отличный: отличные
дорогой: дороже
красный: красным
сенбернар: сенбернарами
перегрев: перегрев
снисходительно: снисходительно
сила: силу
локтевой: локтевых
пальцеобразный: пальцеобразные
тыква: тыкву
вакансия: вакансии
прямо: прямо
приучать: приучайте
семейный: семейные
темно-кария: темно-карий
продукт: продукты
университет: университета
производиться: производится
умудриться: умудрился
покой: покоя
знакомство: знакомство
предприниматель: предприниматель
вроде: вроде
выделить: выделить
кефир: кефира
подтачивать: подтачивать
сыграть: сыграл
солидный: солиднее
подрабатывать: подрабатывая
обустроить: обустроить
таковой: таковой
выше: выше
помощник: помощники помощников
молоко: молоко молока
плавный: плавный
вместе: вместе
длительный: длительного
простокваша: простокваши
позаботиться: позаботиться
столетие: столетия
корм: корма
главный: главная
алопеция: алопеция
катаракт: катаракта
рейтинг: рейтинг
мышца: мышцы
рыжий: рыжая
недопустимый: недопустимы
устанавливаться: устанавливается
подписываться: подписывайтесь
авторитет: авторитетом
знаменитый: знаменитый
простой: простейших
повалить: повалить
сильный: сильные
дисциплина: дисциплина
самостоятельно: самостоятельно
хвост: хвоста хвост
запретить: запрещено
очень: очень
сыроварня: сыроварнях
обычно: обычно
особый: особой
энтропион: энтропион
особенность: особенности
поддаваться: поддаются
расслабляться: расслабляются
мышечный: мышечный
волна: волны
умение: умение
облысение: облысение
наоборот: наоборот
постепенно: постепенно
брак: браком
истечение: истечении
избежать: избежать
специальный: специальной
кличка: клички
довольно: довольно
омномном: омномном
возможность: возможность
родовой: родовой
выпрашивать: выпрашивать
касаться: касается
граница: границы
проверка: проверку
аниматор: аниматоры
подлежать: подлежат
достигнуть: достигшими достигшее
развозчик: развозчиками
собака-универсал: собаками-универсалами
проект: проекте
сигнализировать: сигнализирует
родословный: родословных
получить: получили
кг: кг
несильно: несильно
необходимость: необходимости
тележка: тележке
среднее: среднего
крупа: крупой
линька: линька
бублик: бублик
причинить: причинит
страна: страна
плече-лопаточный: плече-лопаточный
свод: свод
комнатный: комнатного
кусочек: кусочком
заглянуть: заглянув
комфортный: комфортный
регулярный: регулярных
причём: причем
груша: груши
дорога: дорогу
темп: темп
конечность: конечности
ккал: ккал
трусливость: трусливость
болонка: болонка
катать: катать
исправно: исправно
яйцо: яйцом
максимальный: максимального
влюбиться: влюбился
донести: донести
приём: приема
профессор: профессор
типичный: типичные
план: плана
обогревательный: обогревательных
брокколи: брокколи
