низ: низ
ослабить: ослабленный ослабленным
набегаться: набегаются
вертикальный: вертикальные
взяться: взялись
отличать: отличают отличала отличает
кинолог: кинологов кинологи кинолога
тело: тела теле
пигментация: пигментацию пигментация
повредить: повредите
множество: множеством
мучной: мучное
средний: средняя средних средней средний
защита: защиту
выдиться: выдатся
пища: пища пищу
здоровый: здоровых здоровые здоровой
из-под: из-под
четвероногий: четвероногих четвероногом
покрыть: покрытая покрыты покрыта
участвовать: участвовать
посторонний: посторонних
сколько: сколько
ранний: ранней раннем
непригодный: непригодный
соседний: соседних соседние
энтропия: энтропия
водом: водоме
голубеть: голубей
солновать: солную
название: название названия
деньга: денег
материнский: материнской
добавка: добавок
собака: собаку собакой собак собака собаках собакам собаке собаки
открытый: открытом
общение: общением общения общение
справляться: справляются справлялись
ноздря: ноздри
экто: экто
обсуждение: обсуждения
миска: миску
сочленение: сочленений
настоять: настоять
предупредительный: предупредительное
цена: цена ценой
рыба: рыбу
сводистый: сводистыми
образный: образная
зачастую: зачастую
выжть: выжла выжл
инициатор: инициатором
диск: диска диском
заметка: заметку
псиный: псины
подушечка: подушечки подушечек
чувствительный: чувствительные чувствительным
венгерский: венгерским венгерскую венгерском венгерской венгерскими венгерского венгерских венгерская венгерские
вмешательство: вмешательство вмешательстве
материал: материалов материалом
рыбий: рыбий
стараться: старается
обратить: обратите
владелец: владельцам владельца владельцев владельцу владельцы владелец
размер: размерам размеров размеры размер
гормональный: гормональные
овальный: овальную овальная овальной овальные
стоять: стоят
любовь: любовь любви
нюанс: нюансы
сторона: стороны
щтка: щткой
дисквалифицировать: дисквалифицирующие
приспособить: приспособлены
инстинкт: инстинкты инстинктам
выраженный: выраженный выраженная выраженные
россия: россия
каштановый: каштановый
выразить: выразите выражены
морда: морде морда
национальный: национального
раковина: раковины
обратный: обратная
ревакцинация: ревакцинацией
справиться: справиться справятся
начало: началом начало
курцхаар: курцхаары
начинать: начинают
ради: ради
воздержаться: воздержаться
искать: искать
компаньон: компаньонов компаньона компаньоном
команда: команду команде команд команды команда
легавый: легавая легавым легавые легавых легавыми легавую легавой легавый
занятие: занятий
шея: шея
немногий: немногих
отмечать: отмечают
внимательный: внимательное
фокстерьер: фокстерьер
шерсть: шерсть шерсти шерстью
поверхность: поверхности
воспитательный: воспитательной
турецкий: турецкие
одиночество: одиночества одиночеству
ускорить: ускорит
кишечный: кишечные
испортить: испортить
качество: качеств качестве качества
занять: занявшую
челюсть: челюсти челюстей
самый: самая самым
препятствовать: препятствовать
заметный: заметных заметен
тип: тип
значительный: значительном
автономия: автономию
идт: идт
содержать: содержать
янтарный: янтарный янтарного
взгляд: взгляд взгляда
препятствие: препятствий препятствие
исключение: исключение исключением
губа: губами губа губ
становиться: становиться
сохранение: сохранения
отсутствовать: отсутствуете отсутствует отсутствующего
человек: людям людьми людей человека человек
относиться: относится
питомец: питомцами питомцев питомцы питомца питомцем
месяц: месяц месяца месяцев
крыло: крыло
употребление: употреблением
чума: чумы
назвать: назвать
включая: включая
окова: оковы
верный: верный
дополнительный: дополнительный дополнительные
важно: важно
небольшой: небольшое небольшую
измениться: изменится изменился
катя: кати
способность: способность способностей
насидеть: насиженные
обильный: обильного
баланс: балансом
история: история
ватный: ватного ватным
щенок: щенка щенков щенки щенок
среда: среда
приходить: приходит приходят
ненароком: ненароком
удивительный: удивительному удивительная
уступить: уступив
покладистый: покладистому покладистым
выгул: выгул выгуле выгула
попросить: попросите
новый: новые новая новой
проявлять: проявляет проявлять
водохранилище: водохранилищах
обязательный: обязательный обязательном обязательна
прилегать: прилегающие прилегающими прилегает прилегают
искусный: искусный
форма: форма форму формы
особый: особое особых особой
голова: голове головы головой голова
чувствовать: чувствуют
обучение: обучении обучению
тплый: тплой тплую
семья: семьи семьях
упражнение: упражнениям
нередко: нередко
стрижка: стрижкой
характеристика: характеристика характеристику характеристиками
быть: е будьте
ошпарить: ошпаренное
забавный: забавный
выставка: выставках
скрывать: скрывать скрывая
несколько: несколькими
усталость: усталость
помощь: помощью помощи
чрный: чрный
ветеринар: ветеринаром
свернться: свернтся
соответствие: соответствии соответствием
заводчик: заводчик заводчиком заводчика заводчики
около: около
пол: пола пол
публика: публику
пятно: пятна
война: войны
коготь: когти когтей когтями
кандидат: кандидатов
стать: стала стали стал стать станет
утвердить: утвердили
саблевидный: саблевидный
яичко: яичек
первый: первой первые первое первого первый первых
симметрия: симметрией
сужаться: сужается
роль: ролью роль
территория: территория территории
основное: основном
аккуратный: аккуратное аккуратного
комплексный: комплексной
удаться: удалось
видео: видео
дом: домом дома доме
полноценный: полноценного полноценных
исчезновение: исчезновения исчезновением
энергичный: энергичным
фактор: факторами
короткошрстный: короткошрстной короткошрстных
внимание: внимания внимание
полностью: полностью
условие: условии условиям условий условия
бросаться: бросались
возможный: возможные
компания: компании компанию
находиться: находясь находиться находится находитесь
младший: младшего
назначение: назначению
спускать: спускать
мадьяровский: мадьяровских
капуста: капусту
одобрение: одобрение
гепатит: гепатита
нюх: нюху
исполнение: исполнении
скука: скуки
рацион: рациона рацион
коленный: коленные
называть: называют
беседа: беседа
содержание: содержание содержанием содержания
опытный: опытного
щека: щекам
немного: немного
ярый: ярые
чужак: чужак
важный: важен важную важны важный
взаимоотношение: взаимоотношениям
целенаправленный: целенаправленные
выжл: выжлу выжлы
универсальный: универсальными
составлять: составляет
рекомендовать: рекомендуют
углеводосодержащий: углеводосодержащие
обнаружить: обнаружить
реагировать: реагировать
массивный: массивный
численность: численность
отблагодарить: отблагодарит
окрас: окраса окрас
густой: густых густая
компонент: компонентов компонент
пруд: прудах
объект: объект
подвес: подвес
переносица: переносицей переносицы
масло: масло
ушной: ушные ушной
указать: указанным
связь: связь
обернуться: обернуться
контакт: контакта контакт
выделять: выделять выделяют
понимание: понимание
повышенный: повышенным
жизнерадостный: жизнерадостный
вода: воде воду водой
однополый: однополые
грация: грацией
венгрия: венгрия венгрии венгрию
круглый: круглый
непрерывный: непрерывным
острый: острую острому острые
характерный: характерного характерны характерная
энтопаразит: энтопаразитов
основный: основную основным
тмный: тмный тмные
обязывать: обязывает
ганноверский: ганноверские
частный: частном частные
причина: причину причине причины
выделяться: выделялась
пока: пока
ориентироваться: ориентироваться ориентировались
фон: фоне
дружелюбие: дружелюбию
прививка: прививку прививки
вариант: варианте вариант вариантом вариантами
полный: полная полного
травма: травму
состояние: состоянии
подойдт: подойдт
официальный: официальный
солдат: солдат
аллергия: аллергии аллергию аллергия
вязка: вязки вязке
пудель: пудели
растительный: растительное
клещ: клещ
дважды: дважды
нижний: нижние нижняя
давать: давать
проницательный: проницательный проницательному
салюк: салюки
комфортный: комфортного
отведнный: отведнном отведнные
протирать: протирать
совпадать: совпадать совпадает
ненаджной: ненаджное
предмет: предметы
спортивный: спортивные спортивный
лидерство: лидерство
смешаться: смешались
речь: речи
награда: наградами награды
плотно: плотно
преданный: преданны
ежедневный: ежедневном ежедневным
птица: птиц птицы
поле: поле
свобода: свободе
эффектный: эффектной
смотреть: см
друг: друзья друг друге друга другу
иммунитет: иммунитетом иммунитет
превышать: превышает
оспаривать: оспаривать
доверие: доверие
фотография: фотографии
назойливый: назойливой
полевой: полевые
широкий: широкие широкий широким широкую
гордо: гордо
агрессивный: агрессивная агрессивное
хороший: хорошие лучший
уход: уходе уход
знать: знать
последователь: последователей
евгений: евгений
собаковод: собаководу собаководов
титул: титулом титула титулами титулы
уютный: уютном
упростить: упростить
оститься: остатся
климат: климат климату
высокий: высокая высокой высокий
питомник: питомники питомника питомник
переносить: переносят
подружейный: подружейным подружейной
благоприятно: благоприятно
отдавать: отдавать
выбирать: выбирайте
глаз: глаза глаз
проказа: проказы
тактика: тактику тактика
должный: должен должна
ностальгия: ностальгии
бордоский: бордоский
целеустремлнный: целеустремлнный
создавать: создают
начаться: началась начался
тщательный: тщательный
сопровождение: сопровождении
дрессировщик: дрессировщика
элитный: элитной
травля: травле травли
профилактика: профилактики
поинта: поинты
век: века веке век вв
америка: америку
право: праву
год: года лет год году
существовать: существуют
буквально: буквально
грациозный: грациозной грациозных
рычание: рычание
прогулка: прогулка прогулку прогулки прогулок прогулке
взять: взяли
реакция: реакция
поскольку: поскольку
охотничий: охотничьи охотничьих охотничьей
формула: формула
краткий: краткая краткий
свой: своими своим своего
безоговорочный: безоговорочной
натуральный: натуральная натуральной натурального
отношение: отношение отношению отношения
место: место месте места
маникюр: маникюра
класс: классом классов
край: края
корм: кормами кормом
аллергический: аллергическая
эксперт: экспертов
купать: купать
заячий: заячья заячьи
сопровождать: сопровождают сопровождали
блеснуть: блеснуть
удаление: удаление удаления
любимец: любимцем любимца
вконтакте: вконтакте
свет: свет
рядом: рядом
шрстный: шрстный
переход: переход
шарпить: шарпей
осмыслить: осмысленный
ярко: ярко
обращение: обращения
примечательный: примечательны
потребовать: потребует
хозяин: хозяин хозяином хозяину хозяина хозяине
отличный: отличную отличный
продажа: продажу
туловище: туловища туловище
столп: столпа
животное: животных животным животного животными животные животное
кинологический: кинологической кинологического
один: одного одна одной
фасоль: фасоль
сырой: сырую сырой
работа: работой работу
мяч: мячом
достояние: достояния
спрессовать: спрессованных
сша: сша
земля: земле
чреватый: чревато
малый: малейшего
характер: характером характеру характер
устояться: устоявшихся
волос: волос
длина: длины длина
тон: тон
спокойный: спокойным спокойном
выбрать: выбрать
облик: облик
невидимый: невидимые
ловкость: ловкостью
защитный: защитный
рабочий: рабочим рабочих рабочего
основать: основана
охотник: охотниками охотник охотником охотники охотников
продукт: продуктов продуктами продукты
подвижный: подвижной подвижным
охранник: охранника охраннике
расстояние: расстоянии
кожа: кожу кожа кожей
внешний: внешней внешний
бесценный: бесценны
еженедельный: еженедельного
незначительный: незначительные
красавица: красавица
установить: установить установит
ворс: ворса
жареный: жареную жареного
убить: убить
эктропий: эктропия
проблема: проблемы проблем
осмотр: осмотре
очищаться: очищается
порода: породам породы пород породу порода
понимать: понимающие
жить: жил
квартира: квартире
дать: даст
чуткий: чуткому
глазной: глазным
коммуникабельность: коммуникабельности
мера: меру мере меры
влажный: влажным влажными
информация: информация информации
руководствоваться: руководствовались
подходить: подходит подходят
телосложение: телосложение
бокс: боксе
оттенок: оттенков оттенки оттенок оттенками оттенком
резиновый: резиновой
масса: масса
человеческий: человеческих
тесный: тесный
создание: создание
жир: жир
зуб: зуба зубах зубьями зубы зубов
хотеть: хочет
сустав: суставы суставов
палец: пальцами пальцев палец
будущее: будущем будущего
спинка: спинка
передний: передними передние
активный: активного активный активная активном активных активной
выбор: выбор
ниже: ниже
кошка: кошкой кошки
оживлнный: оживлнного
угодье: угодья
язвочка: язвочек
утратить: утратит
вакцина: вакциной
крепкий: крепкие крепким крепкое
воспринимать: воспринимать
радовать: радовал
сухой: сухой сухие сухая сухим
польза: пользу польза
ребёнок: детям детей детьми
неполный: неполная
классический: классический
ощупь: ощупь
среди: среди
гнт: гнта
предел: пределами пределах
племенной: племенной племенного
число: число числу числе
сохраниться: сохранились
дуга: дуги
неагрессивный: неагрессивны
спать: спать
лапа: лапах лапами лапы лап лапе
это: этим это
рельефный: рельефной
учесть: учесть
веко: веки
избавить: избавит
программа: программы
вскоре: вскоре
подружиться: подружиться
длинный: длинные длинная длинной
сгладить: сглажен
центр: центре
подход: подходе
загривок: загривком
оккупация: оккупации
затылочный: затылочного
повысить: повысите
самостоятельный: самостоятельным
берег: берегу
избыточный: избыточным избыточная
развитый: развитый
пигментировать: пигментированной
расположение: расположением
объм: объм
трудиться: трудился
частый: частые чаще
отвислый: отвислая
коричневый: коричневыми коричневый коричневого
выжла: выжлой
ваш: вашим вашей вашего ваша
обмыть: обмыть
гибкий: гибкий
дополнить: дополнить
находить: находить
несложный: несложном
земной: земного
провинция: провинции
удаляться: удаляются
отдохнуть: отдохнуть
золотистый: золотистых
мировой: мировой
низкий: низкая низкую низкой
лес: лесу
считать: считают считая
женский: женского
угол: угла углы
усилие: усилия
добавить: добавьте
чистка: чистка чистке
двухкратный: двухкратном
остановиться: остановиться остановились
привязать: привяжите
завораживать: завораживают
холка: холка холке
обернться: обернтся
анализировать: анализировать
начинающий: начинающему
происхождение: происхождения
заболевание: заболевания заболеваний
резкий: резкий
задуматься: задуматься
необходимо: необходимо
аристократический: аристократическом
готовый: готовы
передвигаться: передвигается
пропорциональный: пропорциональны
скопление: скопления
выходец: выходцы выходца
частично: частично
лишнный: лишнный
задний: задние задним
психика: психику
незаменимый: незаменимым
вакцинация: вакцинации
тщательно: тщательно
разрез: разрез
гладкий: гладкая
дрессировка: дрессировка дрессировке дрессировки
предплечье: предплечья
время: время временах
сказаться: скажется
сука: суки сук сукой
толстый: толстыми
мочка: мочкой мочки
нимрод: нимрод
агрессивность: агрессивность
таков: таковы
великолепный: великолепные великолепным великолепных
требовать: требует
день: дней дня день
местность: местности
начать: начали
неустойчивый: неустойчивую
пясть: пясти
другой: другие других другими
просмотр: просмотров
шершавый: шершавые
использовать: используйте используют использовали
параллельно: параллельно
вылиться: выльется
терпение: терпения терпение
знакомство: знакомстве знакомству знакомства знакомство
вдали: вдали
тянуться: тянется
избежание: избежание
речной: речную
комфортно: комфортно
питаться: питаться питается
сетчатка: сетчатки
рост: рост
ответ: ответа ответ
отходить: отходит
касательно: касательно
редкость: редкость
скрытый: скрыты
зимний: зимних зимнее
определяться: определяется
сила: силы силу
правильный: правильном правильный
к: ко
вычсывания: вычсывания
нестерилизованный: нестерилизованных
реклама: реклама
подшрстка: подшрстка
петь: пет
дождться: дождтся
запах: запахи запаха
грызун: грызуны
остальной: остальные остальном
сечение: сечении
закрепить: закреплены
мускулатура: мускулатурой мускулатура
грубый: грубая
второй: второй втором
ягода: ягоды
проконсультироваться: проконсультируйтесь
ум: умом уму
ввоз: ввоз
зоошампунь: зоошампуни
вкус: вкус
выносливость: выносливостью
рекомендоваться: рекомендуется
привлекать: привлекали привлекают
спокойно: спокойно
воспитание: воспитание
жестокий: жестокое
тепличный: тепличных
достигать: достигает
грубость: грубость
малыш: малыш малыши малыша
имя: имени
беспричинно: беспричинно
элемент: элементов
дичь: дичи дичью
поднять: поднятая
вид: виду виде
опустить: опустите опущенном
регион: регионы
добавлять: добавлять
песчаный: песчаные песчаного
который: которыми которой которого которая которых которые который
завоевать: завоевать
руководство: руководством
задача: задачу задача
сайт: сайту
слышать: слышать
пренебрежительный: пренебрежительного
родословная: родословной
отложить: отложить
следствие: следствие
выпуклый: выпуклым выпуклый
нежели: нежели
специалист: специалисту специалиста
похвала: похвалу
добыча: добыче добычу добычи
противовес: противовес
покорение: покорение
крупный: крупная крупных крупными крупные
этот: эта этих
образовать: образованы образуют
лишь: лишь
калорийность: калорийность
течка: течки
домашний: домашними
немецкий: немецким
выводить: выводить
рбра: рбра
экстерьер: экстерьер
оболочка: оболочка
форум: форум форуме
вырастать: вырастают
заметить: заметить
жирность: жирность
португальский: португальская
варный: варную варными
расположить: расположено
белка: белки
страница: страницах
конец: концами конец
проточный: проточная проточной
звук: звуки
сделать: сделанные сделать сделали сделано сделает
тяжело: тяжело
конечность: конечностям конечности
напрасный: напрасными
кухня: кухню
нечистокровный: нечистокровную
любитель: любители
лоскуток: лоскутка
окрепнуть: окрепли
верхний: верхними
поставить: поставлен
пшеничный: пшеничного
значительно: значительно
кобелма: кобелм
убежать: убежала убежать
признак: признак
ресница: ресниц
описание: описание
замедлить: замедлят
стандарт: стандартом стандарта стандарту стандарт
опираться: опирается
скрестить: скрестили
налта: налта
доверительный: доверительные
гигиена: гигиены
приступать: приступать
декоративный: декоративные
лопатка: лопатки
взаимодействие: взаимодействие
здоровье: здоровьем здоровье
округлый: округлые округлыми
габарит: габаритам
найти: найти
сглаживаться: сглаживаются
однако: однако
увлажннный: увлажннным
искренне: искренне
римский: римской
страх: страхом
отварный: отварное
отличаться: отличаются отличались
обработка: обработка
личный: личным
поэтому: поэтому
предлагать: предлагают предлагаемых
копирование: копирование
активность: активность активности
предусматривать: предусматривает
федерация: федерации
основание: основания
дружелюбность: дружелюбность
незнакомец: незнакомцам
прибегать: прибегать прибегайте
раненый: раненую раненой
заингроч: заингроче
насыщенный: насыщенного
плавно: плавно
направление: направление
отзыв: отзывах отзывы
громкий: громкий
ожить: ожившие
увеличение: увеличение
остаться: остались
неприятный: неприятный
выделение: выделения
толкнуть: толкнуть
шум: шум
особь: особи
прививать: прививают
процедура: процедуры процедура
уровень: уровня уровень
прямой: прямая прямую прямой прямого
популярность: популярностью
щткать: щтку
прибегнуть: прибегнуть
чистый: чист
импорт: импорт
аксессуар: аксессуар
наслаждаться: наслаждаются
назад: назад
резец: резцами
лгкостя: лгкости
шар: шара
цвет: цвет цвета цветом
клиника: клинику
работать: работают
кость: кости
интерес: интерес
мочь: могут
умение: умению умением
изящный: изящные
игра: играх игры
локоть: локти
предпочтительно: предпочтительно
удобство: удобства
возраст: возрастом возраста возрасте
генотип: генотипом
произойти: произошла произошло
формат: формата
кровать: кровати
вакцинировать: вакцинируют
зубной: зубных зубной зубная
ухо: ушей ушах ушами уши
заусеница: заусеницы
возобновить: возобновили
профессиональный: профессионального
целое: целом
объявление: объявления
предпочтительный: предпочтительны
медленно: медленно
основной: основные
решение: решение
полова: половой
удалиться: удалится
единственный: единственного
интеллект: интеллект интеллекта
охранный: охранные
смывать: смывают
беременность: беременностью
вес: вес весом
спина: спину спиной спина
охотиться: охотиться
постоянный: постоянного
игривый: игрив игривым
выполнять: выполнял выполнять
палитра: палитра
помочь: помогут поможет
благородный: благородный
питание: питания питанию питании
незаметный: незаметными
голос: голос
линять: линяют
ежедневно: ежедневно
приучить: приучить
нос: носа нос
сон: сна
жировой: жировой
бег: бега
шубка: шубке
воспалительный: воспалительный
чткий: чткие чткими
диаметр: диаметр
экспорт: экспорт
немногочисленный: немногочисленных
изогнутый: изогнут
подходящий: подходящая подходящих подходящим
полезный: полезные
л: л
повреждение: повреждения
отклонение: отклонения
чрезмерный: чрезмерная
отвисать: отвисают
хромать: хромает
поплавать: поплавать
продолжительность: продолжительность
оказать: оказали
галопом: галопом
паста: паст пасту
борзая: борзые борзыми
протекать: протекающий
вспоминать: вспоминали
физический: физическим
диван: диване диван
курс: курс
отлично: отлично
лептоспироз: лептоспироза
линия: линия линии
привыкнуть: привыкнет
страна: страны странах страна
горло: горле
флис: флиса
мигрировать: мигрировавшие
военный: военным
запястье: запястья
говорить: говорят
оборонительный: оборонительную
размять: разомнут
водяной: водяная
развитие: развития
нужда: нужды
почтный: почтным
результат: результате результату
одежда: одежду
научить: научить
очертание: очертаниями
регулярный: регулярного регулярные регулярной
преданность: преданности
уверять: уверяю
утвержднный: утвержднные
слегка: слегка
обязанность: обязанность
тот: те тех тому
насадка: насадку
бутилировать: бутилированной
опасный: опасных
купание: купание
фото: фото
хлеб: хлеба
прибылой: прибылых
допускаться: допускается
маленький: маленького меньше
два: две двух
сам: самого
яндекс: яндекс
сладкое: сладкое
пущий: пущей
состав: состав
ускорение: ускорении
светло-жлтая: светло-жлтая
терпеливый: терпеливым терпеливы
массовый: массовый
участие: участие участия
ребнка: ребнка
оставлять: оставлять
череп: череп
социализация: социализации
сравнение: сравнении
атака: атаку
общий: общей
сбрасывать: сбрасывают
фрисби: фрисби
дворянин: дворянами
многообещающий: многообещающим
дружелюбный: дружелюбным
суровый: суровому
журнал: журнал
тяжлый: тяжлые
неделя: недели недель неделю
весь: всей
лежак: лежаке
высота: высота высоту
что-то: чем-то
кличка: кличке клички
ст: ст
такса: такса
нуждаться: нуждаются нуждается
статуя: статуи
постав: постав
определить: определить
мариновать: маринованную
отсутствие: отсутствия отсутствие
образование: образование
уживаться: уживаются
нянька: няньки
кисломолочный: кисломолочными
холистик: холистик
покров: покров
болезнь: болезни
вызвать: вызвать
уклоняться: уклоняется
нежелательный: нежелательной
ограничиться: ограничиться ограничьтесь
вдоволь: вдоволь
активно: активно
птичий: птичьего
кипяток: кипятком
белый: белого
кобель: кобелям кобели кобелей кобелями
кислота: кислот
бледно-жлтый: бледно-жлтый
приметный: приметной
будущий: будущих
охота: охоте охота охоты
предпочитать: предпочитают
внимательно: внимательно
ринуться: ринется
яйцо: яйцами
зверь: зверя
подсушивать: подсушивающим
наклонный: наклонный наклонные
селекция: селекции селекцию
мускулистый: мускулистое мускулистый мускулистые
проявить: проявить
разлука: разлуку
тряст: тряст
привлекательный: привлекательнее
допустимый: допустимы допустима
удочка: удочке
присущий: присуща
пролить: пролить
плохо: плохо
движение: движения движении
прыжок: прыжка
скакательный: скакательные скакательных
перекус: перекус
сумма: сумму
входить: входила
заметно: заметно
сородич: сородичами
дсный: дсен
заросль: зарослях
добрый: добрейшая
труд: труда
этап: этап
большой: большого велик большом
жирный: жирное жирных
перейти: перейти
внести: внесли
счастие: счастью
свирепый: свирепом
необходимый: необходимых
ткань: ткани
из-за: из-за
нетипичный: нетипичную
главное: главное
интроверт: интровертами
послать: пошли
костяк: костяком
максимум: максимум
вступать: вступает
псовый: псовыми
поведение: поведение
принять: принятые приняли
овощ: овощами
больший: большей
слово: слова
закруглнный: закруглнный закруглнными
восторг: восторг
собранный: собранными
прохождение: прохождение
красновато-золотистый: красновато-золотистого
весомый: весомый
менее: менее
устроить: устройте
освободиться: освободившись
помтом: помтом
трться: тртся
определять: определяет
причинить: причинить
разработка: разработки
первичный: первичной
лактоза: лактозы
дефект: дефектов дефекты дефектами
поцелуй: поцелуями
обрезание: обрезания
упаковка: упаковке
откуда: откуда
продуктивный: продуктивном
улучшить: улучшить
во-вторых: во-вторых
ударить: ударите
грудь: груди грудь
сложиться: сложилась
кочевник: кочевники
цель: целью
обстановка: обстановке
обзавестись: обзавелись
копчный: копчную
требоваться: требуется
развить: развита
ши-тец: ши-тцу
зимой: зимой
комок: комок
реестр: реестр
раскосый: раскосый
угрожать: угрожает
сместить: смещены
атрофия: атрофия
мастер: мастер
веслой: веслой
восполнение: восполнения
неться: нестся
внешность: внешностью
пример: примеру
обрести: обрела
бездельничать: бездельничать
зрение: зрению
тёмный: темнее
вольер: вольере вольер
просвет: просвета
промысл: промыслом
вынести: вынесены
оценка: оценке
полоса: полосы
рубль: рублей
появиться: появились
ландшафт: ландшафта
пообщаться: пообщаться
пойнтер: пойнтеры пойнтеров пойнтерам
своевременный: своевременном
круг: кругу
пользоваться: пользоваться
разведение: разведения
фашизм: фашизма
нежный: нежны
вечером: вечером
отрабатывать: отрабатывать
нервничать: нервничает
простуда: простудам
трх: трх
полость: полости
опасность: опасность
правило: правило правила
нежирный: нежирное
мелочь: мелочью
уверенность: уверенности
воспаление: воспаления
дог: дог
паннония: паннонии
кот: котов
варьироваться: варьируется
лесной: лесной
отработка: отработки
видеть: видят
каждый: каждый каждая
неизвестно: неизвестно
риск: риска риск
короткий: короткие короткая
часть: часть
иметь: имеет имеют
обратиться: обратиться обратитесь
влияние: влияние
элегантный: элегантнее элегантная
изгрызть: изгрызенный
стоимость: стоимость
клубочек: клубочком
утренний: утренние
вычсываться: вычсывается
приобрести: приобрести приобрела
осмотреть: осмотрите
процесс: процесса процесс
иначе: иначе
особенно: особенно
гарантировать: гарантируют
мимолётный: мимолетном
последний: последние
распространяться: распространялись
час: часов
дефицит: дефицит
включать: включать включает
защитить: защитив
достаточно: достаточно
принимать: принимали
обязательно: обязательно
международный: международной
рыжий: рыжими
бдёр: бдер
клетка: клетке
подыскать: подыскать
редко: редко
любой: любых любой
когтереза: когтерез
сочетаться: сочетается
нагрузка: нагрузках нагрузкам
привести: привели
переходить: переходят переходит
уделять: уделяли
европа: европы
подарить: подарит
щетина: щетины
встревожить: встревожена
тщательность: тщательности
уравновесить: уравновешенных уравновешенную
автомобильный: автомобильного
несмотря: несмотря
купить: купить
носить: носить
улучшение: улучшению улучшения
часто: часто
сильный: сильную сильные сильными
упустить: упустит
научиться: научились
желание: желание желания
вертикально: вертикально
грудной: грудной
упоминание: упоминание
путь: пути
тонкий: тонкая
разводить: разводили
интерьер: интерьера
период: периоды период
горделивый: горделивую
установиться: установившимся
предок: предки
аджилить: аджилити
ласка: ласка
рождение: рождения
паразит: паразитов
корпус: корпусу корпус
погодный: погодным
судьба: судьба
рекомендация: рекомендации
стойка: стойку
своенравный: своенравным
внушительный: внушительную
нрав: нравом
золотой: золотые золотым
оказаться: оказались
рассчитывать: рассчитывать
считаться: считались
живой: живой
следующий: следующий следующее
наличие: наличие
слезоточивость: слезоточивости
минеральный: минеральных
похвалить: похвалите
запретить: запретили запрещено
нежелательно: нежелательно
толстой: толстой
непроизвольно: непроизвольно
редкий: редкими
бугор: бугра
шерстинка: шерстинки
крупа: круп
требование: требований
племя: племени
пилочка: пилочки
далеко: далеко
представлять: представляют
одноклассник: одноклассники
высыпание: высыпаний
скорее: скорее
вс: вс
сучий: сучий
появление: появлению
кожный: кожные
солнышко: солнышком
дисплазия: дисплазия
правда: правда
возможность: возможности возможность
представительница: представительница
отдельный: отдельный
предъявлять: предъявляют
случайный: случайные
кроме: кроме
наблюдаться: наблюдается
мясо: мясо
вылазка: вылазку
трубчатый: трубчатые
навык: навыками
любопытство: любопытство
чувство: чувство
умственный: умственным
гребень: гребни
углубление: углубление
подшрсток: подшрсток
предать: преданные
поиск: поиск поисках
делать: делают
заи: заи
получить: получить
протестировать: протестирует
идеальный: идеальный
очертить: очерченной
пасмурный: пасмурный
дело: делам
выполнить: выполнит
жилетка: жилетку
закисание: закисания
параллельный: параллельны
волосок: волосков
безысходность: безысходностью
разрешить: разрешено
раздумывать: раздумывая
существование: существовании
поворачиваться: поворачиваются
себя: собой
белые: белые
апорт: апорт
выглядеть: выглядят
отбор: отбора
гончая: гончие
шампунь: шампунем
инфекционный: инфекционного
ротовой: ротовой
барьер: барьера
плотоядный: плотоядных
ежегодный: ежегодной
помогать: помогали
переусердствовать: переусердствовать
сбоку: сбоку
круп: крупами
лакомство: лакомством
потребность: потребность
горох: горох
порок: пороки
главный: главным главные главная
река: реки
забота: заботы
средство: средство средства средством
повод: повод
смекалка: смекалкой
изменять: изменять
составить: составят составит
спальня: спальню
недокус: недокус
сократиться: сократилось
остевой: остевой
вовсе: вовсе
опухоль: опухоль
линька: линьки линька
золотисто-рыжеть: золотисто-рыжей
нападать: нападают
жизнь: жизни
собаковод-новичок: собаководов-новичков
заканчиваться: заканчивается заканчиваются
комбинезон: комбинезон
общество: обществе
соколиный: соколиной
сезонный: сезонными
наполнять: наполнять
справление: справления
мир: мире мира
благодаря: благодаря
бурно: бурно
современный: современная
шелковистый: шелковистая
затем: затем
ветеринарный: ветеринарную
комната: комната
впервые: впервые
мадьяров: мадьяров
светлый: светлый
адаптироваться: адаптироваться
вправду: вправду
проживание: проживания
железа: железы
супер-премиум: супер-премиум
шоу: шоу
нужно: нужно
мимимишность: мимимишности
настойчивость: настойчивость
также: также
параметр: параметры параметров
обзаведтесь: обзаведтесь
однородный: однородным
умный: умная
идеал: идеале
вещь: вещь
момент: моменты
встать: встанут встанет
сушить: сушат
вызывающий: вызывающих вызывающие
город: городе города
весна: весной
кончик: кончику
оставить: оставит
подкладка: подкладке
живот: живота
витаминный: витаминных
поясница: поясница
приподниматься: приподнимаясь
устойчивый: устойчивым
выработать: выработанных
окончание: окончание
некупированный: некупированный
частичный: частичная
поджарый: поджарых
дисфункция: дисфункция
сбой: сбои
продолжать: продолжали продолжают
трава: траве
умеренно: умеренно
вытянутый: вытянутого
косточка: косточки
высоко: высоко
агрессия: агрессию
потенциальный: потенциальной
упитанный: упитан
пушной: пушного
сковать: скованные
критерий: критерий
осанка: осанку
сложно: сложно
отмереть: отмерших
область: области
стоить: стоит
нежно-розовый: нежно-розовый
петров: петров
эпилепсия: эпилепсия
неоднородный: неоднородный
приобретение: приобретению
брыть: брыли
любить: любит любят
ножницеобразный: ножницеобразный
подолгу: подолгу
огородить: огороженную
щенячий: щенячьего
умалять: умаляют
сведение: сведению
обучать: обучать
плоский: плоские
сохранять: сохраняет
благоприятный: благоприятная
добродушный: добродушны
удачный: удачный
способный: способен
войско: войска
трусливый: трусливое
нелишний: нелишним
повседневный: повседневной
использование: использование
одного-двуха: одного-двух
легко: легко
ежеминутно: ежеминутно
оградить: оградить
пластичность: пластичности
манера: манера
одобрить: одобрит
рынок: рынка
свежеть: свежей
лента: ленту
словно: словно
воспитать: воспитать
премиум: премиум
порция: порции
лоб: лбом
яблоко: яблокам
перчатка-фурминатор: перчаткой-фурминатором
запереть: запертая
ванная: ванную
половина: половине
изучение: изучению
лай: лай
сбалансировать: сбалансирован
продолжительный: продолжительного
некрупный: некрупными
увеличить: увеличили
отвиснуть: отвисшие
жсткай: жсткая
пасти: пасти
гладкошрстный: гладкошрстный
во-первых: во-первых
эластичный: эластичные
желать: желая
вакансия: вакансии
приучать: приучайте
вычсывать: вычсывать
возвращение: возвращения
прикус: прикус
апартамент: апартаментов
намка: намка
дальнейший: дальнейшем
специализированный: специализированного
склонный: склонных склонны склонным
чистокровный: чистокровных
голень: голени
выше: выше
отдыхать: отдыхаете отдыхать
молоко: молоко
пищеварение: пищеварением
окрасить: окрашены окрашена
цениться: ценились
обойтись: обойтись
большинство: большинстве большинство
бешенство: бешенства
вместе: вместе
течение: течение
веский: веской
похожий: похожи
изучать: изучать
позаботиться: позаботиться
трофей: трофеем
царить: царил
специя: специями
ещ: ещ
покупка: покупка
вздутие: вздутие
катаракт: катаракта
рейтинг: рейтинг
похвастать: похвастать
восточный: восточного
член: членами
ряд: ряд
популярный: популярными
подписываться: подписывайтесь
шутка: шутку
погоня: погоня
присутствие: присутствие
означать: означает
покидать: покидали
самостоятельно: самостоятельно
малоэффективный: малоэффективны
бесстрашно: бесстрашно
прижать: прижаты
хвост: хвоста хвост
наградить: наградите
очень: очень
площадка: площадку
соперник: соперниками
показаться: покажется
поддаваться: поддаются
поводок: поводка
аборигенный: аборигенных
вина: виной
радостный: радостные
покраснение: покраснение
постепенно: постепенно
черта: черта
двухмесячный: двухмесячном
довольно: довольно
купировать: купировать
держать: держать
благородство: благородство
надбровный: надбровные
мужчина: мужчин
энтерит: энтерита
касаться: касается
враждебно: враждебно
граница: границы
самочувствие: самочувствие
проверка: проверку
втираться: втирается
взрослый: взрослых
п-образный: п-образное
проект: проекте
канада: канаде
русский: русскими
настроить: настроены
родословный: родословных
жевательный: жевательная
кг: кг
плавание: плавания
выставлять: выставляют
необходимость: необходимости
среднее: среднего
эмаль: эмаль
минимальный: минимальная
липучка: липучками
перчатка: перчатки
фрукт: фруктами
естественный: естественный
контроль: контроль
низко: низко
темперамент: темперамент
плечевой: плечевые
уголок: уголке
любимый: любимым
ход: ход
щитовидный: щитовидной
встречаться: встречались встречаются
брид: брид
суша: суше
радужный: радужная
распространнный: распространнных
стая: стае
наедине: наедине
независимый: независимым
представить: представлена
красноватый: красноватым
плюсна: плюсны
утончнный: утончнное
книга: книг
родитель: родителей
привлечь: привлекли
вызывать: вызывает
питательный: питательных
упругий: упругой
представитель: представители
слой: слой
случай: случае
раковый: раковая
рысью: рысью
карьер: карьерах
венгр: венгры
загнутый: загнутые
специальный: специальном специальный
неопущение: неопущение
жалеть: жалеть
уделить: уделить
шаг: шаг
