заметить: заметили
дорогостоящий: дорогостоящие
пилочка: пилочку
овощ: овощи
персона: персоне
повод: поводом повод
использовать: используя используйте использовали
мускулистый: мускулистых мускулистая
тело: тела тело
пигментация: пигментацию пигментации пигментация
кровь: крови кровей
широко: широко
средний: средняя среднее
счастие: счастье
аргентинский: аргентинских аргентинскому аргентинские аргентинского аргентинский
ныне: ныне
пища: пища пищи пищу
использоваться: используются использовалась
сколько: сколько
колено: коленях
быть: будете е будьте
морской: морскую
предоставить: предоставить предоставьте
душа: души душе
название: название названия
собака: собаку собаками собакой собак собака собаке собаки
зажиточный: зажиточного
вывести: вывести выведенной
ноздря: ноздри
физический: физических физическими
обсуждение: обсуждения
выгнутый: выгнутая
агрессия: агрессии агрессию
оно: оно
подкожный: подкожного
цена: цена цене
рыба: рыбу
тщательный: тщательное тщательной тщательного
внести: внесла
заметка: заметку
содержаться: содержится
любой: любая любое любом
материал: материалов
раскрытый: раскрытые
казаться: кажется казалось
взгляд: взглядам
разразиться: разразиться
землевладелец: землевладельца
обратить: обратите
туманный: туманного
размер: размерам размеров размерами размер
антонио: антонио
овальный: овальную
качество: качествами качестве качества
любовь: любовь
стоять: стоят
сторона: стороны
испанец: испанцы
инстинкт: инстинкты инстинктах
игра: игру игры
положительный: положительных положительного
город: город города
субпродукт: субпродукты
выраженный: выраженный выражен
апчхи: апчхи
россия: россия
живот: живот
сбалансированный: сбалансированным сбалансированные
морда: морде морды морда
раковина: раковины
забыть: забудьте
обратный: обратная
бесконтрольно: бесконтрольно
смочь: сможете сможет
сотня: сотни
представитель: представителей представителя представителем представителями представители
начинающий: начинающих
шея: шея шеи
мартинес-младший: мартинес-младший
предвещать: предвещал
выплеснуть: выплеснуть
шерсть: шерсть шерсти
брат: братья братьям
доминантный: доминантный доминантен доминантным
документ: документы
выгодно: выгодно
соответствовать: соответствуют
население: население
розовый: розовый
гость: гостя
буквальный: буквальном
челюсть: челюсти челюстей
завезнный: завезнных
должный: должны должен должно должна
скуловой: скуловые
самый: самая самый самым самых
пересечение: пересечение
случайно: случайно
факт: факта
содержать: содержать
энергия: энергию
отмереть: отмерший
неожиданный: неожиданный
алано: алано
человек: людям людей человеку человека
пастуший: пастушья
относиться: относится относятся
питомец: питомцами питомцу питомец питомца питомцем
месяц: месяц месяца месяцев
подпортить: подпортило
промакивать: промакивайте
достойный: достойными
великобритания: великобритания
общение: общения
мышца: мышц
некоторый: некоторых
назвать: назвать
спустя: спустя
ромашковый: ромашковым
дело: дел деле
ценный: ценный
отличаться: отличается отличаются отличались
формат: формат
важно: важно
небольшой: небольшое небольшой
признак: признаками признак признаком
дисквалифицировать: дисквалифицирующими дисквалифицирующих
конкиста: конкисты
дог: догом дога догу доги догов дог
история: история историю
свирепость: свирепость свирепостью
бифштекс: бифштексе
щенок: щенка щенков щенки щенок щенкам
томат: томаты
уживться: уживтся
ирландский: ирландского ирландский
однородный: однородные
внимательный: внимательны
наш: наших
замкнутый: замкнутым
желательный: желательна
тплый: тплой
продолжать: продолжай
нередко: нередко
кордовский: кордовских кордовские кордовскую
характеристика: характеристика
немецкий: немецкий
род: рода
помощь: помощью помощь
экземпляр: экземпляры экземпляров экземплярами
предать: преданным
включить: включить
нос: носу носа нос
специальный: специальное специальной
соответствие: соответствии
отметка: отметку
около: около
зарождение: зарождения
купание: купания
следующий: следующие следующего
год: годы года лет год году
обусловливать: обусловливают
камень: камня
независимый: независимую независимый независимым
еда: еды
копчный: копчные
заворот: заворот
порода: породе породам породы пород породами породу порода породой
мальчик: мальчика
отнюдь: отнюдь
ввязаться: ввязаться
стать: стала станут стали стало стал станет
спина: спине спины спина
обладать: обладать обладают обладает обладающий
появление: появление появлением появления
серебряный: серебряной
палец: пальцы палец
популяризация: популяризации
возможный: возможных возможные возможен
быстро: быстро
принесть: принест
вклад: вклад
сужаться: сужается
озлобить: озлобленных
основное: основном
чисто: чисто
удаться: удалось
противник: противник
вырасти: вырасти
раз: раза
видео: видео
помимо: помимо
открытие: открытия
гетерохромия: гетерохромия
настороженно-скептический: настороженно-скептическое
очередь: очередь
компания: компании компанию
проведение: проведения
смелость: смелость
распространнный: распространнным
последний: последняя последнее последние последним последней
такой: таких такое такие такого
незначительный: незначительный
команда: командами команде команды команда
отдыхать: отдыхает
белоснежный: белоснежные белоснежную белоснежный
содержание: содержание содержания
государство: государство
чистый: чистыми чистом чистый
чрный: чрная чрного чрную
нужный: нужны
немного: немного
замечательный: замечательно
свет: света
озлобиться: озлобится
достойно: достойно
пропорционально: пропорционально
мартинес: мартинеса мартинесов мартинес
волкодав: волкодава волкодав
пропорция: пропорциями
массивный: массивный
оставаться: остаются
ветеринар: ветеринару
пахра: пахра
эксперимент: эксперимента
масло: масло
зеландия: зеландия
ушной: ушные
новый: новая новых новыми новой нового
территория: территорию территории
связь: связь
представлять: представляли представляют
контакт: контакта
трещина: трещин
гибель: гибель
угол: углом углы угол
превышать: превышать превышает
тип: типов
данные: данными
вода: воде вода
внешность: внешность
единственный: единственный единственная единственной
мягкий: мягкой мягкие
поинт: поинтов
лоб: лба
владелец: владельцев
уплощнный: уплощнные
войдт: войдт
пока: пока
ориентироваться: ориентироваться ориентируйтесь
жир: жира
смутный: смутные
от: ото
система: систему системой
профессиональный: профессиональных профессиональными
нрав: нрава
осанка: осанкой осанку
подойдт: подойдт
свора: свору
вязка: вязки вязке
крылатый: крылатая
приятный: приятную приятным
растительный: растительное
аристократ: аристократ аристократа
возможность: возможностей возможность
давать: давать давайте
мир: мир мире мира
здоровяк: здоровяк
вооружиться: вооружилась
размять: размять
нежность: нежностью
двадцать: двадцать
лидерство: лидерство
мебель: мебель
плотно: плотно
куриный: куриного
постоянный: постоянным постоянном
смотреть: см
друг: друзья друг другом друга другу
кордова: кордова кордовы
фотография: фотографии
работать: работать работал
уход: уходе ухода уход
нанимать: нанимал
помнить: помните
результат: результатов результатами результата
бордоский: бордоским
дать: данной
страдать: страдают
высокий: высокая
питомник: питомники
становиться: становитесь становится
верхний: верхней верхняя
породить: породил
находиться: находиться находится
неукротимый: неукротимого
глаз: глаза глаз
климатический: климатическими
решать: решать
бойцовый: бойцовые бойцовую
кинолог: кинолог
корм: корм корма
слабый: слабую
вопреки: вопреки
начаться: началась
самостоятельный: самостоятельной
часть: части
дый: дого
аргентино: аргентино
незначительно: незначительно
неприхотливый: неприхотливы
травля: травле
профилактика: профилактики
поговорка: поговорки
век: века веке век
смысл: смысле
вести: вести
купировать: купированными купированные купированы
софья: софья
поскольку: поскольку
неудачный: неудачная
проявлять: проявляют проявляли
охотничий: охотничьи охотничьих охотничьей
сбить: сбитым
сохранить: сохранит сохранить
краткий: краткая
весьма: весьма
обзавестись: обзавестись обзавелась
бордосский: бордосский
сильный: сильная сильные
натуральный: натуральная
отношение: отношение отношению
заболевание: заболеваниям заболевания
вкупе: вкупе
место: место местах
незаконный: незаконного
полный: полную полной полное полным
случиться: случилось
ветвь: ветви
шимфа: шимфу
край: края краями
отметить: отметить
способ: способов
сородич: сородичей
весь: весь
эксперт: экспертов
местный: местное
десять: десять
вконтакте: вконтакте
рядом: рядом
зарегистрировать: зарегистрирована зарегистрированная
впечатление: впечатление впечатлений
кровожадность: кровожадности
создать: создать
переход: переход переходе
корректный: корректной
ярко: ярко
роль: роль
отличительный: отличительная
действенный: действенных
развитие: развитие
закруглнный: закруглнные
животное: животных животным животного животными животные животное
кинологический: кинологической кинологического
один: одного одной одном
полагать: полагал
существование: существования
мяч: мячом
чадо: чадо
общий: общий общего
центральный: центральная
светлый: светлых
малый: малейшего
характер: характером характера характер
волос: волос волоса
длина: длины длина
привязанность: привязанности
выбрать: выбрать
австрийский: австрийский
упрямый: упрям
поддержка: поддержку
подчркивать: подчркивает
мясистый: мясистые
изделие: изделия
преподношение: преподношения
обводка: обводка
основать: основана
аллергик: аллергик
хотя: хотя
расти: рос
присмотр: присмотра
предпочтительный: предпочтительнее
способствовать: способствуют
редкий: редкой
свый: свом
прочный: прочный
больший: большая большие
ворс: ворса
форма: форму формы
бельмо: бельм
описать: описать
глубокий: глубокие
ворчать: ворча
огромный: огромными
официально: официально
мера: меру
соблюдать: соблюдайте
сочетать: сочетают
известный: известны
мирный: мирные
информация: информация
влажный: влажным
подходить: подходит
создание: создание созданием
оказать: оказал
двухразовый: двухразовое
сво: сво
мочь: могли могут
мускулатура: мускулатуры мускулатура
проводить: проводить
сложить: сложенное
усыплять: усыпляют
острый: острый острые острыми
половина: половины
дружба: дружбе
окрас: окрас окрасов
сдержать: сдержанного
конец: концу конец концы
подставка: подставки
обманчивый: обманчивой
хотеться: хотелось
габарит: габариты
сидеть: сидят
среди: среди
участвовать: участвовала
дуга: дуги
выполнение: выполнении
кризис: кризис
категорически: категорически
это: этим это
веко: веки
вскоре: вскоре
обильно: обильно
крепкий: крепким
длинный: длинные длиннее длинный
считаться: считается
желудочно-кишечный: желудочно-кишечным
собаковод: собаководов
любимый: любимой любимым
особый: особом
ваш: ваше вашим вашей ваш вашего вашем ваших ваша
аллергия: аллергия
порция: порция
развитый: развитый
британский: британских
объм: объм
счастливый: счастливым счастливыми
свирепый: свирепой свирепыми свирепое
тысяча: тысяч
массаж: массажем
оценивать: оценивает
шлифовать: шлифовали
фрукт: фрукты
прославить: прославить
который: которое которыми которого которая которых которые который
чистоплотный: чистоплотных
отсутствовать: отсутствовать отсутствуют отсутствовали
добавить: добавьте
хороший: лучший хороший лучшие лучших
несуществующий: несуществующую
прогулка: прогулки прогулкой
обязанность: обязанностями
сложённый: сложены
происхождение: происхождения
резкий: резкий
задуматься: задуматься задумайтесь
рбрам: рбрам
готовый: готовы готовый готовые
пиренейский: пиренейская
покров: покровов покров
материальный: материальный
молочка: молочка
заблуждение: заблуждению
задний: задние
бдра: бдра
черта: черты черта
организация: организация
тмный: тмную
ситуация: ситуация
приобрести: приобретите приобрести приобрели приобрела
партнров: партнров
дрессировка: дрессировка дрессировке дрессировки
предплечье: предплечья
стандартный: стандартный
нервный: нервную
обособленный: обособленный
время: время времена временем
сука: суки сук сука
прямой: прямым прямой
агрессивность: агрессивность
бизнес: бизнеса
слово: слову
машина: машины
защищать: защищать
день: дней дня день
вес: веса вес
противный: противном
пясть: пясти
кость: костей кости
другой: другие других другими другим
держать: держит держали
вираж: вираж
сила: сила сил силу
хозяин: хозяином хозяину хозяина хозяине
оборот: оборот
взрослый: взрослого взрослыми
выучить: выученными
злак: злаки
задолго: задолго
русло: русло
знакомство: знакомстве
фенотип: фенотип
речной: речную
исчезнуть: исчезли
национальный: национальное
вступать: вступали
несколько: несколько
поверхность: поверхность
пойнтер: пойнтер
рост: рост
потомство: потомство
крутой: крутой
предполагать: предполагает
согласно: согласно
августин: августин августину августина
определяться: определяется
мышечный: мышечную
экономический: экономический
правильный: правильном правильным
значительный: значительный
умеренный: умеренное умеренным
видение: видение
перина: перины
реклама: реклама
оттаять: оттает
первый: первым первого первый
важный: важную
львиный: львиная
линять: линяет
бой: бой боях
грызун: грызуны грызунами
наклон: наклон
качественный: качественные
подчеркнуть: подчеркнуть
рекомендоваться: рекомендуется
выносливость: выносливостью
проблема: проблемами
воспитание: воспитание воспитании
явно: явно
комната: комнаты
лгкий: лгкий
здоровый: здорового здоровым здоровый
малыш: малыш малыша
повизгивание: повизгиванию
посол: послам
вид: виду виде вид
драчливый: драчливого
порок: пороках пороки
поддержание: поддержания
прямоугольный: прямоугольный
задача: задачу задачи задача
оставить: оставите
сайт: сайту
отменный: отменным отменными
бывать: бывает
родословная: родословной
выпуклый: выпуклым
позволять: позволяет
мощный: мощная мощные
скрываться: скрывается
дорогой: дорогое дорогих
паста: пастой
поднимать: поднимайте
чайный: чайной
кожа: кожа кожей
этот: эта этих
лишь: лишь
набрать: набрать
вариант: вариант варианта
сын: сыновей сыновья
рбра: рбра
экстерьер: экстерьер экстерьером
гить: гено
форум: форум форуме
обретта: обретте
апартамент: апартаментах апартаментам
протяжение: протяжении
вверить: вверенную
зоя: зои
паспорт: паспорт
требовать: требуют
магнифика: магнифика
капля: капли
купироваться: купируются
весомый: весомым весомый
шампунь: шампуни
ухо: ухом ушей уха ушами уши
характерный: характерную характерен
мясо: мяса мясо
почсывание: почсывание
отворить: отворят
грейхаунд: грейхаунд
ровный: ровные
видеть: видя видеть видели
поврнут: поврнуты
изрядно: изрядно
земля: земли
описание: описание
рано: рано
виноград: виноград
начало: начало
скрестить: скрестили
дорога: дорогой
враждебность: враждебность
декоративный: декоративные декоративными
здоровье: здоровьем здоровье
середина: середине
торговля: торговлю
распорядок: распорядок
зубной: зубного зубную
собачий: собачьих собачьем
оказаться: оказалась
гибрид: гибрид
глубоко: глубоко
однако: однако
несчастный: несчастным
проветривать: проветриваемым
голень: голеней голени
внушительный: внушительные
гордый: гордой
некупированный: некупированных некупированные
дыхательный: дыхательный
устраивать: устраивать
отсутствие: отсутствием отсутствия отсутствие
поэтому: поэтому
живность: живность
случай: случаев случаи случае
копирование: копирование
захватить: захватить
победа: победу
прекрасно: прекрасно
достоинство: достоинств
активность: активность активностью
предусматривать: предусматривает
существовать: существует
федерация: федерации
дружелюбность: дружелюбность
незнакомец: незнакомцам
мама: мамой мама
приподниматься: приподниматься
попасть: попали
приподнять: приподнят
армия: армия
спортивный: спортивных
брезгливый: брезгливых
отзыв: отзывах отзывы
громкий: громкий громким
крупный: крупных крупнее крупными крупные крупным
кошка: кошки кошками
следовать: следует
кил: киле
масса: массе массу
выделение: выделения
толкнуть: толкнуть
животный: животному
шум: шум
осознание: осознание
ореховый: ореховую
широкий: широкий широкая широких
заметный: заметное заметны
союз: союз
тврдуть: тврдую
совершенствование: совершенствовании
составлять: составляют
сквозняк: сквозняков
популярность: популярностью популярность
щткать: щтку щтки
вырывать: вырывала
допустимый: допустимо
мать: матери
очищать: очищать
придться: придтся
отлучать: отлучать
назад: назад
бросаться: бросаются
цвет: цвет цвета
терпеливый: терпеливое
свободный: свободны свободными свободное
настоящий: настоящий
интерес: интерес
дом: дома
осторожно: осторожно
сегодняшний: сегодняшний
локоть: локти
предпочтительно: предпочтительно
встревожить: встревожен
завидный: завидным
кровать: кровати
целое: целом
объявление: объявления
сделать: сделать сделаете сделано
отдельный: отдельное
основной: основные
интеллект: интеллект интеллектом
охранный: охранные
многие: многие
солнечный: солнечным
виднеться: виднеются виднеется
ежедневно: ежедневно
понадобиться: понадобится
разведение: разведение разведения
банный: банный
чткий: чткие
съедаться: съедается
обладатель: обладателями
бультерьер: бультерьеры бультерьеров
причина: причине причины
именно: именно
подходящий: подходящая
ходьба: ходьбы
ловкость: ловкость
чрезмерный: чрезмерная
собираться: собираться
свежий: свежая свежие
ласковый: ласковое ласкового ласковым
продолжительность: продолжительность
вязать: вязать
май: мае
международный: международная
аппетит: аппетитом
отлично: отлично
расположить: расположенные расположены
чм-то: чм-то
линия: линия линий линией
туман: тумане
страна: страны странах страна
горло: горле
голубой: голубая
зуб: зубами зубы
запястье: запястья
ослабить: ослабленную
скрещивать: скрещивать
бобовый: бобовые
оттенок: оттенок
варный: варные
сформулировать: сформулировал
нужда: нужды
утро: утрам
зависимость: зависимости
осень: осенью
плотность: плотность
одежда: одежду
сохранять: сохранять
опорно-двигательный: опорно-двигательной
южный: южных
слегка: слегка
тот: те тому той
плюсневой: плюсневые
аргентина: аргентины аргентина
насадка: насадку
опасный: опасных
употреблять: употреблять
предпочитать: предпочитаем предпочитают
остров: островах
фото: фото
питание: питание
нетипичный: нетипичных
игривость: игривостью
выделяться: выделяются
два: две двух
сам: самого сама самом
сустав: суставами суставов
будущий: будущий будущему
яндекс: яндекс
дефект: дефект дефектам
привлекательный: привлекательным
залаять: залает
рука: руках руку
участие: участие
ребнка: ребнка
хотеть: хотите хотели
оставлять: оставлять
рукавица: рукавицы
череп: черепа череп
социализация: социализации
сравнение: сравнении
атака: атаку
отклонение: отклонение
лапа: лапы
собрать: собраны
холка: холке
создата: создат
относить: относят
верный: верным верного
решить: решит
журнал: журнал
четыре: четыре
высота: высота высоту
загривок: загривок
отец: отец
что-то: чем-то
глаукома: глаукома
мастиф: мастиф
внешний: внешнему внешний внешнюю
рассердить: рассержен
градус: градусов
нуждаться: нуждаются нуждается
фундамент: фундамент
отвесно: отвесно
еженедельно: еженедельно
дрожжи: дрожжах
уживаться: уживаются
скучать: скучать
обеспечить: обеспечьте
агрессивный: агрессивное
болезнь: болезни
аргентинец: аргентинца аргентинцем
заводчик: заводчиков заводчика
юноша: юноши
чрезмерно: чрезмерно
обоняние: обоняние
уравновесить: уравновешенным
телесный: телесного
легенда: легендой
аналогичный: аналогичных аналогичным
достояние: достояние
скученный: скученные
бульдог: бульдоги
минута: минут
сера: сера
незапертый: незапертых
мячик: мячика
образ: образом
доля: доля
охота: охоте охоты
неопытный: неопытных
висок: висков
простой: простых
опухнуть: опухшие
достигать: достигать
неприемлемый: неприемлемо
внимательно: внимательно
включать: включайте включать
рельеф: рельефом
дешёвый: дешевле
подвес: подвеса
распространить: распространены
слезоточивость: слезоточивость
преданный: преданнее
кобель: кобели кобелей
глухота: глухота глухоты
движение: движения
упомянуть: упомянутые
чаять: чает
отложить: отложите
признать: признала
грозный: грозный
жирный: жирное
развитой: развитой развитых
являться: являются
перейти: перейти
скрещивание: скрещивания
статус: статус
отто: отто
ткань: ткани
размашистый: размашистым
разный: разные
из-за: из-за
главное: главное
регулярно: регулярно
соперник: соперника
максимум: максимум
поведение: поведение
убийство: убийств
коготь: когтей
ключ: ключи
эксклюзивный: эксклюзивное
уголок: уголках
жалобный: жалобным
охотник: охотники
уровень: уровне
расчсывать: расчсывают
иностранный: иностранных
успешный: успешной успешном
добродушный: добродушным
приспособление: приспособление
грудь: груди грудь
иголочка: иголочки
вместо: вместо
слишком: слишком
одиночество: одиночеству
опираться: опираясь
альбион: альбиона
телохранитель: телохранителя телохранителей
придата: придат
обвисать: обвисает
стандарт: стандарта стандарту стандарт
причастный: причастен
выдающийся: выдающимися
гибкий: гибким
сместить: смещены
работа: работа работ
белый: белый
подаваться: подаваться
второй: втором
колония: колонии
желание: желанием
араукан: араукана
густой: густой
наблюдение: наблюдений
повторяться: повторяется
оценка: оценке
рубль: рублей
родина: родине
сперва: сперва
несение: несения
тридцать: тридцати
размеренный: размеренный
веслый: веслую
накопление: накопление
диск: диском
трх: трх
полость: полости
отварный: отварную
правило: правило правила
нежирный: нежирное
кабель: кабель
слабо: слабо
внимание: внимание внимании
шерстяной: шерстяной
блестящий: блестящей
варьироваться: варьируется
поздно: поздно
каждый: каждый каждому
корзина: корзины
компенсироваться: компенсируется
девять: девять
короткий: короткие
выбирать: выбирая
удалять: удаляют
количество: количестве
преподносить: преподносил
иметь: имеет имеющие имеют имеющих
сон: сны
выставка: выставке
обратиться: обратиться
повинный: повинную
напугать: напугать
прообраз: прообразом
стоимость: стоимость
алано-испанский: алано-испанские
особенно: особенно
убирать: убирает
австралийский: австралийская
желательно: желательно
автоматически: автоматически
предугадать: предугадать
осмотреть: осмотреть
звоночек: звоночком
возле: возле
книга: книгой
достаточно: достаточно
драться: дрались
обязательно: обязательно
ответ: ответов ответ
любить: любите
распространяться: распространяется
подшрсток: подшрстком
ребёнок: ребенком детьми
круглый: круглые
успеть: успели
стаффбуть: стаффбули
тихо: тихо
незваный: незваного
возраст: возраста
прибегать: прибегая
нагрузка: нагрузках
неделя: неделю
переходить: переходят переходит
европа: европы
подарить: подарит
список: списке
распространение: распространении
поставить: поставили
северный: северные
несмотря: несмотря
дойти: дошли
сладость: сладости
купить: купить
часто: часто
среднеазиатский: среднеазиатская
семья: семье
свой: своего своей своих своему свои
побоище: побоищ
вопрос: вопросом
образоваться: образовались
процедура: процедура
вынудить: вынуждено
ушко: ушки
помощник: помощника
очередной: очередную
предел: пределах предел
прижиться: прижились
радовать: радующим радует
дедушка: дедушка
промывать: промывать
поглощать: поглощаемой
шлейка: шлейки
голова: голова
горделивый: горделивую
ласка: ласка лаской
демонстрировать: демонстрирует
невыполнимый: невыполнимую
контур: контуры
поощрять: поощряйте
строение: строению
адрес: адрес
галоп: галоп
неравномерный: неравномерное
сожаление: сожалению
прочно: прочно
активный: активную активное
выворот: выворот
рассчитывать: рассчитывать
делать: делает делали
наличие: наличие
чаемый: чаем
прорезиненный: прорезиненной
спасательно-разыскной: спасательно-разыскных
проникновение: проникновения
нежелательно: нежелательно
сердце: сердце
толстой: толстой
руководствоваться: руководствуясь
уверенность: уверенность
крупа: круп
справляться: справляется
английский: английский
нестабильный: нестабильную
современный: современного
желаемый: желаемые
совпадать: совпадает
джентльмен: джентльмен
испанский: испанской
природный: природную
одноклассник: одноклассники
укорачивание: укорачивания
миска: мисок
вс: вс
кожный: кожные кожных
дисплазия: дисплазия
скорость: скорость
случайный: случайные
передний: передние
кроме: кроме
взять: взять
чм: чм
саблеобразный: саблеобразную
треугольник: треугольника
трубчатый: трубчатые
плоский: плоских плоские
углубление: углубление
частый: чаще
поиск: поиск
несоответствующий: несоответствующую
колебание: колебания
слышный: слышно
нежиться: нежиться
преобладание: преобладанием
заядлый: заядлые
контрастировать: контрастируют
крайний: крайней
себя: собой
образовать: образует образуют
белые: белые
запастись: запаситесь
компаньон: компаньоном
пробежка: пробежкой
период: период
собственный: собственное
затылочный: затылочная
жажда: жажда
дичь: дичь
сочный: сочном
ротовой: ротовой
пятно: пятно пятном
страх: страхе
сторож: сторожа
миндалевидный: миндалевидные
орех: орехи
чёрный: черным
учесть: учтите
лакомство: лакомством
потребность: потребность
условие: условиями условия
живт: живт
смекалка: смекалкой
кровожадный: кровожадное кровожадных
остевой: остевой остевого
вовсе: вовсе
линька: линьки линька
жизнь: жизни
конфедерация: конфедерацию
овчарка: овчарка
забывать: забывайте
общество: обществе
соединить: соединены
красивый: красивые
едва: едва
говорить: говорить
благодаря: благодаря
телосложение: телосложением
выуживание: выуживания
плодотворный: плодотворной
плечо: плечи
запах: запах
терпение: терпением
сухой: сухим
обеспечивать: обеспечивает
лоскуток: лоскуток
проживание: проживания
сменить: сменила
обещать: обещают
дсон: дснах
обучение: обучение
относительно: относительно
мимимишность: мимимишности
толчок: толчок
также: также
процесс: процесс
параметр: параметры
втирать: втирайте
чистка: чистке
любимец: любимца
помочь: поможет
несдобровать: несдобровать
момент: моменты момент
пахрамагнифика: пахрамагнифика
возможно: возможно
совместный: совместного
сквозь: сквозь
весна: весной
подушечка: подушечках
бегать: бегать
дверь: дверей двери
универсальный: универсальной
корпус: корпус
гармоничный: гармоничные
брылястость: брылястость
весёлый: веселее
пользоваться: пользовались
смешивать: смешивать
великолепно: великолепно
порог: порог
сложно: сложно
складка: складки
крипторхизм: крипторхизм
ослик: ослик
крайне: крайне
область: области
стоить: стоит
спутник: спутника
подкармливать: подкармливали
неоднородный: неоднородный
прибылой: прибылые
ножницеобразный: ножницеобразный
трусливый: трусливый трусливое
зависеть: зависит
щенячий: щенячьего
квартира: квартиры
кормить: кормить
неполный: неполную
походка: походку
требовательный: требователен
хвостатый: хвостатых
ньюфаундленд: ньюфаундленд
победитель: победителями
невозможно: невозможно
австралия: австралия
забавный: забавную
поднять: поднимут
ям: ямы
европейский: европейской
довольствоваться: довольствуется
служба: службы
подарок: подарок
товар: товаром
хаос: хаос
телевизор: телевизором
принять: примет
алабай: алабай
манера: манера
свежеть: свежей
лента: ленту
гармония: гармонии
колоссальный: колоссальную
селекция: селекцию
основа: основу
храбрость: храбрость
разнополый: разнополые
неутолимый: неутолимая
прародитель: прародителей
исключение: исключением
ватный: ватным
отличный: отличные
лай: лай
выходить: выходили
выдержать: выдержанными выдержанные
проявить: проявит
принимать: принимающим принимают
полдень: полудня
чутьм: чутьм
очаровать: очарован
желать: желая
вакансия: вакансии
молодой: молода
прежний: прежнее
этап: этапа
продукт: продукты
прикус: прикус
центр: центром
приходиться: приходится
полтора: полтора
устроиться: устроится
дальнейший: дальнейшем
сыграть: сыграл
рысь: рысь
сей: сей
выше: выше
маленький: меньше
расцениваться: расценивается
формировать: формируя
необычный: необычный
простудиться: простудиться
большинство: большинстве большинство большинства
вместе: вместе
важность: важности
добровольный: добровольный
мускулистость: мускулистость
вершина: вершины
царить: царил
ещ: ещ
покупка: покупка
триумф: триумф
играться: играется
изгиб: изгиб
посадить: посажены
сгладить: сгладить
главный: главная
практически: практически
излишний: излишнюю
полгода: полугода
рейтинг: рейтинг
мужчина: мужчина
вернуть: вернуть
карапуз: карапузом
подписываться: подписывайтесь
человеческий: человеческом
аллергично: аллергично
непродолжительный: непродолжительной
перешагнуть: перешагнул
совершеннолетие: совершеннолетия
впадина: впадины
бесстрашно: бесстрашно
прижать: прижаты
потакать: потакать
запретить: запрещено
очень: очень
обычно: обычно
щитовидка: щитовидки
обезжиренный: обезжиренная
минимальный: минимальном минимальная
второе: второе
покраснение: покраснение
малыш-аргентинец: малыши-аргентинцы
отмечаться: отмечается
наравне: наравне
иллюстрация: иллюстрация
кличка: клички
пёс: псом
благородство: благородство
отчаянный: отчаянным
обойдться: обойдтся
удивительный: удивительной
составить: составит
касаться: касается
гуарани: гуарани
необходимый: необходимые
гормон: гормонов
проект: проекте
число: числе
бочкообразный: бочкообразная
найдт: найдт
первостепенный: первостепенная
очертить: очерчены
кг: кг
хищник: хищниками
засопеть: засопит
смочить: смоченным
среднее: среднего
наглядный: наглядная
вычсывание: вычсывание
рацион: рацион
выпечка: выпечку
контроль: контроль
встречаться: встречались встречаются
определить: определены
ширина: шириной ширина
зазубрина: зазубрины
тракт: трактом
посадка: посадка
регулярный: регулярных
ирландия: ирландия
кормление: кормления
привычный: привычный
ненамного: ненамного
министерство: министерстве
недостаток: недостаток
ложка: ложки
навряд: навряд
конечность: конечности
расставить: расставлены
оба: оба
хвост: хвост
просмотр: просмотра
формула: формулу
губа: губы
сезон: сезона
частичный: частичной
стремительно: стремительно
приняться: принялось
она: ею
гораздо: гораздо
хвалить: хвалите
призниться: признатся
запрещать: запрещают
уделить: уделить
шаг: шаг
