ясно: ясно
тратиться: тратиться
иметь: имели имеет иметь имеют
обусловить: обусловлено обусловленных
талант: талантах
пигментация: пигментацию
караван: караванами
широко: широко
средний: средняя среднее средней средние средний
обильный: обильнее обильная
полотенце: полотенце
здоровый: здоровых
чёрный: черный черные черной
забронировать: забронировать
использоваться: используются
сколько: сколько
трехцветный: трехцветный
четверолапый: четверолапого четверолапых
эконом-класс: эконом-класса
уметь: умеют
душа: души
название: название названия
кинологический: кинологический кинологическими
солнцезащитный: солнцезащитным
продавать: продавать
милый: милы
собака: собаку собакой собак собака собаке собаки
сбиваться: сбивающейся
путаться: путаться
брить: брить
возникать: возникают
несложный: несложным
симптом: симптомы
обсуждение: обсуждения
наследственность: наследственностью
нестабильный: нестабилен
торговый: торговыми торговые
цена: цена
спать: спит спать
удаваться: удается
псиный: псины
любой: любая любой любым
материал: материалов
природа: природы
путь: путями
перевод: переводе
казаться: кажется кажутся
гардероб: гардероб
полоска: полоски
падкий: падки
уравнять: уравнены
олений: оленьего оленье оленьем
владелец: владельцам владельца владельцев владельцы
восхитить: восхитили
миниатюрный: миниатюрные миниатюрная
стоять: стоят
мускулистый: мускулистыми
качество: качествами качества
любовь: любовь
долгий: дольше
остановить: остановить
зато: зато
русский: русский
россия: россия
живот: живот животе живота
раковина: раковины
улучшить: улучшит
обратный: обратная
температура: температуры
корпус: корпусе корпуса корпусом корпусу корпус
начинать: начинают
эмоциональный: эмоциональную
предварительно: предварительно
гаррет: гаррет
представитель: представителей представители
команда: команду команда
шея: шея
волос: волосом волос
исполнять: исполнять
сводить: сводить
сильный: сильнейший
колбасный: колбасным
бультерьер: бультерьер
шерсть: шерсть шерсти шерстью
компаньон: компаньоны
женщина: женщину
кровососущий: кровососущих
влажный: влажные
среда: среды
рука: руками рукой
хохлатый: хохлатого хохлатой хохлатых хохлатая хохлатую хохлатые
нью-йоркский: нью-йоркская
один: одним одна одном
буквальный: буквальном
челюсть: челюсти
должный: должны должен должно должна
самый: самая самый самые
див: див
исключение: исключение исключения
хрупкий: хрупких хрупкая
стаффордширский: стаффордширский
относиться: относится относятся
месяц: месяц месяцев
олимп: олимпа
домик: домик
иметься: имеется
пикник: пикник
спустя: спустя
равно: равно
дверь: дверью
теория: теория
косметика: косметику
включая: включая
лоточник: лоточники
выраженный: выражен
важно: важно
иллюзия: иллюзию
расчёсывать: расчесывают расчесывайте
встретить: встретить
история: история историй
музыка: музыку
сообразительный: сообразительны
радость: радости
мазь: мазей
щенок: щенка щенков щенки щенком щенок
растительный: растительным
клубок: клубков
выполнять: выполняя
мыть: моют
морозный: морозную
настолько: настолько
пропитать: пропитанным
питомец: питомцев питомцу питомец питомцы питомцам питомца питомцем
породить: породила
обычный: обычный обычного
взрослый: взрослый взрослой
парадоксальный: парадоксально
голова: голове головы голова
зажать: зажмите
неизвестный: неизвестного
комплект: комплект комплектов
натурпитание: натурпитание
нередко: нередко
глазной: глазного
кровянистый: кровянистые
воронка: воронки
характеристика: характеристика
навязчивость: навязчивости
род: рода
стоп: стоп
этот: этими эта
главный: главных главная
такой: таком таких такое такие такую
супермаркет: супермаркета
руб: руб
пеленочник: пеленочники
свинин: свинине
эмоция: эмоции
еда: еды
порода: породе породы пород порода породой
значит: значит
дегтярный: дегтярным
вытерпеть: вытерпеть
палец: пальцы
быстро: быстро
кардинально: кардинально
первый: первой первом первые первым первое первый первую первых
основное: основном
беззубик: беззубиков
раз: раза
видео: видео
исключительный: исключительные
крем: кремах кремы кремом
подойти: подойдет
поднебесный: поднебесная
начать: начать
базироваться: базируется
внимание: внимания
взъерошить: взъерошенное
полностью: полностью
меню: меню
никакой: никаких
незапамятный: незапамятных
улица: улицу
домашний: домашних домашним
видоизменить: видоизменить
тело: телу теле тело
эффектный: эффектные эффектным
сальный: сальные
небольшой: небольших небольшие небольшой
прокол: прокола
зарасти: заросших
ваш: вашу вашей ваш вашего ваша
шапочка: шапочку
зарастать: зарастать зарастают
называть: называют называемой
содержание: содержание содержании содержания
присутствовать: присутствовать
собственный: собственного собственные собственной
корма: кормах
хвост: хвосте хвост
рождаться: рождаться
разновидность: разновидностей разновидности
какой-то: какой-то
жить: живет
умница: умница
обнаружить: обнаружить
сходство: сходстве
комар: комаров
услуга: услуги
ветеринар: ветеринару
воздух: воздуха воздухе
впадать: впадайте впадают
первичный: первичный
ушной: ушные ушной ушное
кстати: кстати
заглянуть: заглянуть
он: нему
появляться: появляться
территория: территорию территории
связь: связь
уделять: уделять
переносить: переносит переносить
точно: точно
журналистка: журналистка
контакт: контакта
клуб: клуб
ходить: ходят ходить
тип: типов типе типа типы
вода: воде
внешность: внешность
стойко: стойко
газета: газету
мягкий: мягкой мягкая мягкого мягким
эпилятор: эпилятор
энергичный: энергичные
овсянка: овсянке
расслабляться: расслабляться
характерный: характерного
хохолок: хохолки хохолок
прогулка: прогулкам прогулки
да-да: да-да
минимум: минимуму
пока: пока
стать: стали станет
чувство: чувства
смазывать: смазывают
антисептик: антисептиком
виноград: винограду
грумера: грумера грумеру
неизменный: неизменная
профессиональный: профессиональных
состояние: состоянии состояния состоянию
облегчить: облегченный
внешний: внешние внешнего внешний внешнем
собачий: собачьего собачьими собачьих
обладать: обладают обладает обладающие
аллергия: аллергии аллергию аллергия
тянуться: тянулась
год: годах лет год годов году
цирковой: цирковым
ида: ида
дважды: дважды
скелет: скелет
прикупить: прикупите
заявить: заявили
нижний: нижние
держаться: держался держится
коробка: коробка
уровень: уровнем
кремовый: кремовый
вкусняшка: вкусняшек
микроэлемент: микроэлементы
крысарик: крысарик
плотно: плотно
психика: психика психики
велосипедный: велосипедная
солнышко: солнышке
бесполезный: бесполезное
смотреть: см смотрите смотрят
коробочка: коробочек
племенной: племенную племенное
напрягать: напрягает
доверие: доверие
фотография: фотографии
завезти: завезенными
ассоциация: ассоциациями
субтильный: субтильной
агрессивный: агрессивная
надолго: надолго
уход: уходе уход
современный: современные современный современного
запутаться: запутавшуюся
период: периода периоды период
голубой: голубой
удобный: удобная
создание: создания
оповещать: оповещая
голый: голой голым голых голая голые
результат: результат
недорезать: недорезать
высокий: высокая высоким
перловка: перловке
питомник: питомники питомников питомник питомником
пищалка: пищалкой пищалки
выбирать: выбирайте выбирая
глаз: глаза глазами
плод: плоду
летний: летний
обыкновенный: обыкновенный
прийтись: придется пришелся
оратория: ораториями
следствие: следствием
реалия: реалии
самостоятельный: самостоятельной
шоколадный: шоколадный шоколадной
боготворить: боготворящая
часть: части часть
завидный: завидную
век: века
смысл: смысле
вести: вести
ветеринарный: ветеринарным
поскольку: поскольку
краткий: краткая
вой: воем
отношение: отношение отношения
недалёкость: недалекость
обаяшка: обаяшки
место: место месту
клумба: клумбах
малыш: малышей малыши малыша
ждать: ждете
миелопатия: миелопатию
пшённый: пшенная
отметить: отметить
сушка: сушкой сушка
одноразовый: одноразовым
яркий: ярче
эксперт: экспертов
узкий: узкие
факт: факт
бесшёрстный: бесшерстным бесшерстных бесшерстные бесшерстной
вконтакте: вконтакте
просмотр: просмотр просмотров
сваляться: свалявшихся
свет: свет
доказательство: доказательств
сходить: сходит
версия: версии
создать: создать
перспектива: перспектива
любимец: любимцев любимца любимец
тазобедренный: тазобедренных
потребовать: потребует потребуют
управляемый: управляемыми
средство: средств средства
проявиться: проявится
китайка: китайкой
кожа: коже кожу кожа кожи кожей
максимальный: максимальной
немаловажный: немаловажный
ценник: ценник
приучить: приучите приучить
животное: животных животным животного животные животное
различаться: различается
автомобиль: автомобиля
пустой: пустой
делишки: делишки
сша: сша
равнодушный: равнодушными
появление: появления
брат: братьям
сплавлять: сплавлять
висячий: висячее
характер: характером характер
склонность: склонностью
ухаживать: ухаживали ухаживающую
выбрать: выбрать
голыш: голыши голышей голышам голышу
скула: скулы
облик: облик
желание: желании желания
кровать: кровать
основать: основана
хотя: хотя
приплыть: приплывшей
продукт: продуктов
пуховый: пухового пуховых пуховая пуховой
интуитивно: интуитивно
бинт: бинтом
порядок: порядок
х: х
мячик: мячиком
искать: ищет
менять: менять
выгуливать: выгуливать
больший: большая большие
везде: везде
каражов: каражова
грелка: грелки грелку
атмосфера: атмосферу
проблема: проблемы проблема
уличный: уличному
познакомиться: познакомиться
будущий: будущей
чувствовать: чувствовать
собаководство: собаководства
пудра: пудры
светлеть: светлеют
середина: середины
мама: мамы маме
брачный: брачного
квартира: квартире квартирах
размер: размеры
официально: официально
мера: меру мере
соблюдать: соблюдайте
заметный: заметен
сырой: сырым сырые
перепад: перепадами
информация: информация
подходить: подходит подходить подходят
телосложение: телосложение
проходить: проходят проходит
имидж: имиджем
накормить: накормили
предугадывать: предугадывать
лес: лес
ребро: ребра
выбор: выбор
ниже: ниже
медицинский: медицинской
окрас: окрас окрасами окрасов
метод: методы
старость: старости
крокет: крокеты
крепкий: крепкие
пожилой: пожилая
сухой: сухой сухие сухая сухую
ребёнок: детям детей
увлечься: увлекся увлекшуюся
сравнительно: сравнительно
лапа: лапах лапы лап
признание: признанием
лежанка: лежанка лежанки лежанке
учесть: учесть учтите
течной: течной
колено: колени
витамин: витамины
обеспечить: обеспечены
считаться: считается
завести: завела
лечить: лечить
подготовка: подготовка
мероприятие: мероприятие
любимый: любимой
тонкий: тонкие
эпилировать: эпилировать
коммуникабельный: коммуникабельная
объяснить: объяснили
слизистая: слизистую
человек: людей человеку
континент: континента
китаец: китайца китайцы китаец китайцев
длиться: длится
водить: водить
соболиный: соболиный
мир: миру
воздействие: воздействию
шарик: шарики
попытка: попытка
покорять: покорять
сапожок: сапожками
мировой: мировой
низкий: низкая
который: которое которой которая которых которым которые который
вывих: вывих
заменить: заменить
чайный: чайного
миссис: миссис
ездить: ездить
добавить: добавьте
китайский: китайской китайские китайская китайских китайскую
происхождение: происхождения
заболевание: заболевания
тёмный: темные
увлажнить: увлажните
паудёр-паффами: паудер-паффами
наследственный: наследственные
необходимо: необходимо
готовый: готовы
терьер: терьер
китай: китаем китай
свой: своем свой своего своей своих свои
задний: задние задних заднее
заведомо: заведомо
редкий: реже редкий редкие
виртуозно: виртуозно
вид: вида
тщательно: тщательно
терпеть: терпеть
гламурный: гламурный
устраивать: устраиваемых
дрессировка: дрессировка
стандартный: стандартный
время: время времена времен времени
ватный: ватными
приблизительно: приблизительно
сука: суки сук сукой
проштрафиться: проштрафившегося
плохой: хуже плохую плохие
агрессивность: агрессивность
многочисленный: многочисленных
плюмаж: плюмажем плюмаж
погода: погоду
хохлатик: хохлатиков хохлатики
археолог: археологов
пясть: пясти
другой: другие других другим
американский: американский американского американская
хозяин: хозяином хозяину хозяев хозяина
традиционно: традиционно
юлия: юлия
неожиданно: неожиданно
пушистиковый: пушистиков
привезти: привезла
категория: категории
фобия: фобий
ничто: ничто
например: например
несколько: несколько
сетчатка: сетчатки
родина: родиной
отличный: отличная
рост: рост
располагать: располагают
ответ: ответа ответ
дисквалифицировать: дисквалифицировать
чувствительный: чувствительное чувствительны чувствительна
лёгкий: легкой
понравиться: понравившийся понравится
согласно: согласно
изделие: изделиям
бело-бронзовый: бело-бронзовый
обидеть: обидеть
девочка: девочек девочкам
нетривиальный: нетривиальным
нестерилизованный: нестерилизованных
соответственно: соответственно
незначительный: незначительному
мясо: мясом мясу мясо
фен: феном
реклама: реклама
использование: использованием
просить: просят
лосьон: лосьоном
линять: линяет
пенка: пенкой
высыпание: высыпания
отложение: отложений
зарост: зарост
малышка: малышка
доступный: доступный
рекомендоваться: рекомендуется
напоминать: напоминает
воспитание: воспитание воспитанием
дружелюбный: дружелюбны
кружиться: кружатся
делиться: делятся
выстригание: выстригание
прорезаться: прорезаются прорезались
насекомое: насекомых
экономичный: экономичнее
закрытый: закрытых закрытой
сайт: сайту
процедура: процедур
оба: обеими
понять: понять поняли
жировик: жировики
метить: метят
обустроить: обустройте
скрываться: скрывается
недуг: недугов
быть: будут
лишь: лишь
вариант: вариант варианты
долго: долго
тереться: трутся
окружающий: окружающей окружающих
стрижка: стрижка
течка: течке
звёздный: звездного
форум: форум форуме
азия: азию
защитить: защищенное
предпочтение: предпочтение
конец: конце конец концов
протяжение: протяжении
волокита: волокита
прямой: прямых прямые прямого
начало: начала начало начале
бело-кремовый: бело-кремовый
заводчица: заводчица
качественный: качественной
спутница: спутница
мальчик: мальчики
сатина: сатина
врождённый: врожденного
нагреть: нагретой
ровный: ровные
верхний: верхними
морской: морской
описание: описание
нормальный: нормальных
приспособление: приспособлениями
доказать: доказанный
убирать: убирать
мишень: мишень
пространство: пространство
хлоргексидин: хлоргексидином
миф: мифов
ревматизм: ревматизме
гигиена: гигиены гигиена
декоративный: декоративные
серьёзный: серьезный
паудер-пафф: паудер-паффов
холодность: холодность
глубоко: глубоко
длинный: длинный длинным длинная длинной
кровеносный: кровеносные
однако: однако
пражский: пражский
гладкий: гладкую
играть: играть
обитать: обитает обитать
магазин: магазина
поэтому: поэтому
предлагать: предлагают
пертёс: пертеса
копирование: копирование
промышленный: промышленных
угорь: угри
черепной: черепная
трудно: трудно
кондиционер: кондиционера
активность: активность
разрешить: разрешенными
полаять: полаять
красивый: красивая
дружелюбность: дружелюбность
коренной: коренные
отправиться: отправился
плавно: плавно
отзыв: отзывах отзывы
экзотика: экзотику
нога: ноги
остаться: остались
чистокровный: чистокровного
нужда: нужд
кошка: кошки
следовать: следует
очаровательный: очаровательный
пропорция: пропорций пропорции
способ: способ
свободный: свободные
шум: шум
диван: дивану
предупредить: предупредить
особь: особи особям особей
причёска: прической
резиночка: резиночкой
подсказать: подскажите
заводной: заводного
книга: книгу
актуально: актуально
назад: назад
породистый: породистого
пожалуйста: пожалуйста
всерьёз: всерьез
интерес: интерес
дом: дома доме
мочь: могут
уединённый: уединенный
звать: зову
телепатия: телепатии
привязанность: привязанность привязанностью
ножницы: ножницами
целое: целом
объявление: объявления
сделать: сделать сделано
белый: белым белый
станок: станком
основной: основные
сложный: сложный сложнее
паштет: паштеты
тесный: тесного
родитель: родителями
гипоаллергенный: гипоаллергенного гипоаллергенные
интеллект: интеллект
охранный: охранные
многие: многие
величина: величины
средне: средне
вес: вес
постоянный: постоянного
вымереть: вымершей
паудер-паффа: паудер-паффы паудер-пафф
собачка: собачкам собачек
широкий: широкая
ежедневно: ежедневно
лишний: лишнее
рада: рады
разведение: разведение разведению
кость: костям
именно: именно
серьёзно: серьезно
сухость: сухости
продолжительность: продолжительность
плотный: плотными
переводить: переводят
несоответствие: несоответствие
интеллигентный: интеллигентные
вытянутый: вытянута вытянутые вытянутым
горячий: горячей
отлично: отлично
питаться: питающимся
кератоконъюнктивит: кератоконъюнктивит
второй: вторая
неизменно: неизменно
отхватить: отхватить
доходить: доходит
опустить: опущен опущенными
дожидаться: дожидаться
процесс: процессу
британский: британские
полотно: полотно
картонный: картонных
осень: осенью
одежда: одежду одежды одежда одежде
кремово-белый: кремово-белый
вокруг: вокруг
цель: целях
никак: никак
бороться: бороться
умиротворять: умиротворяющую
слегка: слегка
тот: те тех
здравствуйте: здравствуйте
общительный: общительной
фото: фото
антисептический: антисептическим
м: м
жаловаться: жалуются
прирождённый: прирожденные
кхс: кхс
заодно: заодно
игрушка: игрушек
густой: густые густой
сустав: суставами суставов
тюфячок: тюфячок
яндекс: яндекс
практичный: практичных
желе: желе
количество: количество
дефект: дефект
детский: детским
почувствовать: почувствовав
давать: дают
народный: народные
уголок: уголок уголках
обожать: обожают обожаемым
экзекуция: экзекуцию
голливудский: голливудских
резиновый: резиновые
пытаться: пытаться пытаются
оставлять: оставлять
дегенеративный: дегенеративную
ухо: уха ушами уши
отклонение: отклонение
путешествие: путешествий
альбион: альбион
холка: холке
кулак: кулак
оценить: оценить
кинология: кинологии
журнал: журнал
неделя: недели неделю
подтечь: подтеки
высота: высота
гиперплазия: гиперплазию
вокалист: вокалиста
задуматься: задумайтесь
одетый: одетыми
понижение: понижению
морковь: морковь
скучать: скучает
гулять: гулять
обработать: обработать
пища: пищу
отсутствие: отсутствия
пищеварение: пищеварение
настроение: настроения
превосходный: превосходные
болезнь: болезни болезнь
пробка: пробки пробок
возможный: возможной
лоток: лоток
совершенно: совершенно
чрезмерно: чрезмерно
невыпуклый: невыпуклые
поиграть: поиграть
найти: найдено
ограничиться: ограничиться
минута: минут
пересыхать: пересыхает
выводить: выводят выводите
строгий: строгое
предпочитать: предпочитают
простой: проще простых
достигать: достигать
пищевой: пищевую пищевой
яблоко: яблоко
округлый: округлая
полтора: полутора
взгромоздиться: взгромоздиться
туалет: туалету туалетом
распродажа: распродаж
сам: сама самом
снизить: снизит
обернуть: обернуты обернутое
создавать: создающую
допустимый: допустимы допустимым
открытие: открытие
закупоривать: закупоривающие
кобель: кобели кобелем
плохо: плохо
весь: всему
условие: условиях условия
упрямство: упрямства
парочка: парочку
объявить: объявлены
взросление: взросления
такт: такта
гладко: гладко
помета: помете
противопоказанный: противопоказаны
манка: манке
этап: этап
немой: нем
нужный: нужен
перейти: перейти
старлетка: старлеток
закреплять: закрепляйте
витаминный: витаминный
реально: реально
из-за: из-за
регулярно: регулярно
лечебность: лечебности
главное: главное
махровый: махровое
действие: действием
максимум: максимум
поведение: поведение
грация: грация
коготь: когтей когтях
копировать: копируют
болевой: болевые
бело-чёрный: бело-черный
коренастый: коренастые коренастое коренастом коренастого
молока: молоку
скакательный: скакательными
менее: менее
артроз: артрозе
нежирный: нежирным
шёрстка: шерсткой шерстку
отменять: отменял
рыбка: рыбкой
кричать: кричите
наведаться: наведаться
третий: третьей
собрат: собратьев
рассказ: рассказы
отказываться: отказывается
костяк: костяк
заводчик: заводчикам заводчики
увы: увы
угощение: угощения
слишком: слишком
любознательный: любознательные
одиночество: одиночеству одиночество
будущее: будущего
уделить: уделите
молчун: молчуна
никто: никто
умный: умные
зимой: зимой
подшёрсток: подшерсток
ментальный: ментальных
стандарт: стандарта стандарту
африканский: африканской
мордочка: мордочка
забыть: забыть
посредством: посредством
изящный: изящным
богемный: богемных
незлобливый: незлобливым
морда: морда
удаться: удастся
капитулировать: капитулировал
появиться: появилось появился
ощущение: ощущения
капуста: капуста
спровоцировать: спровоцировать
оценка: оценке
измельчать: измельчать
рубль: рублей
пользоваться: пользоваться
мочка: мочка
смело: смело
неплохо: неплохо
удостовериться: удостовериться
правило: правило правила правил
провоцировать: провоцирующую
переусердствовать: переусердствуйте
поздно: поздно
каждый: каждый каждому
пушистый: пушистые
напрасно: напрасно
прыщ: прыщи
весить: весит
компенсироваться: компенсируется
короткий: короткие
катаракт: катаракту
удалять: удаляют удалять
выставка: выставке
чесапик-бей-ретривер: чесапик-бей-ретривер
стоимость: стоимость
бридер: бридеров
приобрести: приобрести
таиланд: таиланда
подкладывать: подкладывают
приправить: приправленные
восковой: восковые
особенно: особенно
ткань: ткань
личный: личное
жалоба: жалобы
тяжёлый: тяжелее
длина: длина длину
достаточно: достаточно
дрессировать: дрессировать
обязательно: обязательно
разочаровать: разочарует
породный: породному
тёртый: тертое
обязательный: обязательное
подтянуться: подтянулась
перекрыть: перекрыты
озорной: озорные
обязать: обязан
китайчатый: китайчат
пара: пару
успеть: успели
беременная: беременных беременным
сбивание: сбивания
прикус: прикусом
посвятить: посвятила
подбирать: подбирают
заячий: заячьего
куча: кучу
нередкий: нередки
азиатский: азиатские
заверение: заверениям
популярность: популярность
любитель: любителей
англия: англии
понимать: понимать
цениться: ценятся
несмотря: несмотря
исследователь: исследователи
смягчать: смягчают
купить: купить купите
часто: часто
подопечный: подопечных
подпал: подпалом
поставить: поставлены поставленные
потчевать: потчуют
заняться: займитесь
вуалевидный: вуалевидным
масло: маслом масла
безболезненный: безболезненный
некоторый: некоторое
пуховка: пуховка пуховкам пуховки пуховок
укус: укусов
вертикально: вертикально
осуществляться: осуществляется
беременность: беременности
свежий: свежем
что: чему
несчастие: несчастье
содержать: содержат
хозяйка: хозяйкой
стрессосниматель: стрессосниматели
правдоподобный: правдоподобных
рождение: рождения
вылазка: вылазки
ужасный: ужасные
прокатить: прокатят
функция: функцию
живой: живой живую живым
удаление: удалению
оказаться: оказалось
распаривать: распаривают
нежелательно: нежелательно
домочадец: домочадцев
правильный: правильным
английский: английский английского
рвать: рвет
обитатель: обитатели
втереться: втереться
барышня: барышни
вероятность: вероятность
грубеть: грубеет
далеко: далеко
ум: ума
навсегда: навсегда
знать: знают
шоколадно-подпалый: шоколадно-подпалый
одноклассник: одноклассники
скорее: скорее
сладость: сладостям
приподнять: приподнятым
волосок: волоски
правда: правда
пора: поры пор
чистить: чистить
токсикоз: токсикоз
грудь: грудь
свести: свести
кошачий: кошачье
приземистый: приземистее
случайный: случайные
передний: передние
кроме: кроме
движение: движении
утвердить: утвердившая утвержденному
бело-шоколадный: бело-шоколадный
сплошной: сплошной
доводить: доводить
эпилепсия: эпилепсию
сгодиться: сгодятся
воздушный: воздушной
отдельный: отдельным отдельных
содержимое: содержимое
частый: чаще
поиск: поиск
становление: становления
тёплый: теплого
зависимый: зависимы
чубчик: чубчик
комедон: комедоны
оптимальный: оптимальный
идеальный: идеальный идеальная
зуб: зубы зубов
неуправляемый: неуправляемыми
лезть: лезть
участок: участков
удлиняться: удлиняется
замёрзнуть: замерзнут
туда: туда
лишить: лишены
уютный: уютно
белые: белые
запастись: запаситесь
раскопка: раскопки
поводок-рулетка: поводке-рулетке
сторож: сторожа
дополнительно: дополнительно
нос: нос
ранний: раньше
ультрафиолет: ультрафиолета
колтун: колтуны
потребность: потребность
стесняться: стесняться
повод: повод
расход: расходов
вовсе: вовсе
пробираться: пробирались
три: тремя
жизнь: жизни
атрофия: атрофию
абсолютно: абсолютно
заканчиваться: заканчивается
забывать: забывайте
развлекушка: развлекушками
бортик: бортиками
они: ними
сильно: сильно
сосуд: сосуды
право: право правах
мешать: мешает
говорить: говорить говорит
благодаря: благодаря
выдавливать: выдавливают
плечо: плечи
запах: запах запаха
интеллектуально: интеллектуально
российский: российских
мыло: мылом
привязать: привязаны
курица: курице
изгиб: изгибом
туманный: туманный
мечтать: мечтала
правдивый: правдивы
обучение: обучение
супер-премиум: супер-премиум
отличать: отличает
относительно: относительно
нужно: нужно
мимимишность: мимимишности
также: также
деликатес: деликатесов
экстерьер: экстерьера
прогрессировать: прогрессирующую
идеал: идеале
понятие: понятии
момент: моменты момент
свидетельствовать: свидетельствует
сумка-переноска: сумку-переноску
поведенческий: поведенческого
мария: мария
прошлое: прошлого
побег: побегам
корзина: корзина
специальный: специальных специальным
имиджевый: имиджевая
сезон: сезонам
друг: друга
обучить: обучить
умеренно: умеренно
дискомфорт: дискомфорт
меняться: меняются
вредный: вредное
зоофорум: зоофорумах
привести: привести
ранее: ранее
косметичка: косметичке
конкретно: конкретно
серный: серных
вывозить: вывозите
вечеринка: вечеринках
прикрыть: прикрыты
сложно: сложно
кисломолочко: кисломолочка
стоить: стоит
это: это
расти: растущей
разный: разных
вельможа: вельможи
ужинать: ужинать
альтернативный: альтернативные
бедро: бедрами
обнимашка: обнимашки
чашечка: чашечки
вопрос: вопрос
взрастить: взрастить
бепантен: бепантен
аристократизм: аристократизма
кормить: кормить
держава: держав
вполне: вполне
развивающийся: развивающемуся
невозможно: невозможно
прочий: прочими
занятие: занятие
доброжелательный: доброжелательная
стол: стола
предшествовать: предшествует
прыщик: прыщиками
защищённый: защищенно
сидение: сиденье
игла: иглой
тренировка: тренировка
каша: каши
обучать: обучаемые
позволять: позволяйте
многий: многих
сосредоточенность: сосредоточенности
превратить: превратить
склонный: склонна склонны
несмышлёный: несмышленых
лента: ленту
выгул: выгула выгулов
кукурузный: кукурузная
здоровье: здоровье
подстроиться: подстроиться
известно: известно
макаров: макарова
весенне-летний: весенне-летний
длительный: длительный
вудс: вудс
признанный: признанными
стерильный: стерильным
уверить: уверены
отварный: отварной
просянка: просянки
перегрев: перегрев
сила: силу
выход: выход
вакансия: вакансии
удивительный: удивительная
поводок: поводок поводка
возня: возни
опускаться: опускаться
пёсик: песикам
покой: покоя
начинаться: начинается
встречаться: встречается
план: плане
вроде: вроде
обрабатывать: обрабатывать обрабатывают
фарш: фарша
выделение: выделений
генетически: генетически
смазать: смазать смазав
выше: выше
шри-ланка: шри-ланки
маленький: меньше
дебора: дебора
сорт: сорта
единственный: единственное
вывести: выведешь
случаться: случается
комплекс: комплекс
столетие: столетия
рыба: рыбе
корм: корма
рисовый: рисовая
большинство: большинство большинства
практически: практически
экзотический: экзотическим
хворь: хворей
рейтинг: рейтинг
генетический: генетических
гармоничный: гармоничную
ряд: ряд
палочка: палочками
судить: судить
подписываться: подписывайтесь
бритьё: бритья
стильный: стильной
степенность: степенность
ожог: ожог
мобильный: мобильны
запустить: запущенных
паника: панику
задеть: задеть
целый: целую
патологический: патологической
запретить: запрещено
спрятаться: спрятаться
очень: очень
пробудиться: пробудился
двигаться: движущегося
податливый: податливыми
обычно: обычно
загорать: загорать
немало: немало
мелкий: мелким
вели: вели
особенность: особенности особенность
бело-голубой: бело-голубой
обезжиренный: обезжиренная
достаточный: достаточное
водоём: водоемам
грациозный: грациозных
лысый: лысое
бритвенный: бритвенным
какой: какими
выщипать: выщипать
сплоховать: сплоховали
сидеть: сидевших
наоборот: наоборот
кто-нибудь: кто-нибудь
кличка: клички
частность: частности
список: список
отдавать: отдавали
возможность: возможность
старичок: старичков
дерево: дерева
гиперурикозурия: гиперурикозурию
касаться: касается
след: следы
необходимый: необходимые
молодой: молодых
дело: деле
неистовство: неистовство
комнатный: комнатная
бронзовый: бронзовый
шампунь: шампуня
трюк: трюкам
проект: проекте
житель: жители
иностранец: иностранцами
провозгласить: провозгласивший
депилировать: депилирующие
аллерген: аллерген
ксоло: ксоло
потомок: потомки
во-второй: во-втором
кг: кг
юный: юных
насколько: насколько
нанесение: нанесения
сей: сих
изогнутый: изогнутые
минимальный: минимальная
риск: риск
хрусталик: хрусталика
линька: линька
чудо: чудо
коленный: коленной
рацион: рацион
рот: рот
действительно: действительно
туловище: туловище
шелковистый: шелковистым
страна: страна
низко: низко
попечение: попечение
смочить: смоченное
комплекция: комплекции
внутренний: внутренней
спускаться: спускаться
становиться: становятся
мексиканский: мексиканской
причём: причем
развить: развитая
оставить: оставленное
присоединиться: присоединится
сузить: сужена
недостаток: недостаток
громкий: громким
подтянутый: подтянут
питательный: питательных
кормление: кормление
конечность: конечности
превращаться: превращаются
натуралка: натуралкой
портить: портящие
циркуляция: циркуляцию
случай: случае случай
возраст: возрасте
несанкционированный: несанкционированных
увлажнять: увлажняющих
предел: предела
неполный: неполный
гораздо: гораздо
способный: способны
страдать: страдающего
поездка: поездок
воспитанность: воспитанность
поход: походом
прокалывать: прокалывают
улучшение: улучшения
