ясно: ясно
движение: движениями движении
процесс: процессе процессу процесс процессов
попытка: попытке попытки
овощ: овощи
похожий: похожая
вноситься: вносились
широко: широко
фу: фу
невысокий: невысоким невысокая
параллельный: параллельные
добрый: доброго добрый доброе
пищеварение: пищеварения
верный: верную
выделяться: выделяется
чёрный: черный черные черной
посторонний: посторонних постороннему посторонним
сколько: сколько
склонный: склонен склонна
голодать: голодает
название: название названия названиях
примерно: примерно
собака: собаку собакой собак собака собаке собаки
среднестатистический: среднестатистические
состоять: состоит
хороший: лучшим хорошего хорошим лучшей лучший хороший лучшему хорошем хорошее
предприятие: предприятия
датировать: датируемая
обсуждение: обсуждения
решительный: решительными
оно: оно
годиться: годится
реализовать: реализовав
цена: цена цену цены
собака-лидер: собака-лидер
зачастую: зачастую
динамичный: динамична
мальчик: мальчик
материал: материалов
природа: природы природе
чистота: чистоту чистоты
быть: будучи будут
организация: организации организация
обратить: обратите обратить
постучать: постучите
натура: натуре
собственный: собственных
догообразный: догообразных
морской: морская
простой: простого простой проще
сторона: стороны
заинтересовать: заинтересовать заинтересовали
дисквалифицировать: дисквалифицирующие
обучаться: обучаются
инстинкт: инстинкты инстинктам
город: город
использование: использовании
россия: россия
обратный: обратная
охарактеризовать: охарактеризовать
следующий: следующих следующие
размер: размеров размеры размер размера
поведение: поведении поведение
ревностно: ревностно
охранник: охранник охранника охранником
микроскопический: микроскопические
шея: шея шее
овчарка: овчарки овчарок овчарке овчарку овчаркой овчарка
развитой: развитым развит развитой
внимательный: внимательное
фокстерьер: фокстерьер
шерсть: шерсть шерсти шерстью
магний: магния
документ: документы
ики-ек: ики-еке
пресекать: пресекайте
систематичность: систематичность
кальций: кальция
достаточный: достаточном достаточное
испортить: испортить
рыба: рыба
применять: применять
челюсть: челюсти челюсть
должный: должны должен должно должна
тип: тип типа
говядина: говядина
нарушение: нарушения нарушение
содержать: содержать
предупреждение: предупреждения
посадить: посажен
дружеский: дружеское
начать: начнет
сохранение: сохранения сохранении
человек: людям людей человеку человека человек
пастуший: пастушья
относиться: относится относиться относятся
месяц: месяц месяца месяцев
необходимый: необходимы необходимое необходимой необходим
иметься: имеется
сверху: сверху
нанести: нанесенными
преграждение: преграждением
служить: служить
выраженный: выражен выраженные
участие: участием участие
важно: важно
рис: рис
стабильный: стабильной
плюшевый: плюшевая плюшевого
повиноваться: повиноваться
история: история
брать: брать
выполнение: выполнение
кинологический: кинологических
щенок: щенка щенков щенки щенок щенками
обл: обл
проявляться: проявляется проявляющаяся проявляются
эффективный: эффективным эффективными
отбор: отбором
выгул: выгул выгуле
покупать: покупая
поощрять: поощрять
окружающий: окружающий
сбалансированный: сбалансированного сбалансированное
наш: наших
новый: новые
взрослый: взрослый взрослого взрослом
каждый: каждого каждом
форма: форма форму форм формы
разница: разница
кисломолочный: кисломолочные
семья: семьи семье
определение: определению
защитный: защитные
приниматься: принимается
своенравный: своенравен своенравный
предостережение: предостережение
характеристика: характеристика характеристики
стоп: стоп
выставка: выставках
блоха: блохами
выраженность: выраженности
девчата: девчата
заводчик: заводчик заводчиком заводчиков
зарождение: зарождения
горбоносость: горбоносость
ожирение: ожирение
сомкнутый: сомкнутых
вид: виды виде вид
лакомый: лакомый
значит: значит
признать: признан
проявить: проявивших проявив
нуждаться: нуждались
расстройство: расстройства
спина: спине спина
систематически: систематически
непростой: непростых
лающий: лающих
еда: еду еда
раз: раза
видео: видео
бездумно: бездумно
подойти: подойдет
данный: данном
внимание: внимания внимание
меню: меню
очередь: очередь
возникновение: возникновения возникновение возникновению
президент: президент
незапамятный: незапамятных
азиат: азиаты азиата азиатам азиат азиатов
пёс: псы псов пес пса
домашний: домашних домашней
вакцинация: вакцинация вакцинации
выделить: выделив
древний: древних
профилактика: профилактикой
гордый: гордый гордым
рацион: рациона рационе
опустить: опущена
вытряхивать: вытряхивать
образ: образ образом
проблематично: проблематично
содержание: содержание содержанием содержания
стать: станут стать станет
девочка: девочка девочки
целесообразность: целесообразность
сегодняшний: сегодняшним сегодняшнего
корма: кормах
потомок: потомком потомки
хвост: хвосте хвостом хвост
чужак: чужак чужака
допускать: допускать
алабайка: алабайка
слово: слово
пропорционально: пропорционально
составлять: составляет составлять
жестокий: жестоком
рекомендовать: рекомендуют
бурибасар: бурибасар
полечить: полечить
реагировать: реагировать реагируя реагируют
утверждать: утверждают
путь: путь пути
окрас: окраса окрас
покупка: покупкой
опубликовать: опубликованный
ушной: ушные
калечить: калечить
территория: территорию территории
проверить: проверенными
связь: связь
доверять: доверять
точно: точно
надёжный: надежного надежным
различие: различий различия
кусок: кусок
доза: дозу
понимание: понимание пониманием
граница: границу границы
повышенный: повышенным
прыгать: прыгать
залог: залогом
поведенческий: поведенческих
внешность: внешность
правильный: правильную правильного правильный правильное правильному
владелец: владельцев владельцы
профессионал: профессионалу профессионалам
артрит: артрита
лошадь: лошадьми
преступление: преступление
подгрудок: подгрудок
применительно: применительно
намного: намного
пока: пока
особый: особых особой особый
чувство: чувства
жир: жира
вспомнить: вспомнят
алатау: алатау
восток: востоке
яйцо: яйца
достижение: достижении
возраст: возрасту возраст возраста возрасте
безразличие: безразличием
мир: мир
сильный: сильных сильное сильному сильный
кочевник: кочевников кочевники
врач: врач
психика: психика психику психикой
определённый: определенные
достояние: достоянием
жидкий: жидкие
бумага: бумаги
лежать: лежит
признак: признаки признак
бобковый: бобкова
смотреть: см смотрите
тампон: тампон
друг: друзья другом друга
забрать: забрали
фотография: фотографии
осматривать: осматривать
широкий: широкие шире широкая
туркменский: туркменский туркменской
провокация: провокацию провокации
встречать: встречал
уход: уходе уход
суетливость: суетливости
стартовать: стартуют стартовало
помнить: помните
генетический: генетическими генетическом
губа: губа губы
законодательно: законодательно
страдать: страдать
опорно-двигательный: опорно-двигательного
фигурка: фигурка
высокий: высокая высшей высоким высокого высокими
питомник: питомники питомнике
неприхотливость: неприхотливость неприхотливостью
монстр: монстра
сложение: сложения
глаз: глаза глазами
прийтись: придется
следствие: следствием следствие
вопреки: вопреки
неприхотливый: неприхотливы
сказать: сказать
поздний: позже
век: века век
фосфор: фосфора
конечность: конечностях
год: года лет год годом годов
бойцовый: бойцовая
рычание: рычание
взять: взяли
психический: психических психического
реакция: реакция реакции реакциях
простейшее: простейшие
обучение: обучения
краткий: краткая
грамотный: грамотному
свой: своими своим свой свое своей своих свои
дорога: дороги
вычёсывание: вычесывании
отношение: отношение отношению
январь: январе
всякий: всякого
заболевание: заболеваниям заболевания заболевание
место: место местах месту
систематический: систематическом
отбраковать: отбраковать
терракотовый: терракотовая
малыш: малышей малыш малыша
приводить: приводит
чистый: чистую чистая чистые
гисмет: гисмет
урал: урала
приветствоваться: приветствуются
эксперт: экспертов эксперты экспертами
ранний: раннего
полоса: полосе
факт: факт
вконтакте: вконтакте
зарегистрировать: зарегистрирована
великан: великан
чуткость: чуткость
неверный: неверном
далее: далее
неуклюжий: неуклюжего
ярко: ярко
проявлять: проявлять проявляя проявляющему
пол: пол
подбородок: подбородок
животное: животных животным животного животное
мать: мать матери
одинаково: одинаково
информационно: информационно
сохранить: сохранившая сохранили сохранил
общий: общий общей
затылочный: затылочным
воспитатель: воспитателя
переводить: переводить
предупредительный: предупредительным предупредительный
длина: длины длина
привязанность: привязанности
питомец: питомец питомца питомцем
др: др
выбрать: выбрать
паразит: паразитами
окрепнуть: окрепшего
настоящий: настоящей настоящая
расхожий: расхожему
основать: основана
хотя: хотя
нижний: нижняя нижнюю
плембрак: плембраком плембрак
х: х
злобный: злобного
кожа: кожу
планировать: планирует
диабет: диабету
искать: ищет
коленный: коленного
рассчитать: рассчитать
выгуливать: выгуливать
больший: большая большей
витамин: витаминов
пасть: пасть
проблема: проблемы проблемам проблемами проблему
закон: закон
порода: породам породы пород порода
воплотиться: воплотились
беспокоить: беспокоить
точка: точки
квартира: квартире
дать: даст
актирование: актирования
проживать: проживает
информация: информация
подходить: подходит
гельминт: гельминтов
масса: масса
телосложение: телосложения
кошачий: кошачьими
хотеть: хочет хотите
физический: физического физические физическая
подстилка: подстилку
бесстрашие: бесстрашием бесстрашие
атаковать: атакует атаковать
недоверие: недоверие
спинка: спинка
привязываться: привязывается
выбор: выбор выборе
ниже: ниже
мытьё: мытья
тобет: тобет
характер: характера характер
тёплый: теплый
крепкий: крепкие крепкое крепкий крепкая крепкими крепкой
ребёнок: детям дети
различный: различным различных
предел: пределами
небольшой: небольшая
число: число
алабай: алабая алабаев алабаи алабай
веко: веки
вылечить: вылечить
зуб: зубах зубы
гармоничный: гармоничного
находиться: находится
без: безо
неподготовиться: неподготовившись
расширяться: расширяющаяся
просто: просто
забывать: забывать забывайте
взаимный: взаимное
обусловить: обусловлена
найти: найдет найденная найдя
прямоугольный: прямоугольной
тысяча: тысяч
уловка: уловок
учитывать: учитывая
каспийский: каспийского
фрукт: фрукты
отдохнуть: отдохнуть
независимый: независимый
низкий: низкая
купировать: купируют купированный купированы
который: которое которого которая которым которые который
передать: передали
считать: считают
локоть: локтей
добавить: добавьте
серьёзный: серьезную серьезное серьезной
животный: животном животному
умеренный: умеренная умеренное умеренный
происхождение: происхождения
начаться: началось
необходимо: необходимо
госагропром: госагропром
объективный: объективных
пробел: пробелы
орхан: орхан
пища: пищи
пигментация: пигментации
задний: задние
редкий: реже
черта: черты чертам черта
кобель: кобеля кобели кобелями кобель
тщательно: тщательно
запретить: запрещен запрещено
дрессировка: дрессировку дрессировка дрессировок дрессировки
игнорироваться: игнорируются
время: время времен времени
приблизительно: приблизительно
сука: суки сук сука
агрессивность: агрессивность
заварка: заварке
день: дней дня день
чрезмерный: чрезмерное чрезмерная
вес: веса вес
ограниченный: ограниченный
стирать: стирать
деятельность: деятельности
другой: другие других другими другим
клуб: клубах
просмотр: просмотров просмотра
серповидный: серповидную
характерный: характерна характерны характерно
смесь: смесями
мера: мере меры
близкий: близка
несколько: несколько
короткошёрстный: короткошерстных
рост: рост
ответ: ответа ответов ответ
голова: головы голова
потомство: потомство
согласно: согласно
отстреливать: отстреливали
значительный: значительный
великолепный: великолепного
к: ко
реклама: реклама
южный: южного
половой: половые половых
средний: среднее средних средней
свойственно: свойственно
первый: первым первое первую
аллергический: аллергические
готовый: готовых
мускулатура: мускулатурой
грубый: грубая
процедура: процедуру
среднеазиатский: среднеазиатских среднеазиатской среднеазиатская среднеазиатскую
выносливость: выносливостью выносливость
профессиональный: профессиональное
мочка: мочки мочке мочка
спокойно: спокойно
воспитание: воспитание воспитании воспитанию
тонкий: тоньше
работа: работы
правильно: правильно
регион: регионы
заражение: заражения
сам: самой самого
добиться: добиться
поддержание: поддержания
лапа: лапами лапы
сайт: сайту
топ-лист: топ-лист
специалист: специалисту специалисты
активный: активная активен активной
мощный: мощная
запад: западе
дорогой: дорогое дороже
крупный: крупная крупных крупной крупные
чайный: чайной
этот: эта этому этих
фактура: фактуре
лишь: лишь
изрядный: изрядное
экстерьер: экстерьер экстерьера
треугольный: треугольной
форум: форум форуме
португальский: португальская
огородить: огороженный
предпочтение: предпочтение
конец: конце конец концов
просматриваться: просматриваться
специальный: специальными специального
неприятность: неприятностей
действие: действия действий
звук: звуки
требовать: требуют
согрешить: согрешил
домовладение: домовладения
член: членам членов
такой: такие такая такого такому таким
наименование: наименование
беспокойство: беспокойство
спокойный: спокойны
голодный: голодная
ровный: ровные
явный: явной
племя: племена
токсичный: токсичны
значительно: значительно
один: одна одной одному
описание: описание
начало: начало
многое: многое
состояние: состояния
градация: градация
приступать: приступать
гаяз: гаяз
второй: второго вторую
здоровье: здоровьем здоровья здоровье
округлый: округлые
закрывать: закрывает
свернуть: свернут
белый: белых белый
тонус: тонусе
собачий: собачьих
огромный: огромные огромной
риск: рисками
внушительный: внушительные
поэтому: поэтому
наличие: наличием
лента: ленты ленту
копирование: копирование
дружелюбный: дружелюбная
черепной: черепная
далёкий: подальше
активность: активность
подверженный: подвержены
существовать: существует
точный: точным
федерация: федерации
удивительный: удивительную удивительной
дружелюбность: дружелюбность
иммунитет: иммунитет
отзыв: отзывах отзывы
нога: ноги ногах
бугор: бугром
заготовка: заготовкой
кошка: кошки
следовать: следует
плохой: плохим
пряность: пряности
шум: шум
любознательный: любознательны
поселение: поселения
висячий: висячие
крайний: крайнем
уровень: уровня уровне
особо: особо
прямой: прямая прямые прямой
густой: густая
книга: книгу
допустимый: допустимо
влажный: влажный
брезентовый: брезентовой
актуально: актуально
назад: назад
сетка: сетке
лето: летом
поначалу: поначалу
казахский: казахский
цвет: цвет
кость: кости костями
пастушеский: пастушеской
минимум: минимум
н: н
пылесосить: пылесосить
третий: третью
подрасти: подросшей
обидчивый: обидчив
социальный: социальной
сопровождать: сопровождали
суживаться: суживается
крыша: крышей
объявление: объявления
мелочь: мелочи
сделать: сделать сделали сделано
ценить: ценят
основной: основные
действовать: действовать
брак: брака
вода: вода
заливисто: заливисто
какой: каким
интеллект: интеллект
охранный: охранные охранным охранной
настороженно: настороженно
средне: средне
оценить: оценив оценить
боевой: боевых
уважение: уважение
постоянный: постоянного постоянное
овсянка: овсянка
сторожевой: сторожевой сторожевого сторожевая
питание: питания питанию питание
светло: светло
будка: будкой
купать: купают
бордер-терьер: бордер-терьер
ежедневно: ежедневно
понадобиться: понадобится
нос: носа нос
разведение: разведение
намеренно: намеренно
своевременный: своевременная
верность: верности
именно: именно
грамотно: грамотно
жить: живущих жили
ласковый: ласковое
продолжительность: продолжительность
недоверчиво: недоверчиво
курс: курс
аппетит: аппетитом
страна: страны странах страна
вряд: вряд
подросток: подростки
прибор: приборов
расположить: расположены
входить: входит
налётом: налетом
путин: путину
отклонение: отклонений
определяться: определяются
поневоле: поневоле
водяной: водяная
чистокровный: чистокровный
нужда: нужды
зависимость: зависимости
географический: географической
вещество: веществ
способ: способом способы
боль: болей
слегка: слегка
вилла: вилл
сср: сср
фото: фото
основание: основании
хлеб: хлеба
классификация: классификации
маленький: маленького маленькие маленьких
допускаться: допускается допускаются
применяться: применяется
самый: самое самых
яндекс: яндекс
сладкое: сладкое
количество: количество
миролюбивый: миролюбивое
сао: сао
уравновешенно-спокойный: уравновешенно-спокойному
холка: холке
награда: награду
журнал: журнал
отличный: отличный отличные
высота: высота
кавказский: кавказской
запомнить: запомнить
обмен: обмена
привязь: привязи
делать: делать
познать: познать
грива: грива
пристройство: пристройство
государство: государств
мирек: мирек
папа: папа
наджный: наджного
след: следов
территориально: территориально
э: э
применение: применения применение
месопотамия: месопотамии
хозяин: хозяину хозяина
запрещать: запрещает
вариант: вариантом варианта
получать: получают
болезнь: болезни
кормить: кормят кормить
ухо: ушами уши
ткаченко: ткаченко
чрезмерно: чрезмерно
палевый: палевых
контролировать: контролировать
либо: либо
нападать: нападает
микроэлемент: микроэлементов
минута: минут
татьяна: татьяна
известный: известна
первозданный: первозданный первозданном
нежелательный: нежелательны
ахалтекинский: ахалтекинской
взгляд: взглядом
овальный: овальной
бронзовый: бронзового
подсказать: подскажет
свежий: свежим свежие
статный: статный
внимательно: внимательно
загривок: загривку
оформить: оформлены
любовь: любви
решить: решить
объём: объеме
ответственный: ответственный
развлечение: развлечении
свежатина: свежатины
пусть: пусть
ватка: ваткой
предать: преданного
суета: суеты
сдержанно: сдержанно
плохо: плохо
определять: определяют
подвижный: подвижны
терпение: терпение терпением
вести: ведет ведут
шесть: шесть
истинный: истинного
условие: условиях условия
лёгкий: легкого
взросление: взросления
помета: помете помета
противопоказанный: противопоказаны
защитник: защитника защитник
выводиться: выводились
большой: большого
нужный: нужен
являться: являются является
перейти: перейти
ваш: вашей ваш вашего
статистика: статистика
важный: важной важный
проводиться: проводиться
предыдущий: предыдущие
главное: главное
загородный: загородного
ношение: ношение
серьёзность: серьезности
принять: принятые примет
коготь: когтей
гулять: гуляет
менее: менее
вольерный: вольерной
пти-брабансон: пти-брабансон
тот: тех тому той
будущее: будущим
нежирный: нежирным нежирная
ветеринарный: ветеринарный
иной: иной иных
грудь: груди грудь
внешний: внешний внешнем
костяк: костяк
приобретать: приобретать
отсутствие: отсутствие
одиночество: одиночеству
национальный: национальным
собранный: собранные
подшёрсток: подшерсток
стандарт: стандарта стандарт
кой: коем
купирование: купирования
роды: роды
осветлить: осветленным
отнести: отнести
морда: морда
джунгарский: джунгарского
избаловать: избалованным
обитание: обитание
вольер: вольере вольер
мускулистый: мускулистая
спровоцировать: спровоцировать
оценка: оценке
рубль: рублей
туркмения: туркмении
птица: птицы
сложный: сложнее
вспб: вспб
длинный: длинная длинной
стая: стаи стае
опасность: опасность
установленный: установленной
грубость: грубости
дог: дог
выпадение: выпадение
предназначение: предназначение
конституция: конституция
идти: идет
некоторый: некоторая некоторые
весить: весит
глубокий: глубокая
просушивать: просушивать
часть: часть
иметь: имеет иметь имел
стоимость: стоимость
телятина: телятина
особенно: особенно
желательно: желательно
высокомерие: высокомерия
анастасия: анастасия
воля: волю
настроение: настроению
час: часов
отсутствовать: отсутствует
веранда: верандой
принцип: принцип
достаточно: достаточно
обязательно: обязательно
любить: любите любят
фактор: факторов
сбалансированность: сбалансированность
нарушить: нарушить
пара: пару
выпуклый: выпуклая
москва: москве москва
моська: мосек
кольцо: кольцо
неделя: неделю
клещ: клещи клещами
заложить: заложено
хитрый: хитрее
поводок: поводке поводок
понимать: понимать
связать: связаны
унаследовать: унаследовал
пытаться: пытаясь
купить: купить
часто: часто
любой: любой
род: роду
поставить: поставлены
периферия: периферии
подтверждение: подтверждением
промывать: промывать
проходить: проходит
ключевой: ключевые
завести: завести
желание: желание
лн: лн
интересный: интересен
вывести: выведенная
блестящий: блестящую
просторный: просторный
ценовый: ценовая
ориентировать: ориентирован
предок: предки предков
недостаток: недостатки
степень: степень
слушаться: слушаться
испражнение: испражнения
загадочность: загадочность
поручить: поручить
ссср: ссср
кто-то: кто-то
сожаление: сожалению
здоровый: здоровый здоровое
предгорие: предгорий
гречка: гречка
домочадец: домочадцев
уверенность: уверенность
сомневаться: сомневайтесь
ватный: ватный
бить: бейте
уединиться: уединившись
представлять: представляют
одноклассник: одноклассники
приспособить: приспособлена
скорее: скорее
команда: команды команда
пройти: прошло пройти
зуд: зуд
сравнение: сравнению
случайный: случайные
передний: передние передних
кроме: кроме
мясо: мясо
повлиять: повлиять
муртазин: муртазина
когда-либо: когда-либо
трубчатый: трубчатые
любопытство: любопытство
раскопка: раскопках
сегодня: сегодня
неоправданный: неоправданную
частый: чаще
поиск: поиск
сопрячь: сопряжено
плоский: плоская
тазобедренный: тазобедренного
отбраковывать: отбраковывали
диапазон: диапазоне
выполнить: выполнит
вялость: вялость
памир: памира
есть: ест
жительство: жительства
оптимальный: оптимальное
белые: белые
отопительный: отопительных
окно: окон
короткий: короткая
служба: службу
общение: общении
зрение: зрения
дисплазия: дисплазии
сбоку: сбоку
независимость: независимость
потребность: потребность
проводить: проводите
влиять: влияет
порок: пороки
формироваться: формировалась
грациозный: грациозными
кочевой: кочевые
злость: злость
линька: линьки линька
жизнь: жизни
два: двух
абсолютно: абсолютно
они: ними
средство: средства средствами
сильно: сильно
моцион: моциона
организовывать: организовывать
бесстрашный: бесстрашного бесстрашный
море: моря
рука: рукой
малыш-алабай: малыша-алабая
молоссова: молоссов
выдержать: выдержанный
проживание: проживания
главный: главные главная
отличать: отличает
нужно: нужно
массивный: массивная
мимимишность: мимимишности
настойчивость: настойчивость
азия: азии
вызывать: вызывают вызывает
также: также
повзрослеть: повзрослевшего
арсенал: арсенале
умный: умная
доступный: доступна
любимец: любимца любимец
цель: цели
момент: моменты
тыс: тыс
фамильярность: фамильярности
подготовиться: подготовившись
прошлое: прошлого
поясница: поясница
прогулка: прогулок прогулке
нейтральный: нейтральной
донести: донесшая
юг: юге
стоить: стоить стоит
привести: привести приведет
изначально: изначально
высоко: высоко
агрессия: агрессию
лик: лика
ошейник: ошейника
выходить: выходят
крайне: крайне
дегельминтизация: дегельминтизацию
область: области
это: это
семимесячный: семимесячному
интересно: интересно
ножницеобразный: ножницеобразный
провоцировать: провоцируют
зависеть: зависит
взрастить: взрастить
различать: различают
сила: силах силой силу
российский: российской
наложить: наложил
свой-чужой: свой-чужой
смочь: сможет
тупой: тупая
тёмно-коричневый: темно-коричневого
мучной: мучные
кусочек: кусочек
житель: житель
верхний: верхняя
своевременно: своевременно
стол: стола
сухой: сухими
качество: качества
ирусик: ирусик
пропадать: пропадает
каша: каши
изменение: изменения
легко: легко
стан: стан
контур: контур
быстрый: быстрой
продаваться: продается
утвердить: утвердил
адиль: адиль
известно: известно
намордник: намордник
выглядеть: выглядит
север: севере
лай: лай лаем
уверить: уверены
говорить: говорит
неправильный: неправильного
застраховать: застрахован
гладкошрстный: гладкошрстный
результат: результата
заплатить: заплатить
вакансия: вакансии
адаптация: адаптации
прямо: прямо
восемь: восьми
помогать: помогаю
продукт: продукты
злой: злую
измеряться: измерялась
прикус: прикус
борьба: борьбы
забавно: забавно
унижать: унижайте
встречаться: встречается
постоянно: постоянно
симптом: симптомами
весенний: весенней
обрабатывать: обрабатывать
сей: сей
обустроить: обустроить
выше: выше
смочить: смоченной
очёс: очесы
распространение: распространение
сердце: сердцу
коричневый: коричневого
обладать: обладала
барышня: барышне
волкодав: волкодав
наряду: наряду
практически: практически
рейтинг: рейтинг
простота: простоты
мнение: мнению
треть: третей трети
аппарат: аппарата
ряд: ряд
дворняга: дворняга
независимо: независимо
подписываться: подписывайтесь
означать: означает
типично: типично
самостоятельно: самостоятельно
предусмотреть: предусмотрена
подарить: подарил
регистрационный: регистрационные
очень: очень
обычно: обычно
людный: людных
слушать: слушает
особенность: особенности
нагрузка: нагрузкам нагрузки
выполнять: выполнять
наиболее: наиболее
покраснение: покраснение
толстый: толстый
голубой: голубого
кличка: клички
правило: правила
довольно: довольно
держать: держать
возможность: возможность
неизбалованный: неизбалованного
касаться: касается
естественный: естественным естественный
племенной: племенного
соль: соль
проект: проекте
сразу: сразу
отдать: отдать
обширный: обширной
нервный: нервной
наследство: наследству
охранять: охранять
пора: пор
промзона: промзоне
кг: кг
необходимость: необходимости
городской: городской
блюдо: блюда
потеря: потеря
субъективный: субъективных
сидеть: сидеть
поглаживание: поглаживание
среднее: среднего
надежда: надежд
артроз: артроза
тысячелетний: тысячелетним
низко: низко
продолжаться: продолжаться
гарантия: гарантии
сустав: суставов
кормление: кормления кормление
причём: причем
высокомерный: высокомерным
исполинский: исполинском
корм: кормов
вывоз: вывозу
соление: соления
никакой: никакие
комок: комке
представитель: представители
расставить: расставлены
оба: оба
последний: последней
предотвратить: предотвратят
человекахозяин: человекахозяина
случай: случае
отпечаток: отпечатка
стимул: стимулом
дойти: дошедшая
дом: доме
возможный: возможны
чепрачный: чепрачного
устоять: устоять
гораздо: гораздо
демодекоза: демодекоз
оборонительный: оборонительная
уронить: уроните
уделить: уделить
выступать: выступающая
палочка: палочки
размениваться: размениваясь
