подранок: подранок
травма: травм
кто-нибудь: кого-нибудь
короткий: короткую короткая
три-четыре: тремя-четырьмя
семя: семян
отдавать: отдавайте
вытирать: вытирать
тело: тела
широко: широко
защита: защиту защиты
опыт: опыт опыта
агрессия: агрессия агрессии
покатый: покатой
подбить: подбитой подбитую
активный: активные активный
сколько: сколько
уходить: уходит
недостаток: недостатке недостаток
название: название названия
круповать: круповая
часть: частях части часть
домой: домой
собака: собаку собакой собак собака собакам собаке собаки
вывести: вывести
состоять: состоит
порок: пороков пороки пороками
физический: физических физическими физической
подпадать: подпадают
обсуждение: обсуждения
другой: другое другую другие других
сад: садом
оно: оно
миска: миску
усилитель: усилителем
цена: цена
спать: спит
внести: внесла
мелкий: мелкое мелкой
подушечка: подушечки подушечек
выстрел: выстрелы выстрелов выстрела
забывать: забывая забывайте
материал: материалов материалом
удовольствие: удовольствием
подшёрсток: подшерстком подшерстка
неутомимый: неутомимый неутомимые
натаскивать: натаскивать
расчёска: расческой
владелец: владельцам владельцев владельцу владельцы владельцем
поведение: поведения
погодный: погодных
собственный: собственных собственного
стоять: стоят
дисквалифицировать: дисквалифицирующие дисквалифицируют
инстинкт: инстинкты
сук: сучья
пятно: пятнами
субпродукт: субпродукты
побегать: побегать
зато: зато
россия: россия
строгий: строгую строгий
морда: морде морду морды морда
раковина: раковины
обратный: обратная
итог: итоге
температура: температуры
начинать: начинают
радужка: радужки
представитель: представителей представителя представитель представители
упражнение: упражнений упражнениями
дружелюбный: дружелюбном дружелюбная
соответствовать: соответствует
команда: команду командами команды команда
освободить: освободить
легавый: легавая легавым легавые легавых легавую легавой
занятие: занятий
шея: шея
волос: волосом волос волоса
пример: пример
отмечать: отмечают
пятимесячный: пятимесячного
забрать: забрать
вобрать: вобрала
шерсть: шерсть шерсти шерстью
компаньон: компаньоны
искренний: искреннюю
низкий: низкий низкая
перекрываться: перекрываются
провести: провести
выразить: выражены
крупа: крупа
запретить: запрещена запрещено
кинолог: кинологи
март: марта
оптимальный: оптимальная оптимальный
челюсть: челюсти челюстей
должный: должны должен должно должна
самый: самая самыми самую самые
ратовать: ратовать
тип: тип
покупка: покупку
походка: походке
свет: свете
содержать: содержать
неподвижно: неподвижно
паинька: паиньки
звук: звуков
месяц: месяц месяцев
поселить: поселить
относиться: относится относились
пуходерка: пуходеркой
охотничий: охотничью охотничьи охотничьих
жесткошёрстный: жесткошерстная жесткошерстных жесткошерстной жесткошерстным жесткошерстные
импозантный: импозантный
спустя: спустя
осознавать: осознают
равно: равно
включая: включая
нога: ног ноги
служить: служить служит
выраженный: выражен выраженным
выбрать: выбрали выбрать
дежурить: дежурить
упругий: упругие
меланома: меланома
лидерский: лидерских
обильный: обильного обильном
история: история
гипотиреоз: гипотиреоз
щенок: щенка щенков щенки щенок
полноценный: полноценную
белок: белка
выгул: выгул
следопыт: следопыты
виртуальный: виртуальные
успешно: успешно
прилегать: прилегающие
пытливый: пытливым
дикий: дикие диких
питомец: питомцев питомцу питомец питомцы питомца
взрослый: взрослый
редкий: редкую
каждый: каждого каждом каждый каждая
дополнительный: дополнительной дополнительных дополнительным
подобрать: подобранного
голова: голове голова
чувствовать: чувствуют
семья: семьи
нередко: нередко
белый: белую
сметливый: сметливые
болотный: болотной болотным
балл: балл
характеристика: характеристика
немецкий: немецкий немецкой немецких немецким немецкие немецкая
стоп: стоп
такой: таком таких такие такого такую такими
руб: руб
задание: заданиями
эмоция: эмоции
нос: носу нос
переквалифицировать: переквалифицировать
смыкание: смыкании
зарождение: зарождения
коттедж: коттедж
брюссельский: брюссельский
пол: пола пол
часок: часок
противопаразитарный: противопаразитарными
повод: поводу повод
неплохой: неплохих неплохие
еда: еды
тяга: тяга
осуществлять: осуществлять
обладать: обладать обладая обладающие обладали
быстро: быстро
входить: входят
боязнь: боязнь
штихельхаар: штихельхаары
удаться: удалось
водоём: водоемах водоем
помимо: помимо
видео: видео
отход: отходами
дратхааре: дратхааре
дом: домом домах дом доме
характер: характере характером характер
чучело: чучело
понравиться: понравившегося
разрешаться: разрешается
усидчивость: усидчивость
меню: меню
полностью: полностью
очередь: очередь
вода: воды вода воду
имитация: имитацией
лишённый: лишенное
смысл: смысл смысла
приподнять: приподнять приподнятом
условие: условии условиях
компания: компании
бородатый: бородатым бородатые
прижать: прижатыми
домашний: домашних домашние
смелость: смелость
каша: кашами
запах: запаху
неугомонный: неугомонные
рисовый: рисовой
живность: живностью живность
талант: талантов
бесконечно: бесконечно
ваш: вашу вашего ваших
охотник: охотника охотники охотникам охотников охотнику
лопатка: лопатками
полевой: полевых полевой
утка: утками
речь: речь
образ: образ
содержание: содержание содержании содержания
дать: данная дайте
обеспечивать: обеспечивающих
работа: работе
немного: немного
приучать: приучать
типичный: типичны типичные
благосклонно: благосклонно
гриффон: гриффон гриффоны
реагировать: реагировать
экономичный: экономичные
ноздря: ноздрями
окрас: окраса окрас окрасу окрасы
схватить: схватить
объект: объект
масло: масло
поколение: поколение
догонялки: догонялки
ориентир: ориентиром
кстати: кстати
территория: территорию
связь: связь
клуб: клуб
основный: основному основных
крыса: крыс
внешность: внешность внешности
реденький: реденькую
частичка: частички
превратить: превратив
единственный: единственный
энергичный: энергичные
радужный: радужной
разный: разными
бедро: бедра
травильщик: травильщики
пока: пока
особый: особых
запоминание: запоминанию
природный: природная
легковоспитывать: легковоспитуемой
выставочный: выставочной выставочным
пудель: пудели
растительный: растительное
год: годах года лет год году
лёгкий: легким легкой легкое
дважды: дважды
нижний: нижние нижняя
давать: давать дают
бояться: бояться
частенько: частенько
признание: признания
сайт: сайты сайту
истинный: истинных истинные
горизонтальный: горизонтальном
плотно: плотно
начать: начнут
зарекомендовать: зарекомендовавший
металлический: металлическими
девиация: девиации
смотреть: см смотрите смотрят
племенной: племенную
податливый: податливы
пара-тройка: пару-тройку
способность: способности
доверие: доверие
осматривать: осматривать
фотография: фотографии
общественный: общественного
работать: работать
уход: уходе уход
стартовать: стартуют
обожать: обожающие
результат: результатов
страдать: страдают
высокий: высокая высший
питомник: питомники питомниках питомников
повышенный: повышенную повышенная
переносить: переносят
глаз: глаза глаз
обзаводиться: обзаводиться
прийтись: придется пришелся
бордоский: бордоский
укоротить: укоротите
закрытый: закрыт
корм: корм
специфика: специфика
способный: способного способны
овладевать: овладевают
ус: усы усами
век: века веками
припоздниться: припозднившегося
собачий: собачьей собачья
вести: вести ведет
октябрь: октябрь
светить: светит
предмет: предмет предметов
получать: получает
поскольку: поскольку
контактный: контактны
прочий: прочие
обучение: обучения
величество: величества
упасть: упала
плавать: плавать
существо: существо
краткий: краткая
врождённый: врожденная
свой: своими свое своего своих свои
отношение: отношение отношению
плотный: плотная
поясница: поясницей
полный: полную
случиться: случилось
сушка: сушкой сушку
эксперт: экспертов
недокусперекус: недокусперекус
купать: купать
отказываться: отказывайтесь
вконтакте: вконтакте
рядом: рядом
создать: создать
обращение: обращении
агрессивный: агрессивны
переход: переход
тазобедренный: тазобедренных
разновидность: разновидности разновидностями разновидность
раненый: раненого раненой
шубка: шубки
пропустить: пропустит
ценник: ценники
приучить: приучите
животное: животных животным животного животные животное
фасоль: фасоль
одинаково: одинаково
раздаться: раздавшаяся
появление: появления
серьёзный: серьезном серьезный
висячий: висячее
преследование: преследования
длина: длины длина
шпиц: шпиц
конституция: конституции
тон: тон тонов
бородка: бородкой бородка бородку
перемещаться: перемещающегося
открытый: открытый открытых
авторитарный: авторитарным
мясистый: мясистые
счёт: счет
топь: топям
основать: основана основан
наставник: наставнике наставник
шёрстный: шерстного
чёрный: черного
хотя: хотя
малышня: малышней
паника: паники
прикрывать: прикрывают
позволить: позвольте позволит
х: х
расстояние: расстоянии
вид: видами видов вида виде вид
планировать: планирует планируете
дратхаар: дратхаара дратхаарам дратхаар дратхаарах дратхаары дратхааром дратхаарами дратхааров
лишний: лишним
предъявляться: предъявляется
причесать: причесать
осмотр: осмотре
довольствоваться: довольствуются
мягкий: мягкую
лесной: лесным лесной лесных
отыскивать: отыскивают
страсть: страсть
предрасположенность: предрасположенности
стиль: стилем
доминанта: доминанты
мешать: мешающим
квартира: квартире квартирах
размер: размеры
информация: информация информацию
воронка: воронка
друг: друг друга другу
дуга: дугами
большой: большое
убежать: убежит
любой: любую любое любым
распространить: распространенными
сустав: суставы суставов
недоверие: недоверия недоверие
пострадать: пострадает
прогулка: прогулку прогулки
проводить: проводить
расправить: расправить
пробежка: пробежками
остальной: остальных остальном
специалист: специалистов специалистам
косой: косыми косого
леса: лесам
курс: курса курс
обитатель: обитателей
нагрузить: нагрузит нагрузив
крепкий: крепкие крепкая
вызывать: вызывал
гонка: гонках
игра: играми игры
среди: среди
ушной: ушная ушное
добыча: добыча добычу добычи добычей
выудить: выудил
лапа: лапах лапы лап
линия: линию линии линией
веко: веки
лакей: лакея
цивилизация: цивилизации
считаться: считается считаются
мыть: мыть
жаловать: жалуете
загривок: загривком
просто: просто
пройтись: пройтись
страховать: страхуют
возрастать: возрастает
мыший: мышью
вынужденный: вынужденным
водить: водить
ожирение: ожирением
бросать: бросайте
новый: новом новую
пружинистость: пружинистостью
наличие: наличия наличием
вступить: вступят
брать: берут
приступить: приступить
залп: залпам
развесёлый: развеселого
умница: умницы
добавить: добавьте
хороший: лучший хороший лучшие хорошей хорошее
человек: человеку человека
плавание: плаванию
происхождение: происхождения
зуб: зубьями зубы
лобный: лобной
резец: резцы
необходимо: необходимо
ловко: ловко
секция: секцию
готовый: готовы
удлинённый: удлиненной
заставить: заставив
пища: пищи пищу
какой-нибудь: какой-нибудь
задний: задние
паховой: паховых
двойной: двойными
кобель: кобеля кобели
вислый: вислые
дрессировка: дрессировку дрессировка дрессировки
деятельность: деятельность деятельности
тёплый: теплая теплой
голос: голосом голос
время: время
сука: суки
агрессивность: агрессивность
пыл: пылу
предохранять: предохраняющая
день: дней день дни
урок: уроки
показывать: показывает
противный: противном
пясть: пясти
скрещивание: скрещивание
потерять: потеряет
хозяин: хозяином хозяину хозяевам хозяина
глазной: глазное
традиционно: традиционно
элемент: элементы
параллельно: параллельно
например: например
несколько: несколько
своеобразный: своеобразным
превосходно: превосходно
поверхность: поверхность
обнаружиться: обнаружились
рост: рост
старить: старят
отечественный: отечественных отечественные
закон: законом
хотеться: хочется
боковой: боковых
прицелиться: прицелиться
надеяться: надейтесь
девочка: девочек
умеренный: умеренное умеренной
тёмно-коричневый: темно-коричневый
позапрошлый: позапрошлого
к: ко
реклама: реклама
соответственно: соответственно
наклон: наклоном
где-нибудь: где-нибудь
определённо: определенно
мускулатура: мускулатурой
второй: второй
ум: умом ум
процедура: процедуру процедура
выносливость: выносливостью выносливость
губа: губ губы
воспитание: воспитание
германия: германия германии
безусловно: безусловно
западный: западной
сохранять: сохраняя
малыш: малыш малыша
наступать: наступают
называть: называемая
дичь: дичи дичь дичью
правильно: правильно
харизматичный: харизматичные
который: которыми которого которая которых которым которые который
завоевать: завоевать
фазан: фазанов
добиться: добиться
сухой: сухие
путаться: путается
отменный: отменным
отложить: отложить
колючка: колючек
полезно: полезно
получаться: получаются
конечность: конечностями конечности
картофель: картофель
запоминаться: запоминающаяся
быть: будут
лишь: лишь
вариант: вариант варианты
долго: долго
экспериментальный: экспериментальных
рабочий: рабочие
горло: горла
поход: поход
форум: форум форуме
обрезка: обрезками
предпочтение: предпочтение
белка: белки
хотеть: хотят
купание: купанию
забег: забега
рельефный: рельефным
положение: положение положении
презент: презенты
член: членам
энерджайзер: энерджайзеры
массивный: массивными массивные
скоро: скоро
километр: километров
резкий: резких
трудозатратный: трудозатратный
ровный: ровные
верхний: верхними
встретиться: встретившуюся
экзема: экземы
объявление: объявлений объявления
описание: описание
начало: начало началу
мужской: мужского
стандарт: стандартом
ящик: ящик
почуять: почуяв
понижение: понижениях
середина: середине
подсушить: подсушенной
объединить: объединенной
пользоваться: пользующееся
обитать: обитает обитать
становиться: становится становятся
поэтому: поэтому
стена: стенами
предлагать: предлагают
дополняться: дополняются
копирование: копирование
далёкий: подальше
прекрасно: прекрасно
достоинство: достоинств
активность: активность активности
основание: основания
дружелюбность: дружелюбность
незнакомец: незнакомцам незнакомцев
побаловать: побаловать
насыщенный: насыщенного
плавно: плавно
подвижный: подвижные
отзыв: отзывах отзывы
шип: шипов
переходить: переходить
поинтересоваться: поинтересоваться
узкоспециализированный: узкоспециализированным
кошка: кошки кошку
следовать: следует
способ: способ
отсутствие: отсутствии
животный: животному
шум: шум
натуральный: натуральное натуральную натурального
широкий: широкий широкая широкими
собираться: собирается
особь: особи особям особей
составлять: составляют
особо: особо
диплом: диплома дипломы
краса: красе
рамка: рамки
чутко: чутко
федерация: федерация
актуально: актуально
разлизать: разлизанной
оттенок: оттенка оттенок
лето: летом
местечко: местечки
поначалу: поначалу
цвет: цвет
дача: дача
минимум: минимум
посетить: посетите
благосклонность: благосклонностью
ледяной: ледяную
река: реку
толика: толикой
возраст: возрастом возраста
порода: породы пород породу порода породой
взаимный: взаимного
средний: средней
придавать: придающие придающая
ухо: ушей ушах уши
мордочка: мордочке
профессиональный: профессионального
сделать: сделать сделано сделало
располагаться: располагаются
основной: основные
унюхать: унюхать
интеллект: интеллект
охранный: охранные
многие: многие
неправильный: неправильный
мчаться: мчаться
вес: вес
уважение: уважение
гречневый: гречневой
конец: конец
питание: питания
искривить: искривленными
по-настоящему: по-настоящему
чутьё: чутьем чутью
овсяный: овсяной
именно: именно
повелительный: повелительный
среднестатистический: среднестатистического
улица: улице
злоупотреблять: злоупотреблять
локоть: локтями
сутки: сутками
ответственность: ответственность
холодное: холодное
продолжительность: продолжительность
коротать: коротать
играть: играя
международный: международная
влажный: влажной
острый: острые острых острым
преподносить: преподносят
перекос: перекос
отлично: отлично
пёс: пес пса
потенциал: потенциалом
образец: образец
стать: стать станет
отвислый: отвислыми
запястье: запястья
расценка: расценкам
жесткошрстный: жесткошрстная
зубной: зубную
приём: прием
эксплуатировать: эксплуатировать
следить: следите
полотно: полотно
развитие: развития
управляться: управляющиеся
американский: американские
доминирование: доминированию
оценка: оценка оценке
вышеуказанный: вышеуказанных
вокруг: вокруг
цель: целях
справиться: справятся
слегка: слегка
тот: те та
вожделенный: вожделенной
иметься: имеются
купировать: купирован купированный
сокращать: сокращают
упавший: упавшей
фото: фото
харизма: харизма
допускаться: допускается
независимый: независимее
м: м
регулярный: регулярном
сам: самого
будущий: будущий
энтропияэктропия: энтропияэктропия
яндекс: яндекс
техника: техники
количество: количество количестве
феноменальный: феноменальному
осенний: осеннюю
грызун: грызунов
снабдить: снабдите
оставить: оставьте
череп: череп
древесина: древесины
преследователь: преследователь
чистота: чистоты
густо-краповый: густо-краповые
спина: спиной
холка: холке
выразительный: выразительные
обучать: обучают
многообещающий: многообещающим
птица: птицу птицы птицей
послужить: послужили
относить: относят
двор: дворе
журнал: журнал
оружейный: оружейным
попона: попон
четыре: четыре
весь: всей всем
высота: высота
нуждаться: нуждаются
горбатый: горбатой
ванна: ванны
больший: большие
пищеварение: пищеварение
ширина: ширины
подмять: подмять
обычный: обычной
кисломолочный: кисломолочными
золотистый: золотистый
болезнь: болезни
умение: умением
целиком: целиком
косо: косо
подносить: подносят
один: одной одну одному
заводчик: заводчиков заводчики
совершенно: совершенно
чрезмерно: чрезмерно
невыпуклый: невыпуклые
ребёнок: детей
редко-крапчатый: редко-крапчатые
минута: минут
мочь: мог можете
ряд: ряду ряд
какой: какие какими
прийти: пришло
взгляд: взглядом
охота: охоте охота охоты охоту
услышать: услышит
сидеть: сидящей
яблоко: яблоко
заплыв: заплывы
вязка: вязках вязок
дисквалификация: дисквалификации
зверь: зверя
крупный: крупной крупные
проявить: проявить проявят
намекать: намекает
обижать: обижают
допустимый: допустимы допустимым
навстречу: навстречу
титул: титулах
корпус: корпуса корпусу корпус
скакательный: скакательные
заметно: заметно
упрямый: упрямее
недуг: недугами
заяц: зайца зайцев
немой: нем
превращаться: превращается превращаться
обнаружение: обнаружении
перейти: перейти
наесть: наесть
вымотать: вымотают
привыкнуть: привыкшие
регулярно: регулярно
ношение: ношение
озёры: озерам
большинство: большинством большинство
оболочка: оболочки
менее: менее
сигнал: сигнал
уровень: уровне
собрат: собратьями
жёсткий: жестким жесткой жесткие
вогнутый: вогнутой
дополнять: дополняет дополняя
грудь: груди
беззерновой: беззерновым
разбавить: разбавить
клетка: клетка
лежать: лежащего
бородач: бородачи
одиночество: одиночеству
будущее: будущего
рацион: рационе
положить: положить
нацеплять: нацепляют
водонепроницаемый: водонепроницаемого
кой: коем
ровно: ровно
окунать: окунает
незлобливый: незлобливым
гигиена: гигиена
длинноухий: длинноухий
тёмный: темнее
подобный: подобные
вольерный: вольерном
придерживаться: придерживаться
изогнутый: изогнутую
мускулистый: мускулистая мускулистой
небольшой: небольшие
покров: покрова
плохой: худшее
монотонность: монотонность
различный: различными
избавить: избавлены
апортировщик: апортировщика
зона: зон
грубый: грубой
родина: родине
знакомый: знакомые
пойнтер: пойнтеры
накормить: накормить
развить: развить
мишень: мишенью
карьера: карьеры
сложный: сложнее
мочка: мочка
предложить: предложенную
малоопытный: малоопытным
длинный: длинная
ловить: ловить
правило: правило правила правил
нежирный: нежирное
слабо: слабо
дог: дог
прикус: прикуса прикус
неделя: недель неделю
нападать: нападая
подрасти: подрастет
ветошь: ветошью
глубокий: глубокая
качество: качествах качества
иметь: имеет иметь имеющих
выставка: выставке
промежуток: промежуток
конура: конурой
стоимость: стоимость
приобрести: приобрести
удерживать: удерживать
особенно: особенно
бок: бока
лёгкость: легкостью
пробежать: пробежать
соблазнительный: соблазнительным
желательно: желательно
иноходь: иноходью
открывать: открывают
щётка: щетку щеткой
автоматически: автоматически
дефектный: дефектный
час: часов
обозлить: обозленного
вознамериться: вознамерились
возле: возле
непогода: непогоды
включать: включать
делить: делить
ветка: веток
смекалка: смекалку
диванный: диванного
достаточно: достаточно
граничить: граничащая
обязательно: обязательно
выпускать: выпускают
доминировать: доминировать
распространяться: распространяется
волнение: волнения
ход: ходе
какой-то: какое-то
пара: пару
заложить: заложена
активизироваться: активизируются
производить: производят
бесплатный: бесплатных
апортировать: апортируют
сезонный: сезонным
смешанный: смешанное
клещ: клещи
европа: европы
популярность: популярность
неопрятный: неопрятный
охотно: охотно
любитель: любителей
форма: формы
ходить: ходить
купить: купить купите
часто: часто
поставить: поставлены
находиться: находятся
потчевать: потчуют
первый: первый первая первую первых
обнаружить: обнаружен
излом: излом
страна: странах страна
проволочный: проволочного проволочным
товарищ: товарища
заболевание: заболеваний
наслать: нашли
принимать: принимает
отит: отита
путь: пути
реестр: реестры
ниша: нишу
разноглазие: разноглазие
случай: случаях случае
вылазка: вылазки
усомниться: усомниться
выбирать: выбирать
стойка: стойку
этот: этих
живой: живой
предшественник: предшественников
протирать: протирают
просек: просекам
бровь: брови
усвоить: усвоить
дисплазия: дисплазию
нежелательно: нежелательно
нагрузка: нагрузками
успеть: успела
домочадец: домочадцев
требование: требований
принести: принес
недолюбливать: недолюбливают
сырой: сырое
прикупить: прикупить
племя: племени
далеко: далеко
трусость: трусость
навсегда: навсегда
одноклассник: одноклассники
проходить: проходя
подавать: подает
надёжный: надежную
волосок: волоски
охотник-универсал: охотники-универсалы
отметина: отметину
возможность: возможности
посылать: посылают
внутренний: внутреннюю
усатый: усатые
растение: растений
случайный: случайные случайных
сильный: сильной сильные сильным
передний: передние
чётко: четко
кроме: кроме
движение: движении движений
наблюдаться: наблюдается
мясо: мясо
мечта: мечты
завладеть: завладеть
коричневый: коричневые коричневого
среднее: среднем среднего
десна: деснам
испытывать: испытывают
живот: животе живота
покровный: покровного
бридер: бридеры
держаться: держится
сочетать: сочетать
частый: чаще
поиск: поиск
плясать: плясать
получить: получить
симпатия: симпатию
очертить: очерченной
заветный: заветным
практиковать: практикуют
править: правят
себя: собой
некоторый: некоторые
образовать: образует
апорт: апорт
апортировка: апортировкой
брудастый: брудастая
период: период
доступность: доступности
генетический: генетическим генетическом
продукт: продукт продуктами
включить: включив
кустарник: кустарника кустарник
подозрительность: подозрительность
удивительный: удивительного
салфетка: салфеткой
пройти: пройдет
рассекать: рассекать
разнообразный: разнообразными
выгуливать: выгуливают
конкретный: конкретном
дополнительно: дополнительно
учесть: учтите
битый: битой
потребность: потребность
килограмм: килограммов
горох: горох
единый: единую
побаиваться: побаиваются
линька: линьки линька
малый: малейший
жизнь: жизни
два: двух
достаточный: достаточными достаточной
выдающийся: выдающиеся
они: ними
отмереть: отмершие
благодаря: благодаря
шт: шт
померанский: померанский
диабет: диабет
российский: российских
воспитывать: воспитывать
знакомство: знакомству
габарит: габаритами
вырезка: вырезкой
англия: англию
относительно: относительно
мимимишность: мимимишности
принять: принять
также: также
стеноз: стеноз
умный: умная
настроение: настроение
любопытный: любопытным
мама: мама
ждать: ждать
идеальный: идеальным идеального
любимец: любимца
момент: моменты
факт: факту
возможно: возможно
эмигрант: эмигрантам
воспаление: воспалений
продолжать: продолжает продолжают
вволю: вволю
неглубоко: неглубоко
кинологический: кинологическая
манипулировать: манипулировать
растянутый: растянутый
исключение: исключения
жить: живущие
семенить: семенить
ранее: ранее
шаговый: шаговой
выправка: выправку
выпуклый: выпуклый
гарантия: гарантий
повозиться: повозиться
стоить: стоит
это: это
водоплавающий: водоплавающих водоплавающую
жир: жиров
заострить: заостренную
исполосовать: исполосуют
ножницеобразный: ножницеобразный
гиперактивность: гиперактивностью
зависеть: зависит
выбор: выбору
вопрос: вопрос
сила: силах силу
кормить: кормить кормит
вполне: вполне
неполный: неполную
участок: участком
загонять: загоняя
любить: любят
вширь: вширь
частный: частных
немец: немцы
прочь: прочь
признак: признаков
легко: легко
многий: многих
подтянутый: подтянутых
фейс-контроль: фейс-контроль
непромокаемый: непромокаемая
лента: ленту
чистопородный: чистопородных
здоровье: здоровье
сторож: сторожей
выходить: выходите выходить
основа: основу
сочетание: сочетании
мороз: морозы
основательно: основательно
военный: военную
чаща: чащей
обработать: обработайте
исполнитель: исполнителя
теоретически: теоретически
проволока: проволока
отличный: отличные
длиться: длиться
выход: выход
европейский: европейским европейские
вакансия: вакансии
запачкать: запачкана
выгонять: выгоняет
тридцать: тридцать
селекционер: селекционеров
возвращение: возвращения
недопонимание: недопонимания
продавец: продавцы
приходиться: приходится
внушительный: внушительными
добродушный: добродушные
конфликт: конфликт
голень: голени
утонуть: утонуть утонет
выше: выше
грудной: грудная
улепётывать: улепетывающей
удобно: удобно
безрассудство: безрассудство
трещина: трещины
отправиться: отправиться
чересчур: чересчур
порох: пороха
трофей: трофеем
столетие: столетия
свойственный: свойственна
посадить: посажены
проветрить: проветрить
кабан: кабана
бигль: бигль
главный: главная
практически: практически
катаракт: катаракта
причина: причиной
рейтинг: рейтинг
дефект: дефекты дефектами
мнение: мнению
утвердить: утвержденных
подписываться: подписывайтесь
нехватка: нехватке
последний: последнюю последней
запустить: запущенных
соответствующий: соответствующего
уверенный: уверенный
комплекс: комплексом
экскурсия: экскурсий
вскармливание: вскармливание
хвост: хвоста хвост
утолщение: утолщение
очень: очень
обычно: обычно
исполнительность: исполнительность
лояльность: лояльность
наоборот: наоборот
постепенно: постепенно
кличка: клички
куриный: куриным
довольно: довольно
крем: кремом
список: список
тряпочка: тряпочкой
средство: средствами
пытаться: пытающимся
готовиться: готовьтесь
перемежать: перемежать
касаться: касается
окрасить: окрашена
четвероногий: четвероногого
кортальс: кортальса
удалить: удалить
застревать: застревают
обрабатывать: обрабатывают
одновременно: одновременно
надлежать: надлежит
горбинка: горбинкой
передвигаться: передвигаться
испытать: испытать
вырастить: вырастить
мясной: мясными
проект: проекте
сразу: сразу
слух: слуху
необходимый: необходим
надевать: надевать
аорта: аорты
кг: кг
городской: городской
необходимость: необходимости
гранулёма: гранулемы
минимальный: минимальная
научиться: научится
желание: желаний
подвижность: подвижность
бледный: бледную
комплекция: комплекции
согреться: согреться
овощ: овощам
надбровный: надбровными
ревнивый: ревнивы
трудоголик: трудоголики
стая: стае
тень: тень
посадка: посадка
репея: репея
кормление: кормления кормление
причём: причем
выявлять: выявляют
оригинальный: оригинальная
тонко: тонко
усилие: усилий
родитель: родителей
контролировать: контролирующие
баловень: баловня
ожидание: ожидании
плоский: плоским
затылок: затылком
формула: формулу
питательный: питательным
сезон: сезона
негативный: негативные
гораздо: гораздо
яйцо: яйцом
четырехлапый: четырехлапое
позволять: позволять
толщина: толщины
болото: болотам
неблагоприятный: неблагоприятных
