овощ: овощи
брутальный: брутальную
использовать: используя используют
держаться: держатся держаться
широко: широко
оживлённый: оживленного
средний: средняя среднее среднюю средней
отменный: отменная отменным
ощущать: ощущать
распространиться: распространилось
любопытный: любопытные
чёрный: черный черного
сколько: сколько
близкий: близкие ближайших
предоставить: предоставить предоставили
название: название названия
фон: фон
собака: собаку собак собака собакам собаке собаки
крючок: крючка
сухой: сухого сухой сухими
широкий: широк
переставлять: переставляя
губа: губах губы
физический: физических
обсуждение: обсуждения
предпочтительный: предпочтителен предпочтительный
агрессия: агрессии агрессию
приветствоваться: приветствуется
ваш: вашему вашего
цена: цена
образный: образная
динамичный: динамична
подушечка: подушечки
указать: указана
материал: материалов
служебный: служебная служебный служебным
быть: будучи е
вымётывать: выметывающими
расчёска: расческой
шестимесячный: шестимесячному
упражнение: упражнениях упражнениям
обратить: обратите
десятилетие: десятилетии десятилетий
владелец: владельцам владельцев
телеэкран: телеэкранах
передний: передняя передние передних
курчавый: курчавая
массаж: массажа
овальный: овальную овальной
стоять: стоят
любовь: любовь
морской: морская
инстинкт: инстинкты
город: городах
побегать: побегать
россия: россия россии
живот: живот
вычёсывать: вычесывают
приступить: приступили
лобо: лобо
предназначить: предназначенными предназначена
морда: морде морда
обратный: обратная
предварительно: предварительно
перевести: перевести
представитель: представителей представители
штанишки: штанишками
шея: шея шею шеи
овчарка: овчарки овчарок овчаркам овчарку овчарками овчаркой овчарка
темпераментный: темпераментные темпераментная темпераментна
шерсть: шерсть шерсти шерстью
обладать: обладающая обладает обладавших обладавшие обладающий
документ: документы
специально: специально
стон: стоны
провести: провести
шейный: шейной
желто-серый: желто-серым
рука: руками
рыба: рыба
применять: применять
челюсть: челюсти
приключение: приключениям
должный: должны должен должно должна
говядина: говядина
содержать: содержать
класс: класса
посадить: посажен
незаурядный: незаурядный незаурядной
наискось: наискось
согласие: согласии
ласковый: ласкова ласковый ласковые
вердикт: вердикт
человек: людям людей люди
пастуший: пастушья пастушьей
относиться: относится относятся
питомец: питомцами питомцев питомцу питомец питомца
месяц: месяц месяцы месяцев
дорогой: дорогие
необходимый: необходимы
иметься: имеется
сверху: сверху
участок: участки
включая: включая
рост: росту рост роста
отличаться: отличается отличающееся отличаются
эффектный: эффектная эффектные эффектной
важно: важно
упругий: упругие
проявляться: проявляющийся
история: история
навыкате: навыкате
щенок: щенка щенков щенки щенок щенку
покорить: покоренными
худоба: худоба
попросить: попросите
проявлять: проявляет проявляя
подбирать: подбирать подбирали
различимый: различимо
форма: форма форме форму форм формы
семья: семьи семье
неизвестный: неизвестного
бесчестный: бесчестные
нередко: нередко
белый: белую белыми белых белым белого белой белая белый
шерстяной: шерстяного шерстяные шерстяной
характеристика: характеристика
род: рода роду
выставка: выставках выставке
нос: носу нос
удлинённый: удлиненный удлиненная удлиненные
год: годы лет год годов году
навык: навыков
полярный: полярным
пастушеский: пастушеские
густой: густую густой
новичок: новичку
коготь: когти когтей
пэт-класс: пэт-класса
признать: признан
палец: пальцы
сужаться: сужается сужающаяся
основное: основном
диск: диск
раз: раза
видео: видео
длинношёрстный: длинношерстных длинношерстного длинношерстные
рокфеллер: рокфеллеры
меню: меню
расти: росли
любоваться: любуется
полуслово: полуслова
пёс: псы пес пса
домашний: домашних домашними
дорваться: дорвавшиеся
незнакомец: незнакомцами
небольшой: небольших небольшие небольшой
такой: таких такое такие
чемпионат: чемпионатах
рацион: рациона
белоснежный: белоснежные белоснежных
образ: образ
хороший: хорошим хороший лучшее хорошая хорошей хорошее
содержание: содержание содержания
присутствовать: присутствовать
альп: альпами
немного: немного
вечеринка: вечеринка
движение: движение движения движении
боязливость: боязливость
составлять: составляет составлять
физиологический: физиологические
жить: живет
властный: властных
окрас: окраса окрас окрасом окрасу
фрагментарный: фрагментарное
петлеобразный: петлеобразный
подвес: подвес
юркость: юркость
связь: связь
любящий: любящий
представлять: представляя
внешность: внешность внешностью
количество: количествах количество
видовой: видовое
настороженность: настороженность
лоб: лба
вынести: вынесенный
распутать: распутать
продолжение: продолжение
бедро: бедра
пока: пока
стать: стали стало стать
красота: красоты
от: ото
система: систему
состояние: состоянии состояния
прямой: прямыми прямая прямые
жестковатый: жестковатые
считать: считали
дважды: дважды
возраст: возрасту возрасте
графрат: графрат
давать: давать дают давали
загородный: загородный
далёкий: далека
становиться: становясь
протирать: протирать
расчесать: расчесать
немецкий: немецкой немецких немецкую немецкие немецкая
методика: методику
оказаться: оказался оказалась
плотно: плотно
спасатель: спасателей спасателя
проводник-следопыт: проводника-следопыта
качество: качестве качествам качества
принадлежать: принадлежала
поле: поле
ласка: ласке
смотреть: см смотрите
крепко: крепко
племенной: племенную племенной племенном
превышать: превышает
фотография: фотографии
гитлеровский: гитлеровского
город-миллионник: городах-миллионниках
понимание: пониманием
агрессивный: агрессивная агрессивные
выражать: выражают
уход: уходе уход
знать: знать
дать: данной
ряд: ряде ряды
высокий: высокая высоким
питомник: питомники питомнике
возникнуть: возникла
богато: богато
глаз: глаза глаз
основание: основанию основания
серьёзный: серьезным серьезный
прийтись: придется
целый: целые
наказывать: наказывать
корм: корм кормами корма
тяжёлый: тяжелый
имя: именем
самый: самым самые
часть: части часть
поздний: позже
век: века
конечность: конечностях конечностей конечности
вести: вести
доброжелательный: доброжелательна
реакция: реакция реакциям
обучение: обучения
претендовать: претендующие
ошпарить: ошпаренным
непритязательный: непритязательный
пользоваться: пользуются пользуясь
плавать: плавать
краткий: краткая
весьма: весьма
врождённый: врожденная
планомерный: планомерного
сильный: сильная сильные
отношение: отношение отношении отношению
выделять: выделяя
место: место
одинаковый: одинаковы
плавный: плавная
отметить: отметить
сородич: сородичей
эксперт: экспертов
купать: купать
направить: направлены
недостаточность: недостаточность
выгонка: выгонки
вконтакте: вконтакте
свет: свет
рядом: рядом
тазобедренный: тазобедренных тазобедренного
мощный: мощной мощная мощные
потребовать: потребует
среда: среде
развитие: развитие
энтузиазм: энтузиазм энтузиазмом
обычный: обычным обычной
животное: животных животным животного животными животное
кинологический: кинологической кинологические кинологическая
интенсивный: интенсивный
мяч: мячом мяч
пропорциональный: пропорциональна
сша: сша
очутиться: очутились
длина: длины длину
выбрать: выбрать
распространить: распространенный распространены распространенным
тональность: тональность
грайф: грайф грайфа
свисать: свисает свисающие
основать: основана
сустав: сустава суставов
хотя: хотя
крепкий: крепкую крепкие крепкое крепкая
охранник: охранника
х: х
покровный: покровные
диабет: диабету
редкий: редкой реже
выражаться: выражающаяся
тампон: тампоном
анфас: анфас
осмотр: осмотре
порода: породам породы пород порода породой
собственно: собственно
чувствовать: чувствовать
мама: мамы мамой
размер: размеры размера
официально: официально
швейцарский: швейцарских швейцарской швейцарские швейцарскую швейцарская
сырой: сырым сырой
предполагать: предполагать
информация: информация
подходить: подходит
получить: получило получила получит
литература: литературе
человеческий: человеческих человеческом
хондропротектор: хондропротекторы
арктика: арктики
двухразовый: двухразовое
выразительный: выразительна
гребень: гребнем
прогулка: прогулку прогулки
сначала: сначала
приподниматься: приподнимается
кошка: кошкой кошки кошек
характер: характера характер
появиться: появившийся появилась
конец: концу конца конец
светло-жёлтый: светло-желтый
сообразительность: сообразительность сообразительностью
вплоть: вплоть
ладить: ладят
ангелочек: ангелочков
ребёнок: детям
собаководство: собаководство
среди: среди
дом: дом
подстригать: подстригают
вокальный: вокальным
непроходимость: непроходимости
линия: линию линия линий линии
это: этим это
последовательно: последовательно
генеральный: генеральное
основательный: основательным
неутомимость: неутомимость
мыть: мыть
разведение: разведении разведения разведению
находиться: находится
пол: полу
бежать: бегущая
поиграть: поиграешь
просто: просто
забывать: забывать
аллергия: аллергия
описываться: описывались
зарегистрировать: зарегистрированная
верх: верха
интерес: интересов
опускаться: опускающаяся
размеренно: размеренно
вид: видом вида виде
последующий: последующих
подчеркнуть: подчеркнуто
прочий: прочих
делегат: делегатом
сторожевой: сторожевых
закрутить: закрученный
режим: режима
угроза: угрозы
плохой: плохое плохого
контакт: контакт
именовать: именовать
локоть: локтей
добавить: добавьте
искусственный: искусственному
холка: холка холке
предрасположенность: предрасположенность
происхождение: происхождения
заболевание: заболевания заболеваний
наследственный: наследственные
необходимо: необходимо
понимать: понимают
первый: первые первым первая
пигментация: пигментации
задний: задние задних задней
переход: перехода
черта: черты чертой
организация: организация
кобель: кобеля кобели кобель
стелющийся: стелющаяся
приобрести: приобретите приобрести
дрессировка: дрессировка дрессировке
предплечье: предплечья
нервный: нервную
время: время времени временем
породистый: породистые
приблизительно: приблизительно
сука: суки
отдельно: отдельно
испачкаться: испачкался
агрессивность: агрессивность
великолепный: великолепные
слово: слову
волос: волосы
начать: начали
американо-канадский: американо-канадскую американо-канадская американо-канадскими
пясть: пясти
они: ими
другой: другие другого другими другим
сила: сила силах
хозяин: хозяином хозяевам хозяев хозяина хозяева
просмотр: просмотров
поговорить: поговорить
мера: мере
кишечный: кишечной
например: например
несколько: несколько
встречаться: встречавшиеся встречается
короткошёрстный: короткошерстных
голова: головы голова
предложить: предложить
хотеться: хочется
процедура: процедурой процедуры
присущий: присущие присущи
умеренный: умеренное
позапрошлый: позапрошлого
ругать: ругать
реклама: реклама
швейцарка: швейцарка швейцарки
мягкий: мягкая мягок
силовой: силовых
вычесать: вычесанные вычесать
мускулатура: мускулатурой мускулатуру
общий: общих
месяц-полтора: месяц-полтора
голландия: голландии
живучий: живучим
припустить: припущенные
выразить: выражена
рекомендоваться: рекомендуется
мочка: мочки
скрещивание: скрещиванию
воспитание: воспитание
явно: явно
один: одно одна
частый: частым частой
принять: приняла
бережно: бережно
который: которыми которого которая которых которые
сайт: сайту
бывать: бывает
длинный: длиннее
родословная: родословной
чей: чьей
специалист: специалисту
активный: активный
фактура: фактурой
пища: пищей пище
саблевидный: саблевидную
лишь: лишь
выводить: выводить выводят
сухощавый: сухощавые
швейцария: швейцария швейцарии
иметь: имеющий имеет иметь имеющая имеющие имеют
лёгкий: легок
форум: форум форуме
печень: печень
стесняться: стесняйтесь
соприкасаться: соприкасаться
плечевой: плечевая
понравиться: понравился
начало: начала начало началу
закруглить: закруглены
положение: положение
внешне: внешне
любитель: любители
явный: явной
напротив: напротив
шоу-класс: шоу-класса
натуральный: натуральной натуральными
описание: описание
неутомимый: неутомим
диапазон: диапазон
внушительный: внушительной внушительное
родный: родными родных
специализировать: специализированные
здоровье: здоровьем здоровье
отвергаться: отвергались
гречневый: гречневая
ответить: ответит
однако: однако
финал: финале
германия: германии
играть: играть
справляться: справляться
копирование: копирование
дружелюбный: дружелюбная
постоянство: постоянство
воспринимать: воспринимают
безмятежный: безмятежном
добрый: добрый
активность: активность
красивый: красивая красивый
дружелюбность: дружелюбность
половить: половить
отзыв: отзывах отзывы
чистокровный: чистокровного
следовать: следует
выделение: выделения
шум: шум
особь: особи особей
запоминать: запоминают
отличие: отличие
очищать: очищать
желтеть: желтеет
участвовать: участвовавшим
назад: назад
состоять: состоят
цвет: цвет цвета
решить: решили
мочь: могут
сегодняшний: сегодняшний
минимум: минимум
игра: играх
определённый: определенного определенных
известность: известность
малыш: малышами малыши
творог: творог
иной: иное
ухо: ушей ушах уши
продавать: продают
перспектива: перспективу
целое: целом
объявление: объявления
шалость: шалости
основной: основные
интеллект: интеллект интеллектом
охранный: охранные
многие: многие
летать: летающий
вес: вес
белошёрстный: белошерстным
овсянка: овсянка
действие: действиях
ежедневно: ежедневно
позволять: позволяют
свой: своим свой свое своих свои
результат: результаты результате
сформироваться: сформировалась
родственник: родственники
именно: именно
вопрос: вопросы
чрезвычайно: чрезвычайно
неравнодушный: неравнодушны
чрезмерный: чрезмерная
североамериканский: северо-американские североамериканском
добродушный: добродушный
продолжительность: продолжительность
поплавать: поплавать
популярный: популярна
международный: международная
влажный: влажной влажными
отлично: отлично
излишний: излишняя
полустоячий: полустоячие
вряд: вряд
доходить: доходит
паста: пасту
парез: парез
являться: являлся является
короче: короче
расположить: расположены
оттенок: оттенок
подъём: подъем
нежный: нежном нежная нежные
кончик: кончиках кончики
никак: никак
помощь: помощи
домочадец: домочадцами
тот: те ту той
здравствуйте: здравствуйте
больший: большую
посторонний: посторонним
обращаться: обращаться
фото: фото
переходящий: переходящая
насторожиться: насторожиться
питание: питание
допускаться: допускается
вы: вами
непомерный: непомерных
будущий: будущий
яндекс: яндекс
обращение: обращение
второй: вторые
дефект: дефект дефекты
ограничение: ограничении
обожать: обожают
спокойствие: спокойствие
крадущийся: крадущаяся
выносливый: вынослив выносливая
приобретать: приобретали приобретать
вперёд: вперед
нужный: нужными
франция: франции
путешествие: путешествиям
помнить: помнить
социализация: социализации
поведение: поведением
экстерьер: экстерьером экстерьеру
лапа: лапы
готовый: готовыми
верный: верным
журнал: журнал
высота: высота
говяжий: говяжья
игривый: игривые
делать: делать
грива: грива
провозгласить: провозгласив
нуждаться: нуждаются нуждающийся
обработать: обработать
хрюканье: хрюканья
туловище: туловищу
ширина: ширины
покров: покров покрова
болезнь: болезни болезнь
маниакальный: маниакальный
старательно: старательно
кормить: кормят кормить
изогнутый: изогнута
клинообразный: клинообразную
малый: меньшей
либо: либо
пакетик: пакетик
активно: активно
поводырь: поводыря поводырей
кипяток: кипятком
милый: милых
предпочитать: предпочитают
привезти: привезенный
котэ: котэ
схожий: схожа
замечательный: замечательные
советовать: советуем
надельный: наделен
нарядить: наряжены
подвижный: подвижна
внук-правнук: внуки-правнуки
бдительно: бдительно
сжатый: сжаты
структура: структурах
условие: условиям
сам: само сама самим
селекция: селекции
прилагать: прилагая
миндалевидный: миндалевидная
швейцарец: швейцарцев
сдержанно: сдержанно
заметно: заметно
непривередливый: непривередлива
дело: дело
труд: труда
родоначальник: родоначальника
ген: ген
отличительный: отличительной
перейти: перейти
бшоподойдт: бшоподойдт
запрет: запретом
костяк: костяком костяк
проверить: проверьте
начинать: начинает
уголок: уголках
менее: менее
вершина: вершин
шаейцарский: шаейцарской
тест: тестов
виновный: виновным
германский: германской
раздутый: раздутый
требование: требования
непогода: непогоду
любимец: любимцу любимцами любимца
отсутствие: отсутствие
невероятно: невероятно
слишком: слишком
европа: европе европу
одиночество: одиночеству
будущее: будущего
ассорти: ассорти
придаваться: придавалось
родословный: родословная
сложённый: сложена
комок: комок
подшёрсток: подшерсток подшерстка
даша: даша
падение: падения
работа: работа работу
сзади: сзади
день: день
уравновешенность: уравновешенностью
спина: спины спина
мускулистый: мускулистая мускулистые
призыв: призывы
опекать: опекая
оценка: оценке
бшо: бшо
рубль: рублей
следующий: следующем
книга: книге
паностит: паностит
перпендикулярно: перпендикулярно
правило: правило правила
внимание: внимание внимании
истина: истины
кот: котов коте
использоваться: используется
каждый: каждый
любой: любые любым
дружелюбие: дружелюбия
глубокий: глубокая
соединение: соединения
чесапик-бей-ретривер: чесапик-бей-ретривер
стоимость: стоимость
особенно: особенно
бок: бока
австралийский: австралийская
желательно: желательно
открывать: открывают
удовольствие: удовольствие
строго: строго
появляться: появляясь
нацист: нацисты
отсутствовать: отсутствует
очертание: очертания
заводчик: заводчику заводчики
достаточно: достаточно
поддаваться: поддается
благородно: благородно
бархатистый: бархатистая
мягко: мягко
дрессировать: дрессировать
ответ: ответов
приспосабливаться: приспосабливаться
азартный: азартна
интересовать: интересует
расположение: расположение
угощать: угощать
когтереза: когтерез
ария: арии
полезный: полезной
нагрузка: нагрузках
неделя: неделю
сухопарый: сухопарые
знаменитый: знаменитых знаменитого
переходить: переходят
щетина: щетины
популярность: популярность
осторожность: осторожность
функция: функциями
несмотря: несмотря
ободок: ободок ободке
друг: другом
купить: купить
часто: часто
статус: статусом
легенда: легенда
поставить: поставлены поставленной поставленными
склонность: склонность
ухаживать: ухаживать
наречь: нарекли
характерный: характерная
проходить: проходящих
мелкий: мелкими
регистрация: регистрацию
разводить: разводили
блестящий: блестящую
непременно: непременно
демонстрировать: демонстрирует демонстрировать
сводиться: сводятся
рождение: рождения
наклонить: наклоненный
демонстрироваться: демонстрировались
басенджи: басенджи
обильный: обильный
клуб: клубы
нрав: нравом
сохранять: сохраняют
ушко: ушках
этот: этих
остаться: оставшиеся
здоровый: здоровый
верность: верность
живой: живой
наличие: наличие
пляжный: пляжная
укрывать: укрывающий
травмировать: травмировать
дисплазия: дисплазию дисплазия
входить: входить
уверенность: уверенность
крупа: круп
патология: патологии
громкость: громкость
задавать: задавать
варёный: вареное
обучаемость: обучаемость
одноклассник: одноклассники
вестись: велась
изъян: изъяны
разный: разного разных
плотный: плотнее
энергично: энергично
команда: команды команда
возможность: возможности возможность
чистить: чистить
грудь: грудь
случайный: случайные
чётко: четко
мясо: мясо
порядок: порядке
мускулистость: мускулистостью
сплошной: сплошной сплошное
олений: олений
три: трех
генерация: генераций
лавандовый: лавандовом
европейский: европейском
поиск: поиск
отстранённо: отстраненно
волк: волком
неприхотливый: неприхотлив
зуб: зубы зубов
молодой: молодым
опал: опале
раскосый: раскосые
установить: установили
ганноверский: ганноверской
скакательный: скакательного
потребоваться: потребуется
себя: собой
белые: белые
энергичный: энергичная
выглядеть: выглядят
компаньон: компаньоном
период: период
спорт: спорту
пенаты: пенатах
инвагинация: инвагинация
сторож: сторожа
общение: общении
щётка: щеткой
снисходительный: снисходительным
сделать: сделано
колтун: колтуны
потребность: потребность
порок: пороки
опушить: опушен
забота: заботы
повод: повод
вовсе: вовсе
селекционный: селекционная
линька: линьки линька
жизнь: жизни
аллергический: аллергическим
общество: обществе
отмереть: отмершие
тело: тело
сильно: сильно
едва: едва
яйцо: яйцо
мир: мире
кияять: кияяя
благодаря: благодаря
просторечие: просторечии
понятливый: понятливая
затем: затем
сдержать: сдержан
шёрстка: шерстку шерстке
российский: российских
воспитывать: воспитывать
хоранд: хоранд
эозинофильный: эозинофильный
возвращаться: возвращаться
проживание: проживания
добродушие: добродушие
волнистый: волнистая
нужно: нужно
мимимишность: мимимишности
животик: животик
обосноваться: обосновались
также: также
умный: умная
жилище: жилища
орудие: орудием
идеальный: идеальным
тепло: тепло
цель: цели
момент: моменты
принести: принесли
вырезать: вырезать
фамильярность: фамильярности
нежирный: нежирные
нижний: нижней
почтенный: почтенном
двигательный: двигательной
развитой: развитую
корпус: корпус
поясница: поясница
продолжать: продолжали
баранина: баранина
заводить: заводят
умеренно: умеренно
стоить: стоить стоит
сахарный: сахарному
чистый: чистые
высоко: высоко
выставочный: выставочную
телохранитель: телохранителей
тёмный: темный
смочь: смогут
область: области областью
послушный: послушны
любить: любит любят
ножницеобразный: ножницеобразный
вязка: вязка
край: краям
зависеть: зависит
приобретение: приобретение
вполне: вполне
дрессура: дрессуры дрессуре
голый: голая
непривычка: непривычки
палка: палкой
укоротить: укороченный
убрать: убрать
оригинальный: оригинальной
служба: службе
нелишний: нелишним
тренировка: тренировка тренировок
понаблюдать: понаблюдать
пребывать: пребывают
каша: каши
континент: континенте
легко: легко
изгибаться: изгибаясь
выносливость: выносливость
профессионал: профессионал
лента: ленту
выгул: выгула
чистопородный: чистопородных
словно: словно
известно: известно
хх: хх
детёныш: детеныша
исключение: исключением
ватный: ватным
семейный: семейное
отличный: отличные
инициатива: инициативе
желток: желток
хныканье: хныканья
проявить: проявит
расчёсывать: расчесывать
пасти: пасти
последовательность: последовательность
порезвиться: порезвиться
заплатить: заплатить
безграничный: безгранична
продукт: продуктами
вакансия: вакансии
прямо: прямо
сигнал: сигналов
косолапить: косолапят
прикус: прикус
жизнерадостный: жизнерадостные
спрей: спреями
украшать: украшает
рысь: рысь
голень: голени
выше: выше
определение: определение
прекрасный: прекрасным
палевый: палевый
удобно: удобно
вместе: вместе
двух-четырёхмесячный: двух-четырехмесячных
столетие: столетия
кишечник: кишечника
коричневый: коричневого
рисовый: рисовая
душевный: душевного
главный: главная
причина: причиной
родство: родство
рейтинг: рейтинг
хромота: хромоте
генетический: генетических
весь: всеми
тазовый: тазовых
член: членами
треть: трети
независимо: независимо
подписываться: подписывайтесь
двигаться: движется
внимательный: внимательная
номер: номером
океан: океаном
означать: означает
натуралка: натуралку
хвост: хвоста хвост
запретить: запрещено
брид-класс: брид-класса
алиев: алиева
очень: очень
обычно: обычно
особый: особой
пугливость: пугливости
аппетит: аппетит
умение: умение
мытьё: мытье
олицетворение: олицетворение
постепенно: постепенно
голубой: голубого
происходить: происходит
кличка: клички
голосовой: голосовых
довольно: довольно
австрия: австрии
частность: частности
тряпочка: тряпочкой
ускорять: ускоряют
волосинка: волосинки
обитатель: обитателем
свойственный: свойственны
значение: значения
чрезвычайный: чрезвычайную
передвигаться: передвигаться
шампунь: шампуня
беззвучно: беззвучно
проект: проекте
канада: канаде
число: числе
пращур: пращуры
темно-карий: темно-карего
недопустимо: недопустимо
немец: немцев
потомок: потомки
кг: кг
насколько: насколько
городской: городской
необходимость: необходимости
социализироваться: социализируется
кефир: кефир
полгода: полгода
задействовать: задействованы
среднее: среднего
перуанский: перуанская
действительно: действительно
страна: страна
контроль: контроль
любимый: любимым
мы: нами
квадрат: квадрата
пора: пору
действительность: действительности
регулярный: регулярных
робость: робость
усилие: усилий
глазок: глазки
возбудимый: возбудима
громкий: громким
недостаток: недостаток
плюсна: плюсны
давно: давно
подтянутый: подтянут
родитель: родителей
окончание: окончании
какой: какого
питаться: питающейся
оба: оба
случай: случае
болонка: болонка
загрязнить: загрязненные
допустимый: допустима
мощно: мощно
гораздо: гораздо
сердечный: сердечная
соплеменник: соплеменников
параллельный: параллельными
восторг: восторге
