америка: америке
короткий: короткую короткие короткая короткой
неоговорённый: неоговоренных
обусловить: обусловлено
импровизированный: импровизированная импровизированный
брутальный: брутальную
использовать: используя использовавшей использовали использовать
упитанный: упитанным
тело: тела телу тело
выпадать: выпадает
широко: широко
средний: средняя среднее средней средние
исполинский: исполинского
основа: основе
из-под: из-под
следить: следить
чёрный: черный черная черного черным
посторонний: посторонних
сколько: сколько
чайный: чайным
миссия: миссия
домик: домика
название: название названию названии
часть: частях части часть
фактурный: фактурной
собака: собаку собаками собакой собак собака собаках собаке собаки
примерно: примерно
приём: приеме приемом приема
больший: большими большим большую
порок: пороков пороком пороки
заранее: заранее
губа: губах губа губы
яркий: ярким
справляться: справляются
прикус: прикусе прикуса прикус
фамилия: фамилией
обсуждение: обсуждения
специализация: специализации
величественность: величественностью
цена: цена
реальность: реальности
ламинат: ламинат
делиться: делилось делятся
никто: никому никто
мелкий: мелкое мелкие
подсушивать: подсушивающими
запах: запахом запахов запах
материал: материалов материала
давность: давности давностью
отвлекаться: отвлекаться
выдающийся: выдающейся выдающиеся
эффектный: эффектными
караульная: караульной
вить: вить
след: след следу
календарь: календаре
охотиться: охотятся охотились
дословно: дословно
настойчивость: настойчивостью
дисквалифицировать: дисквалифицирующие
семейство: семейства
ритм: ритму
схожий: схожий
атлантика: атлантику
русский: русский русская
россия: россия россию россии
карьера: карьеру
морда: морде морду морды морда
миска: миска
обратный: обратная обратное
занятие: занятиям занятий
маленький: маленьким меньше
корпус: корпусе корпуса корпус
отчётливо: отчетливо
получаться: получается
следующий: следующих следующим
великобритания: великобритании
выворот: выворота
обрамить: обрамленная
тон: тоном тон тона
радужка: радужки
корректив: коррективы
представитель: представителей представители
отвлечь: отвлечь
умышленно: умышленно
шея: шея
разрушение: разрушения
плащаседло: плащаседла
смертный: смертная
рот: ртами рту
шерсть: шерсть шерсти шерстью
напополам: напополам
трапеза: трапезу
низкий: низкий низкие
нежелание: нежеланием
один: одним одно одной
должный: должны должно
самый: самая самый самых самые
нетипичный: нетипичные
небольшой: небольшого небольшой небольшими
породный: породного породные
свет: свете свет
янтарный: янтарный
взгляд: взгляд взглядом
бладхаунд: бладхаундам бладхаундами бладхаунды бладхаунду бладхаунда бладхаунд бладхаундом бладхаундов
концерт: концерты
посадить: посажен посажены
влечь: влекущему
время: временам время времени
проход: проходе
формировать: формирующие формируют
привязать: привязана
человек: людям людей человеку человека человеком
относиться: относится относясь
питомец: питомцами питомцев питомцу питомца питомцем
королевский: королевской
охотничий: охотничью
красивый: красивой
включая: включая
нога: ног ноги
самодержец-реформатор: самодержца-реформатора
отличаться: отличается
местный: местных
утолстить: утолщенная
формат: формат
магазин: магазин
покладистый: покладистого
важно: важно
стекать: стекающий
сбрасывать: сбрасывайте
расчёсывать: расчесывают
скопиться: скопившиеся
типичный: типичную типичный типичная
история: история
брать: брать
месяц: месяцы месяца месяцев
щенок: щенка щенков щенки щенок щенку
проверять: проверять
нормально: нормально
фитнес: фитнес
потрудиться: потрудиться
выгул: выгул выгула
тянуть: тянет
успешно: успешно
невозмутимый: невозмутимых невозмутимые
никакой: никакой
раздражитель: раздражители
новый: новые новом
настолько: настолько
крупяной: крупяных
пропасть: пропавших
каждый: каждого каждой каждому
голова: голове головами голова
импортировать: импортировал
трансформироваться: трансформируются
минимальный: минимальный
метис: метисами
дрессировочный: дрессировочных
отвечать: отвечающих
даваться: дается
нередко: нередко
истратить: истратила
воронка: воронки
помета: пометах пометы помет
характеристика: характеристика
стоп: стоп
благородный: благородными
такой: таком таких такое такого
скрывать: скрывать
масть: мастей масть мастью
дом: дому домах дом дома доме
выраженность: выраженности
сента-юберы: сент-юберы
гибкий: гибкое
печёночный: печеночного
заводчик: заводчик заводчиков заводчики
зарождение: зарождения
роды: родов
год: годы годах года годам лет год году
пол: пола полу
пятно: пятна
война: войны
истребить: истребили
профессионально: профессионально
предпочитать: предпочитающие предпочитают
вздутие: вздутию вздутие
брудастый: брудастым
находиться: находилась находится
обнаружить: обнаружена обнаружить
еда: еды еду
заворот: заворот завороту
специфический: специфическом
внушительный: внушительный
явление: явлений
порода: породе породы пород породу порода породой
приемлемый: приемлемы
открыть: открыли
отвлекать: отвлекающие
саблевидный: саблевидный
развлечение: развлечениям развлечении
основное: основном
выстрел: выстрелу
видео: видео
помимо: помимо
обследование: обследования
свёрнутый: свернутые
трубка: трубку
недуг: недугу недугов
раб: рабов
внимание: внимания внимание
меню: меню
полностью: полностью
очередь: очередь
гонять: гоняли
смысл: смысл
приподнять: приподнять
длинный: длинное длинные длинный длинная длинными длинной
условие: условии условиях
месячный: месячного
построить: построенного
улица: улицу
компания: компании
закрепиться: закрепилась
домашний: домашних
способный: способный способного способна способен
брылей: брылей
тусовка: тусовку
снимка: снимками
длинноухий: длинноухих
древний: древних древние
нужный: нужна нужный
профилактика: профилактикой профилактике
локтевой: локтевого
приобрести: приобретено
проступать: проступающими
бесконечно: бесконечно
рацион: рациона рационе
охотник: охотника
содержание: содержание содержания
стать: станут стали стать станет
летальный: летальному
вложение: вложений
предположить: предположить
тесновато: тесновато
работа: работе работой
немного: немного
метко: метко
исполниться: исполнилось
дерматит: дерматитам дерматиту
чистокровный: чистокровными чистокровного
вливаться: вливаются
предать: предан
нагружать: нагружать нагружают
мощный: мощный
родительский: родительские
привыкать: привыкает
ринг: ринге
массивный: массивный массивных массивными массивная
оставаться: остаются
воздух: воздуха
знакомство: знакомств
подвес: подвес
помёт: пометов
кстати: кстати
опустить: опущенная
лояльный: лоялен
связь: связь связи
точно: точно
скучать: скучающих
выраженный: выраженная выраженным выраженные выраженного
покрыть: покрыты
квалификация: квалификацию
соперник: соперников
грация: грацией
выяснить: выяснить выясните
арденнский: арденнского арденнские
владелец: владельцев владельцем
длина: длине длины длиной
переводиться: переводится
радужный: радужной
второй: второму втором
иметь: имеющую имеет имея имел имеющих имеют
бедро: бедра
лунатик: лунатик
блёклый: блеклые
опрятно: опрятно
пока: пока
уточнить: уточните
славиться: славились
хлоргексидин: хлоргексидина
жильё: жилья
заряд: заряда
внешний: внешние внешних внешний
обладать: обладают обладает обладающие обладали
прямой: прямыми
ставить: ставят
уживчивый: уживчивым
лёгкий: легким легкий
интерес: интереса интерес интересом
загородный: загородный загородному
подпалина: подпалины
бассет-хаунд: бассет-хаунда
пригород: пригороде
конёк: конек
слюнявый: слюнявы
французский: французских французской французскими
протирать: протирать протирайте
сильный: сильных сильный сильные
монастырский: монастырские
логический: логическим
спокойный: спокойный
выразительный: выразительная
предмет: предметы предмет
скука: скукой
мебель: мебель
двухцветной: двухцветные двухцветным
возглавить: возглавить
качество: качестве качество качества
поворот: поворотах
сента-юбер: сент-юберов
ноздря: ноздрей
бывать: бывают бывает
смотреть: см
бельгийский: бельгийские бельгийское бельгийских бельгийской
ограничительно-запретительный: ограничительно-запретительные
ищейка: ищеек ищейку
фотография: фотографии
мастиф: мастифами
помогать: помогает помогают
невзирая: невзирая
надолго: надолго
занятой: занятых
уход: уходе ухода уход
современный: современные современных
успеть: успевшая успела
надбровье: надбровий
заваливание: заваливания
слежка: слежку
поражать: поражать
дать: данной данные дало
высокий: высокая
тестирование: тестирование
питомник: питомники питомника питомниках
усердно: усердно
верхний: верхней верхняя
закручивание: закручивания
объяснять: объясняя
анатомический: анатомические
узкий: узким узкой
прародитель: прародители прародителями
одноцветный: одноцветных
череп: черепом
взрослый: взрослой взрослых
выбирать: выбирайте выбирая
глаз: глаза глаз глазами
район: районе
сыщик: сыщики сыщиков
работать: работая работают работает
прийтись: придется
прилежание: прилежанию
аномалия: аномалиям
корм: корм корма
тяжёлый: тяжелый
сознание: сознание
вниз: вниз
век: века веке век
вести: вести ведет
настой: настоем
наследовать: наследует
светить: светит
равнодушный: равнодушный
сменяться: сменяется
поскольку: поскольку
тянуться: тянущаяся
тапочки: тапочки
бельгиец: бельгийцев бельгийца
черно-подпалый: черно-подпалых
чемпионство: чемпионство
краткий: краткая
батарейка: батарейки
кровяной: кровяная кровяному
компаньон: компаньона
долгий: долгое
свой: своими своем свой своей своих своему свои
любой: любого любую любой
первоклассный: первоклассные первоклассных
отношение: отношение отношения
овощ: овощей
петлять: петляющая
позаниматься: позанимайтесь
образовать: образующая образуют
малыш: малышей малышам малыша
приводить: приводит приводящих
квест: квест
ребёнок: ребенка детей детях
приветствоваться: приветствуются
эксперт: экспертов
умный: умный умен умная
упрямство: упрямством упрямство
полоса: полосе
криворотость: криворотость
вконтакте: вконтакте
тысяча: тысячи
впечатление: впечатление
детёныш: детенышей
невыразительный: невыразительные
версия: версии версию версия
создать: создать
изоляция: изоляция
любимец: любимцев
удерживать: удерживает
хозяин: хозяин хозяином хозяев хозяина
среда: среде
пахнуть: пахнущая
развитие: развитие развития
ценник: ценник
животное: животных животным животного животными животное
ножницеобразный: ножницеобразном
занимать: занимает
одинаково: одинаково
серьёзный: серьезная серьезных
олень: оленей
мясистый: мясистый
сша: сша
скользкий: скользкой
раскрывать: раскрывать
характер: характером характера характер
преследование: преследования
феноменальный: феноменальное феноменального феноменальные
какой: каком какими
медлительный: медлительные
выбрать: выбрать
запоминаться: запоминающимся
концентрация: концентрация
облик: облик облику
думать: думающие
тщательный: тщательного
напасть: напав напавшей нападет
городской: городскому
основать: основана
хотя: хотя
малышня: малышней
паника: паники
добычливый: добычливыми
продукт: продуктов
сущий: сущее
натура: натуры
вентилирование: вентилирование
рельефный: рельефный
вырасти: вырастут
х: х
расстояние: расстоянии
двухнедельный: двухнедельной
кожа: кожу кожа
мягкий: мягкие мягкая мягкими
близкий: ближайших
общий: общее общего
упорный: упорных
слышный: слышен слышно
неприятный: неприятных
хвост: хвостом хвоста хвост
помешать: помешала
трубный: трубный
пасть: пасть
растянуто-прямоугольный: растянуто-прямоугольный
проблема: проблемы проблема
закон: закон
свободно: свободно
довольствоваться: довольствуются
предрасположенность: предрасположенности предрасположенность
множественный: множественными
квартира: квартире
повторяться: повторяющиеся
заметный: заметен
выпуклость: выпуклости
сотня: сотен
информация: информация
поимка: поимки
складка: складками складки
друг: друг другом другу
резиновый: резиновой
масса: масса массу
телосложение: телосложения телосложением
пригодный: пригодны
чутьё: чутье
сустав: суставы суставов
интересный: интересным интересный
курс: курсов
распространение: распространению
нерв: нервы
глубокий: глубоким глубокая
остальной: остальных остальные
мытьё: мытья
ниже: ниже
генетический: генетической
продолжение: продолжением
окрас: окрас окрасы
пухлый: пухлые
крепкий: крепкие крепким крепких
положиться: положиться
гигантский: гигантскими
польза: пользу
нюхач: нюхач
классический: классический классическом классическим
габарит: габариты габаритам
сравнительно: сравнительно
среди: среди
перебарщивать: перебарщивать
различный: различным
талант: таланты
число: число
дуга: дуги
добыча: добыча добыче добычу
техногенный: техногенных
вредный: вредные
робкий: робкие
грудина: грудине
считаться: считается считаются считались
мыть: мыть
кто: кем
верёвка: веревки
загрязнение: загрязнения
просто: просто
забывать: забывать забывайте
обязать: обязанных
пиодерма: пиодерме
мало: мало
приход: приходу
общеизвестный: общеизвестная
позиция: позиции
подать: подаст
слюнтяй: слюнтяи
мир: миру мире
прочий: прочих
принять: принято
наличие: наличия
природный: природное природных
нравиться: нравятся
учитывать: учитывая учитывать
час: часа часов
завершать: завершая
застенчивый: застенчивые
выход: выходом
отстранить: отстраненный
лорд: лорда
квадратный: квадратный
территория: территории
сука: суками суки сук
лес: лесу
женский: женского
четырехлапый: четырехлапых четырехлапого
белг: белгов
выражение: выражение
добавить: добавьте
хороший: лучший хорошей
прогулка: прогулки прогулках прогулок
цеплять: цепляют
собачий: собачьим
умеренный: умеренная умеренное
происхождение: происхождения происхождение
отразить: отражено
необходимо: необходимо
первый: первые первым первыми первую
деньга: деньги
входящий: входящим
улика: уликами
пища: пищи
терьер: терьер
пигментация: пигментации
распространить: распространена распространенная
позволить: позволено позволят
бегом: бегом
черта: черты
виртуозно: виртуозно
тщательно: тщательно
гончий: гончая гончей гончим гончих
деятельность: деятельность
дрессировка: дрессировка дрессировки
агрессивность: агрессивность
ушной: ушной ушное
требовать: требует требуют
измайловский: измайловском
зафиксировать: зафиксированная зафиксированных
день: дней дня дни
уплощённый: уплощенным
лоб: лбу
одиночка: одиночке
местность: местности
урок: уроки
пясть: пясти
скрещивание: скрещивание скрещивания
учёба: учебы
другой: другие других
напоминать: напоминающими
параллельно: параллельно
догонять: догонять
неожиданно: неожиданно
шкура: шкура
мера: мере
уверять: уверяют
например: например
несколько: несколько нескольких
место: местах
короткошёрстный: короткошерстных
рост: рост
ежедневный: ежедневным
чистокровность: чистокровность
отечественный: отечественных
редкость: редкость
тишина: тишину
согласно: согласно
высококачественный: высококачественной
крошечный: крошечные
обладатель: обладатель
знать: знатью
приспособить: приспособленная
девочка: девочек
давить: давит
идти: идущие
брыль: брылями
морщина: морщинами морщины
к: ко
реклама: реклама
соответственно: соответственно
наклон: наклоном
вставать: встающие
репутация: репутация
монастырь: монастыря
счастливый: счастливы
гончая: гончими гончие
окд: окд
насквозь: насквозь
всяческий: всяческое
воспитание: воспитание
внутрь: внутрь
безусловно: безусловно
собака-следопыт: собака-следопыт
следователь: следователем следователей
отслеживать: отслеживая
розыскной: розыскная
сам: самой
растянутый: растянутые
преть: преет
прямоугольный: прямоугольный
сайт: сайту
решение: решения
свободный: свободного свободные свободной
выращивание: выращивание выращиванию
болезнь: болезням болезни болезнь
родословная: родословной
особенность: особенностей особенностями особенности
похвала: похвалу
ослиный: ослиным
завернуть: завернутое
лишь: лишь
калорийность: калорийность
пытаться: пытается
вариант: вариант варианты
повредить: повредит
долго: долго
ризеншнауцер: ризеншнауцер
смыкаться: смыкающиеся
рабочий: рабочие
выводить: выводить
состоять: состоящим
горло: горла горле
форум: форум форуме
позвоночник: позвоночника
задевать: задевать
компанейский: компанейская
отдавать: отдающих
предпочтение: предпочтение
конец: конце конец
протяжение: протяжении
сушка: сушки
поход: походы
сезонный: сезонно
подвиг: подвиги
расширять: расширять
издеваться: издеваются
заводить: заводить
анатомия: анатомии
характерный: характерную
мясо: мяса
километр: километров
двойной: двойной
ровный: ровные ровной
изрядно: изрядно
напротив: напротив
земля: земли
описание: описание
игра: игр
начало: начало началу
мужской: мужского
стандарт: стандартом стандарта стандарт
исторический: историческому
соревнование: соревнований
подниматься: поднимается подниматься
оттенок: оттенки оттенок
перепрофилироваться: перепрофилируется
лопатка: лопатки
переключаться: переключается
середина: середине
чепрак: чепраком
закрывать: закрывает
поиск: поиске поиск поиска
однако: однако
шумный: шумные
искренне: искренне
имидж: имиджа
внедрять: внедряют
который: которой которого которых которым которые которому который
устраивать: устраивать устраивайте
поэтому: поэтому
отказ: отказ
коричневый: коричневый
копирование: копирование
дружелюбный: дружелюбная
активность: активность активностью
бладхаунд-производитель: бладхаундов-производителей
подверженный: подвержены
предусматривать: предусматривает
существовать: существует
дружелюбность: дружелюбность
печальный: печальный
проводиться: проводятся проводилось
отзыв: отзывах отзывы
оценить: оценят
отследить: отследить
извне: извне
крупный: крупных крупную крупные
заключаться: заключается
неугомонный: неугомонных
кошка: кошки кошками
следовать: следует
годовалый: годовалого
нереально: нереально
поберечь: поберечь
сообразительный: сообразителен
шум: шум
физический: физическое физической
доносить: донося
гость: гостям гостей
служебный: служебную
достать: достанут
висячий: висячие
стандартный: стандартных стандартные
наследственный: наследственную
особь: особи особей
метка: метки
особо: особо
отличие: отличие
навязать: навязанной
лужица: лужицы
утверждать: утверждать
североафриканский: североафриканских
гулять: гуляют гулять
установленный: установленная
самородок: самородки
воодушевлять: воодушевляющий
киль: килем
назад: назад
нижний: нижнюю
кость: кости
ощутимый: ощутимый
локоть: локти
кайфовать: кайфует
предпочтительно: предпочтительно
пищеварительный: пищеварительной
плечо: плечом
падаль: падаль
покупатель: покупателям
скользить: скользят
приносить: приносят
дворик: двориком
ухо: ушей ушах ушами уши ушам
лосьон: лосьонами
целое: целом
клубный: клубного
объявление: объявления
медленно: медленно
просчитывать: просчитывать
развитой: развитое развиты
частное: частного
бульдог: бульдогов
основной: основные
упитанность: упитанность
неокрепший: неокрепшие
глухой: глухой
интеллект: интеллект
охранный: охранные охранной
семейный: семейных
словарь: словарь
отмечать: отмечающий
конечность: конечностей конечности
величина: величины
средне: средне
вес: вес
спина: спину спины
степень: степени
святой: святого
отказываться: отказывавшихся
вносить: вносят
питание: питания
широкий: широкая
голос: голос
возраст: возраст возраста возрасте
ежедневно: ежедневно
нос: носа носом нос
рада: рады
по-настоящему: по-настоящему
запасть: запасть
утратить: утрачен
именно: именно
происходить: происходящее происходит
л: л
неравнодушный: неравнодушны
арденна: арденнах
сегодняшний: сегодняшние
черно: черно
палец: пальцах
догообразный: догообразными
добряк: добряки
продолжительность: продолжительность
коротать: коротать
несоответствие: несоответствие
перекос: перекос
следопыт: следопытов
отлично: отлично
затылочный: затылочный
вряд: вряд
превалировать: превалируют
нюх: нюха
обеспечить: обеспечить
утренний: утреннюю
скрещивать: скрещивать
положение: положении
расположить: расположены
пересечь: пересечь
два: двумя двух
мышца: мышцами
счёт: счету счетов
окрестить: окрестили
полотно: полотно
зависимость: зависимости
результат: результате результатами
первоначальный: первоначальной
продавец: продавца
вокруг: вокруг
учиться: учиться
никак: никак
бороться: бороться
слегка: слегка
тот: те тех тому
оберегать: оберегали
иметься: имеются
опасный: опасных
суперпопулярный: суперпопулярны
пахучий: пахучими
фото: фото
показать: показать
экстерьерный: экстерьерных
переходящий: переходящая
скула: скул
заодно: заодно
активный: активных активнее
мочка: мочке мочка
прорисовать: прорисованный
яндекс: яндекс
количество: количество
дефект: дефект дефекты
давать: дают
участие: участие
зоолог: зоолог
стильный: стильную
лось: лосей
духовенство: духовенство
поведение: поведением
отклоняться: отклоняясь
экстерьер: экстерьером
боков: боков
холка: холке
рык: рык
здоровье: здоровью здоровья здоровье
журнал: журнал
линия: линии линией
нормандский: нормандских нормандские
весь: всей всем
высота: высота
вокальный: вокальные
отсекать: отсекая
подчинение: подчинение
пускать: пускают
действие: действий
особенный: особенное
предстоять: предстоит
розыск: розыска
нуждаться: нуждаются
уголок: уголков
эластичный: эластичная
постав: постав
угс: угс
капюшон: капюшон
свисать: свисая свисающая
покров: покров
экзерсис: экзерсисы
превосходный: превосходные
прочее: прочего
взять: взявшему
свирепый: свирепых
выяснять: выясняют
выдрессировать: выдрессировать
нормандец: нормандцы
совершенно: совершенно
чрезмерно: чрезмерно
контролировать: контролировать
либо: либо
зона: зоны
зверинец: зверинце
этот: этому
взрослеть: взрослеет
минута: минут
загипнотизировать: загипнотизированный
собирать: собирающей
образ: образом
охота: охоте охота охоты
замечательный: замечательные
благородство: благородством
терять: терять теряющая
наплевательск: наплевательски
керн-терьер: керн-терьер
дисквалификация: дисквалификации
сметать: сметать
мускулистый: мускулистое мускулистые
смелый: смелых
кобель: кобели кобелей кобелями
плохо: плохо
движение: движения движении
скакательный: скакательные
диплом: дипломы
воспитанный: воспитанным
указ: указ
глас: глас
сумма: сумму
последний: последними
стычка: стычки
безболезненно: безболезненно
память: памяти
грозный: грозный
перейти: перейти
разумный: разумнее
артефакт: артефактов
зверьё: зверье
сутки: сутки
каторжник: каторжников
штопор: штопор
из-за: из-за
регулярно: регулярно
главное: главное
перетекать: перетекающие
максимум: максимум
помешаться: помешавшейся
уравновесить: уравновешенные
поверхность: поверхностей
удирать: удиравших
оболочка: оболочки
менее: менее
содействие: содействие
указывать: указывает
вопрос: вопросу
поджарый: поджарым
спортивный: спортивной
отменять: отменял
пробежка: пробежек
бельгия: бельгия
полагать: полагают
грудь: груди
клетка: клетка
веер: веер
заблаговременный: заблаговременное
круг: круг
костяк: костяк
светло-карий: светло-карие
торжество: торжества
альтернативный: альтернативная
отсутствие: отсутствие
морфема: морфема
слишком: слишком
европа: европе европы
одиночество: одиночеству
юный: юному
будущее: будущего
требоваться: требуется
трясти: трясти
шалун: шалуну
поглощать: поглощающие
посредством: посредством
вязка: вязками
бархатистый: бархатистую
появляться: появляется появлялись
усиленно: усиленно
гигиена: гигиена
дружить: дружить
внешность: внешностью
участник: участников
подобный: подобные подобных
собственный: собственную
книзу: книзу
неоднородный: неоднороден
оценка: оценке
басистый: басистый
рубль: рублей
грубый: грубой
вывозить: вывозят
требование: требованиям требований
ваш: вашего
массировать: массирующей
общительный: общительная
команда: команд команды команда
сложный: сложнее
смело: смело
основательность: основательность
топ: топ
возможный: возможен
расцениваться: расцениваться
валенок: валенков
полость: полости
слабо: слабо
слуховой: слуховом
нигде: нигде
лесной: лесной
пренебрегать: пренебрегать
десяток: десятков
варежка: варежкой
поработать: поработать
сбить: сбить
п: п
подразделять: подразделяют
ремесло: ремеслу
английский: английскими английские английского
брыластость: брыластость
выставка: выставке
редкий: редкий
стоимость: стоимость
удалять: удалять
актуальность: актуальности
особенно: особенно
отметина: отметины
инструктор: инструктор
стойка: стойке
однотонный: однотонных
строго: строго
спешить: спешите
населить: населенного
взмах: взмахом
достаточно: достаточно
дрессировать: дрессировать
грязь: грязи
пометка: пометку
субпродукт: субпродуктов
трофей: трофеев
ход: ходе
сбалансированность: сбалансированность
обозначать: обозначает
придавать: придает
кабанов: кабанов
темно: темно
редко: редко
напольный: напольным
любим: любимы
бланхаунд: бланхаунды
объёмный: объемная объемные
производить: производят
неделя: неделю
мягкотелый: мягкотелых
переходить: переходят
вынужденный: вынужденные вынужденная
переживаться: переживаются
чрезмерный: чрезмерной
поводок: поводке поводок
точнее: точнее
охотно: охотно
исследователь: исследователи
неплохой: неплохой
включать: включающего
купить: купить
часто: часто
подопечный: подопечных подопечного
гражданский: гражданской
поставить: поставлены
склонность: склонность
красный: красного
выворотзаворот: выворотзаворот
казнь: казнь
товарищ: товарища
коллективный: коллективным
профиль: профилем профиль
принимать: принимает принимают
фанат: фанаты
выдавать: выдавать
бесконфликтный: бесконфликтным
покрытие: покрытиям
вывести: выведенная
разводить: разводили разводить
случай: случаях случаи случае
издевательство: издевательство
сторона: сторону
проживание: проживанию
столетие: столетии столетия
привлекать: привлекают
испытание: испытания
деструктивный: деструктивным
смерть: смерти
душа: душу
сужать: сужающий
система: системы
тёмно-красный: темно-красной
плащ: плащом
постный: постного
делать: делает
соединение: соединении
традиционный: традиционные
талантливый: талантливые
клещеобразный: клещеобразном
кисломолочный: кисломолочных
подпасть: подпала
дисплазия: дисплазию дисплазия
барсук: барсуков
неуловимый: неуловимый
рентгеновский: рентгеновскими
угол: углы угол
крупа: круп
эпилепсия: эпилепсии
гектар: гектаром
далеко: далеко
выдержать: выдержать
одноклассник: одноклассники
скорее: скорее
челюсть: челюсть челюстей
бахрома: бахромой
узнать: узнать узнайте
волосок: волоски
мочь: можете
каша: каш
правда: правда
хозяйский: хозяйские
ходьба: ходьбой
дрессировщик: дрессировщиком
чистить: чистить
пройти: прошло пройти
заканчивать: заканчивая
аббатство: аббатства
квартирный: квартирному
забота: забота
случайный: случайные
кроме: кроме
навык: навыки
завезти: завезшие
постичь: постигло
осмотр: осмотром
шоу-особь: шоу-особей
повлиять: повлиять
человекоориентировать: человекоориентированных
светло-рыжий: светло-рыжего
периодичность: периодичностью
нечего: нечего
щенячий: щенячьем
частый: чаще
профессиональный: профессиональным
получить: получить
крупногабаритный: крупногабаритные
весить: весить
тазобедренный: тазобедренного
зуб: зубы
мало-мальски: мало-мальски
закисание: закисания
ждать: ждал ждала
культивировать: культивировали
тайна: тайны тайну
лестница: лестницам
тенденция: тенденции
мышечный: мышечная
себя: собой
белые: белые
апорт: апорт
выглядеть: выглядят выглядела
концентрироваться: концентрироваться
разместить: разместить
шампунь: шампунем
дичь: дичь
ротовой: ротовой
дорожка: дорожка
рыбный: рыбного
нормальный: нормального
светлый: светлые светлый
сделать: сделано
выгуливать: выгуливают
конкретный: конкретном конкретных
карапуз: карапуза
потребность: потребность
периодически: периодически
сохраниться: сохранилась
деформировать: деформировать
повод: повод
утрировать: утрированные
парик: парик
предок: предков предками
личный: личном
вовсе: вовсе
наскучить: наскучить
жизнь: жизни
увешать: увешана
вытянутый: вытянутым
они: ними
отмереть: отмершие
сильно: сильно
флегматичность: флегматичности
право: право правах
мешать: мешает
роскошный: роскошный
благодаря: благодаря
оговорить: оговоренным
обзор: обзора
монах: монахи
шелковистый: шелковистая
затем: затем
пловец: пловцы
видеть: видит
пространство: пространства
группа: группы
обитель: обители
воспитывать: воспитывать
выступление: выступлению
кровь: кровью
молоссова: молоссов
цветной: цветная
блокировать: блокируя
отличать: отличает
пункт: пункта
нужно: нужно
мимимишность: мимимишности
также: также
проблемный: проблемные
бруталый: бруталы
дисциплина: дисциплине
жилище: жилища
прозвать: прозванные
достаточный: достаточной
покупка: покупки покупка
шёрстный: шерстный
шестой: шестому
момент: моменты момент
повышенный: повышенная
маршрут: маршрута
выпуклый: выпуклой
скормить: скормить
порция: порциями
секрет: секрет
скос: скоса
пугливостьчрезмерный: пугливостьчрезмерная
рассматриваться: рассматриваются
живот: живота
исход: исходу исход
аромат: ароматы
поясница: поясница
мысленный: мысленную
отсюда: отсюда
начинать: начиная
морщинка: морщинки
выставочный: выставочную выставочное
предпосылка: предпосылки
впоследствии: впоследствии
лакомство: лакомства
ожирение: ожирению
крайне: крайне
отяготить: отягощенными
область: области
стоить: стоит
это: это
вид: вид
найти: найденной
обидеть: обидит
существо: существа
брыть: брыли
филе: филе
беглый: беглых
затягивать: затягивать
наклонить: наклоненные
кормить: кормить
практиковать: практиковали
недопуск: недопуск
вполне: вполне
предложить: предложил
беспамятство: беспамятства
разыскивать: разыскивают
создавать: создающий
прокладываться: прокладывается
своевременно: своевременно
выгибать: выгибая
линять: линяющей
служба: службе
приглашать: приглашайте
расти: расти
тренировка: тренировка
сезон: сезон
заинтересованность: заинтересованность
легко: легко
ежеминутно: ежеминутно
склонный: склонна
диванный: диванной
лента: ленту
вверх: вверх
грешить: грешат
интенсивно: интенсивно
тренер: тренер
безжалостный: безжалостных
тип: типа
защищать: защищающей
особняк: особняк
дух: духа
последовать: последует
упорно: упорно
лай: лай
печеночно-подпалый: печеночно-подпалыми
говорить: говорит
по-львиному: по-львиному
брыластый: брыластые
разновидность: разновидность
настоящий: настоящие
сила: силу
управляемый: управляемым
инспекция: инспекцию
вакансия: вакансии
угощение: угощение
прямо: прямо
обратно: обратно
старый: старому
горизонтальный: горизонтальных горизонтальный
приходиться: приходится
линолеум: линолеум
разглядеть: разглядеть
добродушный: добродушные добродушного
обойтись: обойдется
встречаться: встречается встречаются
полтора: полтора
постоянно: постоянно
план: плане
вроде: вроде
выделить: выделить
путать: путать
вечерний: вечернюю
голень: голени
псовина: псовиной
выше: выше
грудной: грудная
захватывать: захватывая
единственный: единственное
течение: течение
чересчур: чересчур
запираться: запиравшихся
оказывать: оказывать
неординарный: неординарного
кишечник: кишечника
разделить: разделить
юбер: юбера
кабан: кабана
главный: главная
практически: практически
логично: логично
мироздание: мироздания
причина: причиной
рейтинг: рейтинг
баснословный: баснословную
получасовой: получасовые
мнение: мнению
слабохарактерность: слабохарактерностью
ряд: ряд
важность: важность
промежуток: промежутками
подписываться: подписывайтесь
двигаться: движется
суетливый: суетливому
самостоятельно: самостоятельно
трубчатый: трубчатую
кинолог: кинологом
запретить: запрещено
очень: очень
закрепить: закрепить
обычно: обычно
бок: бокам бок
плотный: плотной
обязанность: обязанностью
наиболее: наиболее
толстый: толстый
грызть: грызут
ультракороткий: ультракороткая
постепенно: постепенно
сотрудничать: сотрудничать
кличка: клички
правило: правила
довольно: довольно
прежде: прежде
частность: частности
держать: держать
уединение: уединение
исключительный: исключительных
бесправный: бесправного
надбровный: надбровные
сельский: сельской
касаться: касается
беспрекословный: беспрекословное
племенной: племенного
весело: весело
сконцентрировать: сконцентрированным
проходиться: проходятся
одновременно: одновременно
командный: командный
бледно-рыжий: бледно-рыжий
проект: проекте
сразу: сразу
ныряльщик: ныряльщики
бронирование: бронирование
потомок: потомки
пора: пор
кг: кг
необходимость: необходимости
злобность: злобность
среднее: среднего
линька: линька
дверь: двери
страна: страна
низко: низко
темперамент: темперамент
интерьер: интерьер
сабаней: сабанеев
позволять: позволяющей
подмять: подмявшие
иной: иная
разнообразный: разнообразное
внутренний: внутренней
спускаться: спускаться
психологический: психологическими
причём: причем
расположение: расположении
опытный: опытным
развить: развитая
усилие: усилий
предписывать: предписывавший
лаять: лает
недостаток: недостаток
плюсна: плюсны
сосед: соседей
событие: события
умственный: умственное
катастрофа: катастроф
далёкий: далеких
натуральный: натурального
кормление: кормление
бугор: бугор
конкурсант: конкурсанта
циркуляция: циркуляцию
кончик: кончике
являться: является
пострадать: пострадавших
огородить: огороженным
болонка: болонка
рысью: рысью
выгуливаться: выгуливающиеся
конструкция: конструкцию
житель: жителей
пётр: петр
пыль: пыли
сенбернар: сенбернаров
импозантность: импозантность
параллельный: параллельными
донести: донести
исходящий: исходящий
воздействие: воздействий
просторный: просторной
известность: известности
действовать: действовал
