низ: низ
радость: радостью
предпринять: предпринять
расформирование: расформирование
отечественный: отечественная отечественных
заметить: заметили
овощ: овощи
взяться: взялись
кинолог: кинологов
тело: тела
кровь: крови
стоять: стоять
средний: средняя среднее
смириться: смириться
агрессия: агрессия
неоспоримый: неоспоримых
насыщение: насыщения
добрый: доброго добрая
расти: растет
наверняка: наверняка
выделяться: выделяется
сколько: сколько
четверолапый: четверолапого четверолапый
уметь: умеют
название: название названия
эталон: эталон
собака: собаку собаками собакой собак собака собакам собаки
примерно: примерно
источник: источник
повременить: повременить
переселять: переселять
карело-финн: карело-финн карело-финны
прикус: прикусе прикуса
обсуждение: обсуждения
другой: другое другие других другими
миска: миску
оптимально: оптимально
цена: цена
удаваться: удается
материал: материалов
поголовье: поголовья
питомец: питомце питомцами питомцы питомца питомцем
настоящий: настоящими настоящая
расчёска: расческой
идеальный: идеальные
массивный: массивным массивнее массивные
прокачка: прокачки
владелец: владельцам владельца владельцев владельцем
поведение: поведения поведением поведение
натаска: натаска натаске
пригодиться: пригодится
собственный: собственных собственного собственным собственной собственную
мускулистый: мускулистыми
морской: морская
простой: простого проще
сторона: стороны сторона сторону
больший: большим большие больших
семейство: семейства семейству
побегать: побегать
сомкнутый: сомкнутые
месяц: месяцем месяц месяца месяцам месяцев
цукат: цукаты
россия: россия россии
живот: живот живота
дремать: дремать
обратный: обратная
итог: итоге
занятие: занятиям занятии
берлога: берлоги
корпус: корпусе корпус
отчётливо: отчетливо
начинать: начинают начинать начинает
радужка: радужки радужка
представитель: представителей представителя представителю представитель представителями представители
искать: искать
раззадорить: раззадорить
охранник: охранник
команда: команду командами команды команда
скопировать: скопировать
шея: шея
шерсть: шерсть шерсти шерстью
компаньон: компаньоны
финн: финнов
выразить: выражены
шуршать: шуршащее
рыба: рыба
выкручивать: выкручивающим
собака-работяга: собаки-работяги
карело-финский: карело-финской карело-финским карело-финскими карело-финских карело-финская карело-финские
объявиться: объявились
челюсть: челюсти челюсть
чемпионский: чемпионскими чемпионские
готовить: готовить
должный: должны должно должна
самый: самая
тип: тип
узкий: узкая
финский: финским финскими финский финских финские финского финскую финском
север: север
взгляд: взгляд
разъярённый: разъяренного
начать: начнет начать начните начав
защита: защита
гуляние: гуляния
останавливать: останавливают
один-единственный: один-единственный
рождаться: рождаются
ушной: ушных ушное
необходимый: необходимы
иметься: имеется
пикник: пикник
сверху: сверху
столь: столь
тестирование: тестированием
дозированно: дозированно
включая: включая
нога: ног ноги ногах
отличаться: отличается
формат: формат формата
дежурить: дежурить
карелка: карелке карелки карелок карелка карелками карелкой
важно: важно
небольшой: небольшое небольшой
рис: рис
иллюзия: иллюзию
расчёсывать: расчесывают
битый: битую
признак: признаками признаков
осторожный: осторожный
склонный: склонные
встретить: встретить встретите
история: история
подняться: поднялась
пышный: пышный
брать: брать берите
возможный: возможными возможен
промысловый: промысловыми промысловая промысловой
щенок: щенка щенков щенки щенком щенок щенку щенкам
компактность: компактность
нормально: нормально
шпиц: шпицы шпицами шпиц шпицем шпица шпицев шпице
успешно: успешно
причислить: причислили
никакой: никакой
лес: леса лес
руководство: руководства
проявлять: проявляет
выезжать: выезжающая выезжающих выезжающим
навёрстывать: наверстывать
подстрелить: подстреленной подстреленную
каждый: каждого каждым каждые каждый
взрослый: взрослый взрослую взрослому
голова: голове голова
приятно: приятно
семья: семьи семье
нередко: нередко
чувство: чувством чувство
шерстяной: шерстяного
характеристика: характеристика
стоп: стоп
такой: таком такое такие такого таким такими
руб: руб
соответствие: соответствии
переход: переходы
заводчик: заводчик заводчики
следующий: следующие следующий
голень: голенями
тёплый: теплым теплое
повод: поводу
вид: виды виде вид
звериный: звериные
коготь: когти
мастерски: мастерски
значит: значит
систематически: систематически
быстро: быстро
тугодум: тугодум
удаться: удалось
водоём: водоемах
видео: видео
грубый: грубый
обитать: обитавшие
крошечный: крошечный крошечным
фронтальный: фронтальной
удостоиться: удостоились
полностью: полностью
меню: меню
улица: улицу улице
компания: компании
смелость: смелость
эффектный: эффектные
местечко: местечке
домашний: домашнюю домашнего
талант: талантов
рацион: рациона рацион
охотник: охотника охотник охотников
речь: речь
знакомиться: знакомиться знакомится
содержание: содержание содержания
различие: различиях
ручей: ручьях
стать: станут стали стало ставшая
мелкий: мелких мелкого
работа: работе
приучать: приучать приучая
хвост: хвосте хвосту хвоста хвост
наведываться: наведываться
составлять: составляет
бесплатный: бесплатный
приходиться: приходилась
реагировать: реагировать
численность: численность
окрас: окраса окрас окрасы
ветеринар: ветеринару
подкармливать: подкармливают
протереть: протрите
догонялки: догонялки
помёт: пометов
кстати: кстати
территория: территорию территориях
он: нему
связь: связь
русский: русские русская
адепт: адептов
точно: точно
выделять: выделять
кабинет: кабинете
рахит: рахита
автоматизм: автоматизма
соперник: соперников
вода: воде водой
разрушительный: разрушительные
внешность: внешность внешности
энергичный: энергичные
лидерствовать: лидерствовать
вредность: вредности
губерния: губерний
налёт: налет
пока: пока
фон: фоне
образ: образа образом
профессиональный: профессиональных
развиваться: развивается
завиток: завитком
потерять: потерять
собачий: собачьего собачьим собачьими
обладать: обладают обладая
дважды: дважды
интерес: интереса интерес
давать: давать дают
значительный: значительных
покраснение: покраснения
интуитивный: интуитивное
бить: бьет
среднестатистический: среднестатистический
эктопаразит: эктопаразитов
лишний: лишние
универсальный: универсальных
остальной: остальная остальном
выставка: выставки выставку
старший: старше старшего
приём: приемов
качество: качестве качество качества
птица: птиц птицу
бывать: бывают
смотреть: см
друг: друзья друг другу
иммунитет: иммунитетом
белок: белками
самодостаточный: самодостаточные
фотография: фотографии
карельский: карельской карельские карельского
невзирая: невзирая
заслужить: заслужить
уход: уходе уход
современный: современные
медовой: медовой
переставать: переставая
манный: манной
телепат: телепат
голубой: голубой
создание: создания созданий создание
помнить: помните помнить
псина: псиной
шумный: шумная
высокий: высокая высокого высший высокий
властвовать: властвовать
питомник: питомники питомников
повышенный: повышенную повышенная
пара: пары пару
сухофрукты: сухофрукты
отдавать: отдавать
глаз: глаза глазами
разлив: разлива
район: районе
решать: решать
благоразумный: благоразумны
прийтись: придется
авторитарный: авторитарный
слезливость: слезливость
устремляться: устремляется
вопреки: вопреки
свистнуть: свистнуть
ринг: рингу
тщательный: тщательный
вниз: вниз
часть: части часть
председатель: председателем
смысл: смысле
век: века
вести: вести ведите
год: года годам лет год году
лайк: лайки лайке лайками лайка лайку
буроватый: буроватый
охотничий: охотничьи охотничьих охотничьими охотничьим охотничья охотничьем охотничьей
краткий: краткая
скрещивание: скрещиванием
обзавестись: обзавестись
весьма: весьма
диета: диета
свой: своими своего свои
лайка: лайкой лаек
проконтролировать: проконтролировать
отношение: отношение отношением отношения
место: место места
одинаковый: одинаковы одинаковыми
ветвь: ветви ветвью
зверь: зверю зверя зверем зверей
чистый: чистую чистой
псовый: псовая
первый: первом первые первый первых
эксперт: экспертов
купать: купать
вырисовываться: вырисовывающейся
крупяной: крупяными
ждать: ждут
вконтакте: вконтакте
свет: свет
рассчитывать: рассчитывайте
впечатление: впечатление
некий: некой
ярко: ярко
гусь: гуся
шубка: шубки
пахнуть: пахнущая
устранить: устранить
приучить: приучите приучить
сельскохозяйственный: сельскохозяйственную
животное: животных животным животного животные животное
ножницеобразный: ножницеобразном
раковина: раковин
старый: старая
одинаково: одинаково
попасть: попавшая попали
общий: общий
свежий: свежими
чреватый: чревато
адекватно: адекватно
волос: волос
длина: длины длина
инбридинг: инбридингом
конституция: конституции
выбрать: выбрать
кусочек: кусочки
концентрация: концентрация
скула: скулы
зависимый: зависимого
оценить: оцените
оборудовать: оборудовать
общество: общества обществе
счёт: счет
шкурка: шкурки
основать: основана
сустав: сустава суставами суставов
шёрстный: шерстного шерстный
хотя: хотя
малышня: малышней
нижний: нижняя
стандартизация: стандартизации
дисциплинировать: дисциплинирует
знать: знаю
х: х
расстояние: расстоянии
мягкий: мягкие
спор: споры
самостоятельность: самостоятельность самостоятельности
выгуливать: выгуливать
красавица: красавица
купить: купил купить
помешать: помешала
северный: северных
проблема: проблемы проблему проблем
свободно: свободно
грязный: грязными
мама: мамы
бедро: бедрах бедру бедрами
отыскивать: отыскивают
квартира: квартире
облаивать: облаивать
мясной: мясном
разговорчивый: разговорчивого
угощение: угощением
информация: информация
наклонный: наклонным
масса: масса массой массу
чутьё: чутье
сначала: сначала
универсальность: универсальность
изделие: изделиями
активный: активного
приподниматься: приподнимается
родословный: родословную
обитание: обитания
лечь: лечь
крепкий: крепкие крепким крепкий
прямой: прямом прямые прямой
цепной: цепная
сухой: сухой сухая
скрещиваться: скрещиваться
сравнительно: сравнительно
среди: среди
соображать: соображает
племенной: племенной
экстерьерный: экстерьерные
налагать: налагает
лапа: лапах лапы
сука: суке суки сук
линия: линию
это: этим это
проточина: проточины
коротковатый: коротковатой
считаться: считается
стыдно: стыдно
развитой: развитыми развитых
тряпочка: тряпочку
ваш: ваше вашей вашем
карелов: карелов
просто: просто
пройтись: пройтись
мало: мало
податься: податься
слизистая: слизистую
развитый: развитый
подождать: подождать
снизить: снизить
костный: костные
упрямиться: упрямиться
понимать: понимающего понимать
знакомить: знакомить
неожиданно-популярный: неожиданно-популярной
обрадовать: обрадован
закрутить: закрученный
час: часа
прорисовать: прорисован
сложность: сложность
беспроблемный: беспроблемная
сентябрь: сентябрь
пушистый: пушистой пушистый
низкий: низкая
квадратный: квадратный квадратного
который: которое которыми которой которая которых которым которые которому который
добавить: добавьте
чистка: чистка
молодой: молодой
светлый: светлой светлее
прогулка: прогулки
я: мной
предрасположенность: предрасположенность
происхождение: происхождения
необходимо: необходимо
ловко: ловко
готовый: готовы готов
утяжелить: утяжеленная
пожалуй: пожалуй
развесить: развешенные
пища: пищи пищу
дойти: дошло
преподавать: преподавать
задний: задние задних
редкий: реже
черта: черты
тракт: тракт
дрессировка: дрессировка дрессировке
время: время
рыжий: рыжим рыжего рыжих рыжая рыжие
косуля: косулями
агрессивность: агрессивность
упорядоченность: упорядоченности
полость: полость
многочисленный: многочисленных
вздохнуть: вздохнуть
жёсткий: жесткий
урок: уроки
противный: противном
пясть: пясти
курица: курицу
недельный: недельном недельных
кость: костей костями
блюдо: блюдо
они: ими
просмотр: просмотров
ловить: ловит
объединить: объединенная
параллельно: параллельно
подкормка: подкормки
улучшить: улучшили
отказаться: откажутся отказаться
мера: мере меры
уверять: уверяют
охотница: охотницы
например: например
питаться: питаться питающимся
несколько: несколько
превосходно: превосходно
частный: частную
рост: рост
борзая: борзая
облаять: облаять
согласно: согласно
трофей: трофея трофеями
метрика: метрикой
девочка: девочек
жить: жить живущих живу
близкородственный: близкородственным
резко: резко
к: ко
реклама: реклама
соответственно: соответственно
незначительный: незначительному
исполниться: исполнится
сыр: сыр
облегчённо: облегченно
сельский: сельскую
исполнительный: исполнительна
лосьон: лосьоном
лакомство: лакомствами
насадка: насадкой
плохой: плохой
выраженный: выраженным
ущемление: ущемление
характерный: характерны
воспитание: воспитание воспитании
вывих: вывихам
обладание: обладание
безусловно: безусловно
один: одно одна одними одну одни
наказать: накажите
вытащить: вытащите
порок: пороках пороки
сайт: сайту
повтор: повторов
родословная: родословной
приживаться: приживается
весенний: весенняя
выпуклый: выпуклым
нежели: нежели
задорный: задорного
понять: понять
бесконтрольный: бесконтрольной
паста: пастой
крупный: крупная крупных крупнее крупного крупные крупным
этот: эта этих
быть: будут
лишь: лишь
вариант: вариант
окружающий: окружающей
рабочий: рабочие
репутация: репутацией
болото: болота
ветеринарный: ветеринарном
форум: форум форуме
задевать: задевать
пилотаж: пилотаж
конец: конце конец
добровольно: добровольно
белка: белки
начало: начала начало
требовать: требуют требующие
купание: купанию
лайкам: лайкам
мальчик: мальчики
увлекаться: увлекается
комочек: комочки комочком
компенсировать: компенсировать
посягать: посягают
шумливый: шумливая
ровный: ровные ровным ровной
ходить: ходили ходить
кончик: кончиками кончики
заплыв: заплыва
описание: описание
травяной: травяными
убирать: убирать убирают
добыча: добычу
миттельшнауцер: миттельшнауцер
вторгаться: вторгающихся
хлоргексидин: хлоргексидином
приграничный: приграничных
ромашковый: ромашковом
дорога: дорогой
парка: паркам
послушный: послушна
посадить: посаженные
лопатка: лопатки лопатках
доброжелательный: доброжелательным
округлый: округлые
белый: белых
подростковый: подростковом
еда: еда
стоячий: стоячие
прыгать: прыгая
длинный: длинный
посмотреть: посмотрите
однако: однако
дело: делу дело
становиться: становится становятся
плутишка: плутишкам
поэтому: поэтому
четыре: четырех
родить: рожденных
копирование: копирование
достоинство: достоинств достоинства
активность: активность активности
направить: направленные направленная
выждать: выждать
куница: куница
существовать: существует
наставник: наставника
осматривать: осматривайте
дружелюбность: дружелюбность
застелить: застелить
вольерный: вольерная
прессовать: прессованными
насыщенный: насыщенного
подвижный: подвижные
отзыв: отзывах отзывы
ротовой: ротовую
юный: юном
кошка: кошки
следовать: следует
находчивость: находчивость
нормальный: нормальным нормальной
резкий: резкие
выделение: выделения
шум: шум
натуральный: натуральными натурального
гав: гав
собакакака: собакакак
наблюдать: наблюдать
доесть: доела
разрядка: разрядки
местность: местность
спальный: спальное
биография: биографии
назад: назад
перспектива: перспективами
планировать: планируете
отставать: отстающий
цвет: цвет
слой: слоем
откровенный: откровенное
зарубежный: зарубежные
дом: дома доме
осторожно: осторожно
мочь: могут можете
посетить: посетите
клещ: клещей
движение: движением
переходить: переходя переходят
порода: породы пород породу порода
хулиган: хулигана
кровать: кровати
ухо: ушей уши
целое: целом
объявление: объявления
сделать: сделать сделано
отдельный: отдельное отдельной отдельных
ускоренный: ускоренном
основной: основные
повторяться: повторяются
отправиться: отправятся
кобель: кобелю кобели кобелей
интеллект: интеллект
охранный: охранные
конечность: конечностей конечности
средне: средне
конфликтовать: конфликтовать
вес: вес
уважение: уважение
охотиться: охотиться
притворяться: притворяться
питание: питания питание
неизбежность: неизбежностью
попытаться: попытается попытались
голос: голос
возраст: возраст возраста возрасте
ежедневно: ежедневно
постав: постава
ввоз: ввоза
позитивный: позитивное
овсяный: овсяной
именно: именно
признательность: признательность
апатичный: апатичной
отклонение: отклонения отклонениями
энергия: энергия
любимый: любимому
правильный: правильнее правильный правильной
оттаивание: оттаивания
продолжительность: продолжительность
вязать: вязать
стандартизировать: стандартизировать
процент: процент
добычливость: добычливости
весёлый: веселое
член: членов члены
отлично: отлично
право: прав
страна: страны страна
затылочный: затылочный
второй: вторая втором
короче: короче
рыжик: рыжика
окончательный: окончательное
оттенок: оттенок оттенками
попасться: попался
инстинкт: инстинктов инстинктами инстинкт
молочный: молочной
витаминно-минеральный: витаминно-минеральные
полотно: полотно
тон: тонов
размер: размера
утро: утрам
подход: подход
опорно-двигательный: опорно-двигательной
депигментировать: депигментированная
стандартный: стандартного
учиться: учиться
именовать: именуют
никак: никак
слегка: слегка
тот: те та
способный: способная
единый: единой
фото: фото
сесть: сесть
толчок: толчком
накладываться: накладываться
недоверие: недоверием
вспугивать: вспугивают
популярный: популярным
м: м
вы: вами
заменить: заменив
игривый: игрива
яндекс: яндекс
обращение: обращение
количество: количество
участие: участие
потапович: потапыча
оставлять: оставлять
томат: томатами
череп: череп
сравнение: сравнении
экстерьер: экстерьером
боков: боков
спина: спиной спины
холка: холке холкой
заход: заход
жёлтый: желтый
двор: дворе
журнал: журнал
неделя: недели недель неделю
высота: высота
советский: советские
стиль: стиль
зацикленный: зациклены
коллаген: коллагена
сварить: сваренную
последующий: последующим последующей
ленинградский: ленинградского
диван: диван
морковь: морковь
насилие: насилие
гулять: гулять
уголок: уголков
определить: определить
ванна: ванны
спинка: спинкой
граничить: граничащий
хозяин: хозяину хозяина
показаться: показалось
образование: образование образованию
покров: покров покрова
болезнь: болезни
косо: косо
притравочный: притравочной
кормить: кормят
настой: настое
лизать: лижет
заталкивать: заталкивать
чрезмерно: чрезмерно
либо: либо
внешний: внешними внешняя
поиграть: поиграть
вдоволь: вдоволь
терять: теряют
стадо: стада
минута: минут
выводить: выводят
профилактический: профилактические
ладить: ладим
самозванец: самозванец
упрямство: упрямство
кошачий: кошачьи
человек: человека
охота: охоте охота охоты охотой охоту
ущерб: ущерба
внимательно: внимательно
задумываться: задумывается
увеличивать: увеличивать
станция: станции
полтора: полутора
туалет: туалету
полезный: полезный полезны
предложить: предложенное
весь: всему всем
потенциальный: потенциального
диплом: дипломы
условие: условиях
заметно: заметно
немаловажный: немаловажно
взросление: взросления
помета: помете
глухарь: глухарей
день: дня день
темп: темпе
смочить: смочите
выводиться: выводились
перейти: перейти
переезд: переездом
атаковать: атакуют
обиженный: обижен
сутки: сутки
сгодиться: сгодится
уменьшать: уменьшают уменьшая
из-за: из-за
быстрый: быстрее быстрая
регулярно: регулярно
главное: главное
заострить: заостренной
график: графику
красновато-золотистый: красновато-золотистого
скакательный: скакательными скакательного
заморачиваться: заморачиваться
менее: менее
укус: укуса
определять: определяет
пти-брабансон: пти-брабансон
обрабатывать: обрабатывайте
выстраивать: выстраивает
глядеть: глядя
порция: порцию
трехнедельный: трехнедельных
шалить: шалит
поохотиться: поохотиться
грудь: груди грудь
цель: целью
отказываться: отказывается
костяк: костяк
пассажир: пассажир
область: область
отсутствие: отсутствие
слишком: слишком
одиночество: одиночеству
развернуть: развернут
гнойный: гнойные
требоваться: требуется
зимой: зимой
бесстрашие: бесстрашие
стандарт: стандарта стандарт
пик: пик
морда: морда
угольный: угольного
гигиена: гигиена
средство: средствах
внутренний: внутренняя
птичий: птичьи
подобный: подобные
относиться: относятся
выгул: выгулом
любящий: любящая
густой: густой
оценка: оценке
рубль: рублей
круг: кругу
сказываться: сказывается
расчёсывание: расчесывания
плотный: плотном
мочка: мочка
отрабатывать: отрабатывать
свешиваться: свешивается
бесспорный: бесспорно
нежирный: нежирное нежирная
внимание: внимание
зубной: зубной
любой: любые любой
здоровый: здоровые здоровое
месячный: месячных
короткий: короткие короткая короткой
жилище: жилище
иметь: имеет иметь имеют
необоснованный: необоснованная
стоимость: стоимость
удалять: удалять
приобрести: приобрести приобрела
последний: последнее
подписать: подписано
поддерживать: поддерживать
иначе: иначе
особенно: особенно
отметина: отметины
аккуратный: аккуратны
засыпать: засыпать
подавать: подавать
личный: личное
масштабный: масштабного
нервозность: нервозностью
узнавание: узнавания
возле: возле
симметрично: симметрично
рыже-медовый: рыже-медового
надбровье: надбровья
металлический: металлической
достаточно: достаточно
обязательно: обязательно
парный: парной
пинцет: пинцета
оба: обоими
дружеский: дружеские
привычка: привычки
полениться: поленитесь
достойный: достойный
неухоженный: неухоженные
зоомагазин: зоомагазина
апортировать: апортируют
производить: производит
поводок: поводке
любитель: любителей
форма: формы
значимость: значимости
несмотря: несмотря
неплохой: неплохой
фонтан: фонтаном
часто: часто
пользоваться: пользуется
распрямляться: распрямляется
бороздка: бороздка
поставить: поставлены поставленные поставленными
раздражить: раздраженных
вопрос: вопросом вопрос
обожать: обожаемому
медведь: медведя
товарищ: товарища
развитие: развитии
целесообразный: целесообразнее
принимать: принимает принимавшая
смышлёность: смышленостью
желание: желание
период: периоды период
удивить: удивили
преступление: преступления
недостаток: недостатки
дикий: дикого
газета: газетами
обустраиваться: обустраиваться
глазной: глазных
ссср: ссср
утомительный: утомительных
отработать: отработать
наличие: наличие
гречка: гречка
обращать: обращайте
толстой: толстой
забывать: забывают забывайте
объявляться: объявлялись
эпилепсия: эпилепсии
выстрел: выстрел
круто: круто
каресть: карело
открытый: открытых
недолюбливать: недолюбливают
проморозить: промороженный
племя: племени
далеко: далеко
навсегда: навсегда
реальность: реальностью
одноклассник: одноклассники
появление: появлению
сам: самому
транспортировать: транспортировать
клан: кланами кланом
детвора: детворы
возможность: возможности
породный: породной
притравка: притравку
ушко: ушками
случайный: случайные
передний: передние передних
самодостаточность: самодостаточности
кроме: кроме
мясо: мясо
мечта: мечты
прицепиться: прицепился
взять: взять
откровенно: откровенно
стандартно: стандартно
великий: великая
кеннел-клуб: кеннел-клуба
среднее: среднем среднего
компромисс: компромисса
суть: сути
держаться: держится
частый: чаще
поиск: поиск
польза: пользы
упустить: упущенное
привести: привело
важный: важные
зуб: зубы зубов
удобный: удобные
вообще: вообще
карий: карими
проявить: проявила
вкусняшка: вкусняшку
есть: ест
туда: туда
характер: характер
потребоваться: потребуется
безопасный: безопасный
некоторый: некоторые
себя: собой
основный: основная
официальный: официальное
белые: белые
выглядеть: выглядят выглядит
воротник: воротника
продукт: продукт продуктами
обделить: обделенная
дичь: дичь дичью
порезать: порезанным
встать: встал
президент: президентом
миндалевидный: миндалевидные
сторож: сторожа
пищеварительный: пищеварительный
дисплазия: дисплазии
правило: правилах правила
спустить: спустите
нос: нос
пушной: пушных пушного
потребность: потребность
периодически: периодически
волна: волной
поступок: поступков
остевой: остевой
практический: практической
линька: линьки линька
жизнь: жизни
два: двух
заканчиваться: заканчивается
пугаться: пугаться
вооружаться: вооружайтесь
мешать: мешает
миниатюрный: миниатюрная
телосложение: телосложением
объёмный: объемного
двигаться: двигаться
дисквалифицировать: дисквалифицирующих
система: системой
облегчение: облегчения
видеть: видит
четырёхлетний: четырехлетней
переутомить: переутомить
очистить: очистить
война: война
главный: главные главная
угощать: угощайте
обучение: обучение
шоу: шоу
нужно: нужно
материальный: материального
относительно: относительно
малоежками: малоежками
мимимишность: мимимишности
поглотить: поглощены
вызывать: вызывают
также: также
параметр: параметры
умный: умная
настроение: настроение
достаточный: достаточной
бактерия: бактерий
момент: моменты
мясистый: мясистыми
косолапый: косолапого
свидетельствовать: свидетельствует
принести: принесло
эталонный: эталонным
мария: мария
город: городе города
приносить: приносящего
внеплановый: внеплановые
бульон: бульоне
малыш: малыши малыша
поправиться: поправилась
круп: крупу крупом
изучить: изучите
оставаться: остается
впоследствии: впоследствии
тёмный: темный
серьёзный: серьезными
моча: моча
суоменпистикорва: суоменпистикорва
обязательство: обязательств
сложно: сложно
кисломолочко: кисломолочка
крайне: крайне
отвечать: отвечающие
стоить: стоит
срочно: срочно
прекратить: прекратило
существо: существа
отличный: отличным
наклонить: наклоненные
пролетать: пролетающего
избыток: избыток
собака-подросток: собаки-подростка
показатель: показатели
линять: линяющая
вполне: вполне
чистить: чистящей
походка: походку
обмывать: обмывать
избранный: избранным
недолго: недолго
управляться: управляющихся
победитель: победителями
предупредительный: предупредительный
отходить: отходя
хитрость: хитрости
отвести: отведенном
аккуратно: аккуратно
пыль: пыль
прочь: прочь
каша: каши
холодоустойчивый: холодоустойчивой
получать: получали
превратить: превратить
лента: ленту
преследовательский: преследовательских
пожизненно: пожизненно
здоровье: здоровье
заниматься: занимающиеся
воспитать: воспитать
детство: детстве
порционный: порционно
храбрость: храбрость
мороз: морозы
основательно: основательно
скрытый: скрыта
интенсивно: интенсивно
регулярный: регулярной
теоретически: теоретически
специалист: специалиста специалисты
соглашение: соглашение
слияние: слияние
стихийно: стихийно
носить: носило
безопасность: безопасности
любить: любить
отвар: отварами
длиться: длиться
создать: создало
навык: навык
основательный: основательного
разновидность: разновидность
ркф: ркф
шеркуновый: шеркунова
вакансия: вакансии
стол: стол
провоцировать: провоцирует
физический: физической
тормоз: тормозах
борьба: борьбы
незнакомец: незнакомцев
лобный: лобная
финляндия: финляндия
месяц-другой: месяц-другой
начинаться: начинается
гноиться: гноящимися
план: плане
развлекать: развлекать
здраствовать: здраствуйте
хрящ: хрящи
фарш: фарша
почтительный: почтительном
фурминатор: фурминатором
отклонить: отклоненные
тренировка: тренировок
сбалансировать: сбалансировать
овальный: овальным
маленький: меньше
грыжа: грыжи
пшено: пшено
окрасить: окрашены окрашена
единственный: единственное
удобно: удобно
чересчур: чересчур
внезапно: внезапно
притравливать: притравливать
подсадный: подсадного
май: мая
большинство: большинство
кабан: кабана
практически: практически
рейтинг: рейтинг
рассудок: рассудка
дефект: дефекты дефектами
запад: запад
ряд: ряд
подписываться: подписывайтесь
недостаточно: недостаточно
номер: номерами
уходить: уходят
возлагать: возлагайте
вновь: вновь
самостоятельно: самостоятельно
ложа: ложе
учёба: учебе
запретить: запрещено
обычный: обычные
очень: очень
особь: особей
явление: явлением
поделать: поделаешь
лужа: лужам
обычно: обычно
задаться: задались задайтесь
произойти: произошло
будка: будку
узнать: узнайте
наиболее: наиболее
хороший: хорошее
постепенно: постепенно
кличка: клички
вескормить: вескормлю
родный: родной
частность: частности
участок: участок
ладный: ладно
жалость: жалость
касаться: касается
царский: царской
являть: являют
проект: проекте
житель: жители
отдыхать: отдыхать
кг: кг
плавание: плавания
потеря: потеря
температура: температура
чувствовать: чувствует
сидеть: сидеть
носка: носки
всесоюзный: всесоюзную
риск: риск
надежда: надежд
запас: запаса
ответ: ответ
задушить: задушил
зверёк: зверьков
действительно: действительно
туловище: туловище
низко: низко
микроорганизм: микроорганизмов
вкрапление: вкраплений
подопечный: подопечного
экономить: экономьте
кормление: кормления кормление
причём: причем
развить: развитая
основание: основанием
папа: папы
подтянутый: подтянут
родитель: родителей
рыболов: рыболовов
подстричь: подстричь
бугор: бугор
натуралка: натуралкой
фишка: фишки
той-фокстерьер: той-фокстерьер
обязательный: обязательна
случай: случае
пользование: пользование
чёрный: черными
городской: городским
особый: особый
закись: закиси
торчком: торчком
комплект: комплекте
типичный: типичные
осмотр: осмотр
паразит: паразит
какой: каких
