травма: травм
туалет: туалет туалета туалетом
барбет: барбетов барбет
поощрение: поощрением
заметить: заметили замечены
процесс: процессе процесса
овощ: овощи
тело: тела тело
плоский: плоской плоскими
средний: средняя среднее средние средний
фу: фу
неповторимый: неповторимым
основа: основе
далёкий: далекими
из-под: из-под
познакомить: познакомить
активный: активные
участвовать: участвовать
чёрный: черный черные черного черной черными
сколько: сколько
чёткий: четкий
морской: морскую
благодарный: благодарна
название: название названия
прошлое: прошлое прошлого
собака: собаку собаками собакой собак собака собаке собаки
ввести: ввели
обсуждение: обсуждения
чувствительность: чувствительность
подход: подхода
цена: цена цены
рыба: рыбу
мальчик: мальчик
генетический: генетические
материал: материалов
удовольствие: удовольствием
перевод: переводе
комнатно-декоративный: комнатно-декоративной
ветреный: ветреным
некого: некому
познакомиться: познакомьтесь
владелец: владельцам владельцев владельцу владельцы
миниатюрный: миниатюрные миниатюрный
долгий: дольше
дисквалифицировать: дисквалифицирующие
положительный: положительных положительные
холка: холку холке
россия: россия
морда: морде
обратный: обратная
услуга: услугам
утопать: утопающие
длительный: длительные длительного
тон: тоном
радужка: радужки
предварительно: предварительно
поведение: поведении
учёт: учетом
представитель: представителей представителях
пушистик: пушистики пушистика
пышный: пышная пышной
игрушка: игрушкой
травка: травке
шея: шея
сократить: сокращенное
способный: способные способны
шерсть: шерсть шерсти шерстью
компаньон: компаньоны компаньонами
ласково: ласково
поверхность: поверхности
собака-инфант: собаки-инфанты
подпиливать: подпиливают
разрастись: разросся
розовый: розовый
применять: применять
челюсть: челюсти
метод: метод
должный: должны должен должно
небольшой: небольшого небольшие небольшим
яркий: ярких
месяц: месяц месяца месяцам
тонкий: тонкий тонкие тонкая
гипоаллергенный: гипоаллергенных
гениталии: гениталии
участок: участки
некоторый: некоторых некоторые некоторой некоторыми
назвать: назвать
спустя: спустя
выраженный: выражен выраженной
болонка: болонки болонками болонку болонок болонка
уличный: уличным
главный: главный главная
палка: палки
признак: признаками признаков
встретить: встретить
история: история
неизменный: неизменными
аллергик: аллергиков аллергик аллергика
щенок: щенка щенков щенки щенок щенками
взрослый: взрослое взрослый взрослой взрослые взрослых взрослым
проверять: проверять
успешно: успешно
король-рыцарь: король-рыцарь
утолщение: утолщением
форма: форма форме форму формой
голова: голове голову голова
запас: запасом
бродячий: бродячие
шерстяной: шерстяного
характеристика: характеристика
выставка: выставках выставке
руб: руб
такой: таком таких такое такие такую таким такими
нотация: нотацию
коммуникабельный: коммуникабельны
нос: носу носа
пуховка: пуховкой
эмоция: эмоции
аксиальный: аксиальная
неспособный: неспособное
наткнуться: наткнулись
навык: навыков
незащищённый: незащищенный
пятно: пятна
надоедать: надоедают
образцовый: образцовая
прийти: пришел
кормление: кормлении кормлений кормления кормление
вглубь: вглубь
окрик: окрики
комбинированный: комбинированный
коготь: когти
порода: породе породам породы пород породу порода
орган: органами
деформация: деформация
популяризация: популяризации
быстро: быстро
ольга: ольга
входить: входят
игровой: игровой
белоснежный: белоснежной белоснежные
чисто: чисто
французский: французская французские французских французской французского французскую
гнойник: гнойник
раз: раза
видео: видео
помимо: помимо
завершённость: завершенности
дать: дала данной даст
начать: начать
равный: равен
меню: меню
очередь: очередь
полностью: полностью
желтоватый: желтоватым желтоватый
обаятельный: обаятельный
улица: улицу улицы
гость: гости
макароны: макароны
ловля: ловлей
странный: странная
капать: капали
последний: последняя
неугомонный: неугомонные
частота: частота
сбиваться: сбивающаяся
франциска: франциска
франциск: франциск
ровный: ровными ровные ровной
содержание: содержание содержания
стать: станут стали стать
населять: населяли
выстраивать: выстраивать
присутствовать: присутствовать
опытный: опытного
шалун: шалун
немного: немного
приучать: приучать приучают
натуральный: натуральном натуральными
утверждать: утверждают
капризный: капризное
ветеринар: ветеринару
подвес: подвес
опустить: опущенная
связь: связь
ветпаспорт: ветпаспорт
приближение: приближения
подобный: подобным подобных
даниленко: даниленко
выступать: выступающие
потешный: потешные
покрыть: покрыты покрыто покрыт
бедренный: бедренной
грозный: грозные
крыса: крыс
вода: воде
внешность: внешность внешности
газета: газету
мягкий: мягкой мягкая мягкого
преступление: преступление
родство: родстве
грумера: грумера
состояние: состоянии
приживаться: приживающиеся
непропорциональный: непропорциональную
собачий: собачьего
обладать: обладают
слёзный: слезных
сумрачный: сумрачного
год: годах года лет год году
дважды: дважды
заинтересованность: заинтересованности
давать: давать
грудина: грудиной
спираль: спирали
беспорядок: беспорядок
шарм: шармом
эффективный: эффективная
плотно: плотно
промышлять: промышляли
полениться: полениться
качество: качестве качества
смотреть: см смотрите смотрят
свинина: свинина
фотография: фотографии
широкий: широкие широким широкой
ассоциация: ассоциациями ассоциация
агрессивный: агрессивная агрессивный агрессивных
занятой: занятых
обмывать: обмывают
уход: уходе уход
период: периода периоды
пет-терапия: пет-терапии
губа: губа губ губы
высокий: высокая высокий
питомник: питомники питомнике
проникать: проникает
глаз: глаза глаз
водяной: водяных
прийтись: придется
слезливость: слезливость
недисциплинированный: недисциплинированные
часть: части частью часть
вкусняшка: вкусняшками
парижский: парижские
упругий: упругими
прогулка: прогулка прогулку прогулок
простейшее: простейшие
реакция: реакция
поскольку: поскольку
дом: домах дома доме
обучение: обучения
проявлять: проявляют
пользоваться: пользуются
существо: существо существа
краткий: краткая
весьма: весьма
обзавестись: обзавестись
морковный: морковного
любой: любого
отношение: отношение отношении отношения
отпочковаться: отпочковались
отличительный: отличительные
место: место месте
поясница: поясницей
арена: арене
ступень: ступень
ветвь: ветви
вести: вело ведите
присмотреть: присмотреть
эксперт: экспертов
купать: купать
ранний: раннего раньше
вконтакте: вконтакте
человек: людьми людей
переход: переход
удерживать: удерживает
цирковой: цирковые
ярко: ярко
хозяин: хозяин хозяином хозяевам хозяева
экстракт: экстрактов
быть: буду будут
шубка: шубки шубках шубке шубка
пол: пол полу
кожа: коже кожа кожей
животное: животных животным животного животное
один: одного одно одном одну
усваивать: усваивают
сша: сша
характер: характером характера характер
волос: волос
длина: длины длиной длина
означать: означать означают
питомец: питомец питомца питомцем
сопротивляться: сопротивляются
выбрать: выбрать
основать: основана
нижний: нижняя
подтон: подтон
порядок: порядок
х: х
упорный: упорных
видный: видны видна
баранка: баранку
ренессанс: ренессанса
больший: большая большие большее
набирать: набирает
программа: программу
пудра: пудры
мероприятие: мероприятиях
квартира: квартире квартирах квартиры
размер: размеры размера
соблюдать: соблюдайте
информация: информация
подходить: подходит подходят
элементарный: элементарные
создание: создание
двухразовый: двухразовое
хотеть: хочет хочу
желать: желают желающим
палец: пальцами
поселиться: поселиться
курс: курсов
выравниваться: выравнивается
крошечный: крошечное
ниже: ниже
кошка: кошкой кошки
окрас: окрас
старость: старости
сложный: сложных сложные
шалость: шалостях
сухой: сухой сухим
вытянутый: вытянутом
габарит: габариты
сидеть: сидят
приклеиться: приклеилось
среди: среди
запастись: запастись
подстригать: подстригают
формирование: формированием
кудрявый: кудрявой кудрявая кудрявый
цирк: цирка
подушечка: подушечками подушечка
крупа: крупы
категорически: категорически
эпический: эпический
обильно: обильно
расстелить: расстеленную
проток: протоков
ласковый: ласковые
считаться: считается
операция: операция
недовольный: недоволен
любимый: любимой
сталкиваться: сталкивались
потомок: потомками
поставить: поставленная
силуэт: силуэту
аллергия: аллергия
дождь: дождь
одноразовый: одноразовую
палочка: палочкой
частый: частые частых почаще
вид: видом виде вид
неизлечимый: неизлечимых
закрутить: закрученный
запутаться: запутавшиеся
час: часа
проследить: проследите
сложность: сложность
перекочевать: перекочевали
раздражение: раздражение
низкий: низкая
вымыть: вымытая
осваивать: осваивают
пластина: пластины
пропорциональный: пропорциональная
начинаться: начинаются
добавить: добавьте
светлый: светлой светлый
мусор: мусор
черта: чертах черты
дог-шоу: дог-шоу
происхождение: происхождения
заболевание: заболевания
лапка: лапки
лобный: лобной
необходимо: необходимо
никакой: никакого
валюта: валюту
одуванчик: одуванчик
пища: пищи
свой: своем своего своих свои
задний: задние
заведомо: заведомо
корм: кормом
редкий: реже
вакцинация: вакцинации
тщательно: тщательно
недорого: недорого
сбивание: сбиванию
дрессировка: дрессировка дрессировке дрессировок дрессировкой
стандартный: стандартный
время: время времена времени временем
испачкаться: испачкался
трусливый: трусливых трусливый трусливое
агрессивность: агрессивность
остров: острова
устроить: устроить
полость: полость
наказание: наказания
товарищ: товарищей товарищами
общий: общие
деятельность: деятельности
урок: уроки
противный: противном
другой: другие другими
пачкать: пачкать
просмотр: просмотров просмотра
параллельно: параллельно
куриный: куриных
знакомство: знакомстве
мера: мере мера
бишон: бишоны бишонам бишонов бишон бишона
категория: категории
несколько: несколько
деликатес: деликатесами
называть: называемые
рост: рост роста
ответ: ответа ответ
густота: густоты
согласно: согласно
мышечный: мышечную
строгий: строгим
правильный: правильном
хотеться: хочется
напоминать: напоминают
доживать: доживать
к: ко
реклама: реклама
нестабильность: нестабильность
объявление: объявление объявления
высыпание: высыпания
аллергический: аллергические
ограничение: ограничение
франция: франция
полагаться: полагается
рекомендоваться: рекомендуется
пигментация: пигментация
ножницевидный: ножницевидный
озорник: озорники
раздражить: раздражена
воспитание: воспитание
явно: явно
малыш: малыш
неисчислимый: неисчислимое
наука: науке
воздушный: воздушная воздушных
хороший: хороший хорошее
сайт: сайту
болезнь: болезням болезни болезнь
доброжелательный: доброжелательного
особенность: особенностей
волнистый: волнистой
шаловливый: шаловливые
получаться: получаются
отлучаться: отлучающихся
картофель: картофель
селить: селили
уменьшаться: уменьшается
мода: моду
недуг: недугов
лишь: лишь
вариант: вариант
долго: долго
недавно: недавно
роговица: роговицы
тесный: тесном
форум: форум форуме
престарелый: престарелых
конец: конце конец
протяжение: протяжении
стесняться: стесняйтесь
белка: белки
соприкасаться: соприкасаться
сушка: сушки
грешить: грешащие
минимизировать: минимизировать
дружелюбный: дружелюбные
принуждать: принуждать
капля: капли
ты: тобой
энерджайзер: энерджайзеры
пигментировать: пигментирована пигментированы
комочек: комочки
распространение: распространения
эталонный: эталонного
антидепрессант: антидепрессант
фриз: фризе
эпоха: эпоху
значительно: значительно
шоу-класс: шоу-класса
описание: описание
игра: игр игры
начало: начало
влага: влага
овсяный: овсяную
декоративный: декоративные декоративных
воздушность: воздушности
второй: вторую
середина: середине
белый: белых белого
сырой: сырые сырое
состоять: состоящие
найти: найти
глубоко: глубоко
дело: делу
который: которой которым которые который
поэтому: поэтому
напиток: напитка
копирование: копирование
трудно: трудно
добрый: добрый
кондиционер: кондиционера
активность: активность
эксклюзивный: эксклюзивного
пуходерк: пуходерку
умирать: умирает
основание: основания основанием
продукт: продукта продуктами
дружелюбность: дружелюбность
совершение: совершения
прибегать: прибегать
маша: маша
названиематакса: названиематакса
плавно: плавно
отзыв: отзывах отзывы
нога: ноги
ротовой: ротовую
заключаться: заключается
пружинить: пружинящий
нужда: нужд
следовать: следует
однообразный: однообразные
испытывать: испытывающее
отсутствие: отсутствии отсутствие
бежевый: бежевый
шум: шум
привлечь: привлечь
надёжный: надежные
висячий: висячие
особь: особи особям особей
ассоциативный: ассоциативный
процедура: процедуры
особо: особо
озорной: озорных
исчезать: исчезает
прямой: прямая прямые прямой
наделять: наделяет
сбить: сбитый
допустимый: допустимо
очищать: очищать
элита: элиты
жирный: жирными
собака-одуванчик: собаки-одуванчика
назад: назад
породистый: породистого
резец: резцами
цвет: цвет цвета
находиться: находящимся
интерес: интерес
мочь: могут
локоть: локти
солёный: солеными
измельчить: измельченном
клещ: клещей
оставаться: оставались
плавный: плавным
возраст: возрастом возраст возраста
округлый: округлый округлая
принятие: принятия
особый: особого особой
ухо: ушей уши
сделка: сделки
целое: целом
основной: основные
дополнительный: дополнительным
родитель: родителями
интеллект: интеллект
охранный: охранные
конечность: конечностей конечности
средне: средне
неправильный: неправильный
вес: вес
брид-разновидность: брид-разновидности
потчевать: потчевать
голос: голос
линять: линяют
позволять: позволяют
рада: рады
кипячёный: кипяченой
способствовать: способствовал
вычитать: вычитала
именно: именно
чрезвычайно: чрезвычайно
стиль: стиле
склонный: склонная
популярный: популярна
продолжительность: продолжительность
международный: международная
требовать: требующие
являться: являвшиеся являются
вряд: вряд
заводной: заводной
попасть: попавшее
приём: прием приемом
бобовый: бобовые
расположить: расположены расположен
оттенок: оттенок оттенком
результат: результате
компромисс: компромисс
отучать: отучать
современный: современной
вокруг: вокруг
сойти: сошел
слегка: слегка
тот: те та
фото: фото
затея: затея
крик: криком
питание: питание
допускаться: допускается
грубый: грубое
показать: показан
яндекс: яндекс
держать: держал
обращение: обращение
количество: количество количества
пытаться: пытаться
череп: черепа
родитель-чемпион: родителей-чемпионов
чистота: чистоты
ставить: ставить
обучать: обучающую
спина: спиной спины
покусывание: покусывание
песчинка: песчинки
окрасить: окрашенная
двор: дворе
обязательный: обязательных
журнал: журнал
линия: линии
тщательный: тщательном
скула: скулами
высота: высота
что-то: чем-то
делать: делать
минута: минуты минут
такса: такса
нуждаться: нуждаются нуждается
уголок: уголков
участие: участии
рассчитать: рассчитанная
ванна: ванны
первый: первое
ширина: ширины
нервный: нервных
скучать: скучать
дистрофия: дистрофия
гипотрихоз: гипотрихоз
ребёнок: дети ребенком детьми
подарок: подарка
сэкономить: сэкономить
преподнести: преподнести
кормить: кормят
сужаться: сужающимся
либо: либо
заключение: заключении
начинать: начинать
поиграть: поиграть
ограничиться: ограничиться
решать: решает
этот: этому этих
активно: активно
смягчение: смягчения
кипяток: кипятком
детский: детских
умеренный: умеренной
предпочитать: предпочитают
придание: придания
собачка: собачки собачек
поднимать: поднимает
каждый: каждые каждый
крайний: крайняя
позвоночник: позвоночнику
корпус: корпуса
рекомендовать: рекомендованные
плохо: плохо
перекус: перекус
заметно: заметно
прочитать: прочитать
порог: пороге
взросление: взросления
компактный: компактного
превышать: превышают
родиться: род
вечерний: вечерним
вовлечь: вовлечь
превращаться: превращается
перейти: перейти
закрытый: закрытой
сутки: сутки
статус: статус
из-за: из-за
запрет: запретом
волонтёрский: волонтерской
маленький: маленькие
гулять: гуляет
когтерез: когтерезом
собранный: собранными
прохождение: прохождение
стандарт: стандарты стандартам
будущее: будущим будущего
труппа: труппы
шёрстка: шерсткой шерстка
дефект: дефектов дефектами
по-своему: по-своему
игривый: игривый
откуда: откуда
непоседливый: непоседливые
бельгия: бельгия
тайна: тайной
клетка: клетка клетке клетки
цель: целью цель
роскошь: роскоши
предоставить: предоставит
костяк: костяк
слишком: слишком
одиночество: одиночеству
рацион: рационе
страдать: страдающие
масса: массу
комок: комок
дворцовый: дворцовых
подшёрсток: подшерсток подшерстка
плюшевый: плюшевый
увидеть: увидели
тенерифский: тенерифский
мордочка: мордочка мордочку
забыть: забыть
итальянский: итальянская
день: день
отрицательный: отрицательных
появляться: появляется
кучерявый: кучерявые
избаловать: избалованным избалованное
плюс: плюсы
круглый: круглая круглые
позволить: позволить
относиться: относятся
свобода: свободы
густой: густой
покров: покрова
оценка: оценке
гречневый: гречневую
мокрый: мокрый
расчёсывание: расчесывания
пелёнка: пеленку
излишний: излишне излишней
мочка: мочка
длинный: длинная длинной
правило: правило правила
сильный: сильное
внимание: внимание
повторять: повторяющие
блюдо: блюд
зубной: зубной
поработать: поработать
короткий: короткие короткая
обратиться: обратиться
средневековье: средневековья
стоимость: стоимость
больница: больницах
обдать: обдать
особенно: особенно
щипчики: щипчиками
желательно: желательно
покой: покоев
выводить: выводите
мрак: мраком
облачко: облачка
заводчик: заводчику заводчика
дрессировать: дрессировать
добраться: добрались
достаточно: достаточно
обязательно: обязательно
привычка: привычки
шнур: шнуры
ковёр: ковер
придавать: придает придают
подыскать: подыскать
угощать: угощать
объёмный: объемная
тренировка: тренировки
подчёркивать: подчеркивающий подчеркивающими
неделя: неделю
постричь: постричь
груминг: груминге
англия: англии
понимать: понимать
иметь: иметь имеющего имеют
несмотря: несмотря
ходить: ходить
семья: семьях
сладость: сладости
канатьев: канатьева
купить: купить
плотный: плотный
часто: часто
отварный: отварные
неровность: неровности
приемлютый: приемлют
новый: новое нового
комплекс: комплексов
завести: завести
стричь: стригут
промокать: промокает
кудряшка: кудряшками
переселиться: переселились
случай: случаях случаи случае
попросить: попросить
хозяйка: хозяйкой
социальный: социальный
диагностировать: диагностируемым
крепкий: крепкой
привлекать: привлекают
бездна: бездны
кто-то: кто-то
присматриваться: присматриваюсь
равнобедренный: равнобедренного
революция: революции
мальтийский: мальтийская
бар: бар
проживать: проживаю
рисковать: рискуют
патология: патологии
одноклассник: одноклассники
мальтеза: мальтезе
отметать: отметайте
сформулировать: сформулированы
приобрести: приобрели
команда: команды команда
сходство: сходство
чистить: чистить
грудь: грудь
случайный: случайные случайных
мясо: мясо
наблюдаться: наблюдается
кобель: кобелей
коричневый: коричневые
провальный: провальная
треугольник: треугольника
суть: сути
периодичность: периодичностью
поиск: поиск
направление: направлению
тренировать: тренировать
получить: получить
оптимальный: оптимальный оптимальным
зуб: зубы
бархатный: бархатная
удалить: удалены удалить
неярко: неярко
применение: применением
основный: основная
официальный: официальное
белые: белые
концентрироваться: концентрироваться
невесомый: невесомые
острый: острыми
лежать: лежать
сторож: сторожа
зрение: зрения
сделать: сделано
анна: анна
потребность: потребность
порок: пороки
условие: условиями
действовать: действует
недокус: недокус
остевой: остевой
три: тремя
жизнь: жизни
занимать: занимать
остальной: остальном
проказник: проказники
ваш: ваша
диабет: диабет
море: моря
облегчение: облегчения
предок: предками
плечо: плечи
минус: минусы
запах: запаха
терпение: терпением
непринуждённый: непринужденной
переходить: переходит
проживание: проживания
посещать: посещать
мимимишность: мимимишности
также: также
кисломолочный: кисломолочного
продажа: продажи
пет-терапевтический: пет-терапевтических
идеал: идеале
болоньеза: болоньез
мама: мама
ждать: ждать
идеальный: идеальным
помочь: поможет
момент: моменты
кот: кот
ретривер: ретривер
повышенный: повышенная
обаяние: обаяния
век: веку
курточка: курточке
обращать: обращать
витаминный: витаминных
кинологический: кинологическая
изучить: изучите
параметр: параметром
друг: друга
говорить: говоря
бар-бишон: бар-бишон
косточка: косточки косточках
высоко: высоко
вольность: вольность
лапа: лап
сложно: сложно
крипторхизм: крипторхизм
крайне: крайне
пушистый: пушистая
область: области
стоить: стоит
препарат: препараты
это: это
снежно-белый: снежно-белый
эпилепсия: эпилепсия
сформироваться: сформируется
вопрос: вопрос
приобретение: приобретение
разводить: разводить
неуправляемый: неуправляемым
специфический: специфического
улучшиться: улучшится
тибетский: тибетский
любить: любят люблю
образоваться: образовавшиеся
предпочесть: предпочесть
отправление: отправления
новошотландский: новошотландский
европейский: европейской
умильный: умильные
включение: включение
изменение: изменения
использование: использование
полный: полное
легко: легко
ватный: ватной
живой: живую
средиземный: средиземного
лента: ленту
выгул: выгула
здоровье: здоровье
твёрдо: твердо
изогнутый: изогнутой
вверх: вверх
изменить: изменить
звонкий: звонкий
основательно: основательно
непременный: непременным
специалист: специалиста специалисты
просторный: просторных
отличный: отличные отличными
половина: половине
дорогой: дороже
расчёсывать: расчесывать
пасти: пасти
разновидность: разновидность
настоящий: настоящие
сила: силу
опека: опеке
элемент: элемента
выход: выход
избыточный: избыточная
вакансия: вакансии
передний: передних
прикус: прикус
приходиться: приходится
мочекаменный: мочекаменная
обойтись: обойдется
дерматит: дерматит
встречаться: встречается встречаются
вроде: вроде
рассматривать: рассматривало
подавлять: подавляющее
осуществлять: осуществляя
сказать: скажешь
выделение: выделений
путать: путать
муж: муж
смочить: смоченной
неистощимый: неистощимым
занятие: занятия
мускулистый: мускулистой
столетие: столетия
быстрый: побыстрее
проделка: проделках
базироваться: базироваться
колбаса: колбаса
всевозможный: всевозможными
большинство: большинство
тёплый: теплой
монарх: монархов
практически: практически
катаракт: катаракта
рейтинг: рейтинг
ученик: ученики
канистерапевтический: канистерапевтическую
избавиться: избавиться
прозвище: прозвище
любимец: любимцы
ряд: ряд
умилительный: умилительное
подписываться: подписывайтесь
общительный: общительного
купироваться: купируется
подстричь: подстриженный
самостоятельно: самостоятельно
незнакомый: незнакомое
использовать: использовать
заниматься: занимаясь
побережье: побережье
учёба: учебе
запретить: запрещено
очень: очень
обычно: обычно
шевченко: шевченко
энтропион: энтропион
исправить: исправить
выполнять: выполнять
наиболее: наиболее
мытьё: мытье
прохладный: прохладной
наоборот: наоборот
постепенно: постепенно
специальный: специальной
кличка: клички
мясной: мясных
прививка: прививкам
друг-бишон: друга-бишона
список: список
атакса: атакса
выпечка: выпечка
возможность: возможность
контраст: контраст
касаться: касается
четвероногий: четвероногого
шампунь: шампуня
проект: проекте
сразу: сразу
звучать: звучало
спаниель: спаниель
кг: кг
юный: юных
необходимость: необходимости
молоко: молока
водорослевый: водорослевых
риск: риск
приобщить: приобщить
линька: линька
рыжий: рыжие
страна: страна
когтевой: когтевой
заварить: заваренные
диалог: диалог
адекватный: адекватный
фелинологический: фелинологическими
король: короли
косой: косые
корабль: кораблях
чься: кусь
спутник: спутниками
гампр: гампр
хвост: хвост
сбрить: сбрили
выбор: выборе
обычный: обычного
пользование: пользование
стимул: стимулом
воспитывать: воспитываете
паста: пасты
запутать: запутано
малогабаритный: малогабаритных
полчаса: полчаса
