америка: америке америку
тратиться: тратиться
хаск: хаски
ситуация: ситуациях
отличать: отличают
тело: тела
колебаться: колеблется
амин: амина
приобретать: приобретают приобретать
широко: широко
средний: средняя средней средний
здоровый: здоровых
проникнуть: проник
расти: растет
котлован: котлован
интересный: интересные
продолжаться: продолжалась
чёрный: черный черная
сколько: сколько
уметь: умеют уметь
миссия: миссия
покрыть: покрытым покрыт
название: название названия
часть: частях части
домой: домой
примерно: примерно
собака: собаку собаками собак собака собакам собаке собаки
плащевый: плащевой
грань: грань
открытый: открытом открытым
состоять: состоит
расположить: расположена расположенных расположены
больший: большими большим большая
вызываться: вызывается
нагрузить: нагруженные
ноздря: ноздри
обсуждение: обсуждения
другой: другое другие других другими другим
оставаться: оставаться остаются оставалось
сочленение: сочленений
цена: цена цен цене
рыба: рыбу
далёкий: далекие
подушечка: подушечки
смышлёный: смышленые
материал: материалов
твёрдость: твердость
спокойный: спокойнее
порок: пороком порокам пороки
вещь: вещи
массивный: массивным массивные
неврологический: неврологическим
нарта: нарты
владелец: владельцам владельцев владельцу владельцы владельцем
поведение: поведения поведением поведение
охотиться: охотятся
качество: качествами качестве качеством качество качествам качества
любовь: любовь
сторона: стороны стороной
отомстить: отомстить
дисквалифицировать: дисквалифицирующие дисквалифицирующий
неуправляемый: неуправляемой
близкий: ближайшие ближайшего
россия: россия россии
живот: живот живота
привязаться: привяжется
морда: морде морда
обратный: обратная
рост: ростом рост
начинать: начинают начинать начинает
особый: особые особой
представитель: представителей представителя представителями представители
охранник: охранник
приспособить: приспособленные приспособленной
носиться: носиться
шея: шея шее шеи
исполнять: исполнять
продуктивный: продуктивные
шерсть: шерсть шерсти шерстью
взлёт: взлет
мощность: мощность
выпустить: выпустив
вынудить: вынужден
документ: документы документам документов
шаг: шага шаг
аденокарцинома: аденокарцинома
популяризироваться: популяризировался
выразить: выражены выражена
коровий: коровий
челюсть: челюсти
неопытный: неопытным
самый: самая самым самыми самых самые
должный: должны должен должно
основополагающий: основополагающую
узкий: узкая
содержать: содержать
разрывать: разрывающих
взгляд: взгляд взгляде взгляды
исключение: исключение исключения
холодный: холодный
беринг: берингов
снимать: снимает
человек: людям человеку человеком люди
надоедать: надоедает
относиться: относится относятся
поселить: поселить поселите
недюжинный: недюжинную
большой: большой большое велика большом
необходимый: необходимы
клубный: клубным
покорение: покорения
зимний: зимняя
предназначить: предназначены
сибирь: сибири
столь: столь
некоторый: некоторых некоторые
равно: равно
отличаться: отличается отличающихся отличаются
обои: обои
обязательный: обязателен
важно: важно
главный: главный главными главная
сужение: сужением
ориентирование: ориентированию
шенка: шенка
способность: способность способности
войти: вошла
центральный: центральной
история: история историю
упряжка: упряжку упряжке упряжках
кинологический: кинологических кинологическая
щенок: щенка щенков щенки щенок щенку щенках
проход: прохода
видно: видно
нормально: нормально
незадача: незадача
белок: белка
сопоставление: сопоставления
миловидный: миловидной
уравновесить: уравновешенный
выполнять: выполняя
рутина: рутина
малемить: малемьют
упряжь: упряжью
слава: славу
питомец: питомцев питомца питомцем
положительный: положительной положительном
скулить: скуля
разница: разница
семья: семьи
ходульный: ходульные
нередко: нередко
проделать: проделать
лаз: лаз
характеристика: характеристика
стоп: стоп стопа
этот: этими эта этих
такой: таком таких такие такая такого таким
руб: руб
дом: дому дома доме
пищевой: пищевых
выраженность: выраженности
коричневый: коричневая коричневый
год: годы года лет год году
ожирение: ожирение
измениться: изменились
оправдать: оправдали
собирать: собирали
залог: залог
повод: поводу
неправильный: неправильном
коготь: когти когтями
внушительный: внушительный
современный: современном современных
порода: породе породы пород породу порода
значит: значит
отнюдь: отнюдь
спина: спине спиной спины
палец: пальцы пальцев
считать: считает
помогать: помогая
как-то: как-то
огромный: огромных огромные огромный огромным огромная
круглогодично: круглогодично
видео: видео
помимо: помимо
ступать: ступают ступает
физический: физическую физическими физические физическая
выносливый: выносливым выносливее выносливые выносливых
гетерохромия: гетерохромия
дать: дала данной дай
исчезновение: исчезновения
течка: течка
характер: характере характером характера характер
стремиться: стремятся стремится стремиться
периферический: периферической
своенравный: своенравный
внимание: внимания внимание
очередь: очередь
полностью: полностью
лидерство: лидерству
условие: условии условиях условиями
возможный: возможные возможным возможна
нестабильный: нестабильные
быть: будьте будут
улица: улицу улицах улице
месячный: месячного месячных
пёс: псы псов псам пес пса псом
насторожить: насторожило
каша: кашу
древний: древних древнейших древнейшая древняя
нужный: нужна
притаиться: притаятся
опустить: опущена опущенными
охотник: охотника
называть: называют называемый называемым
образ: образ
интернет: интернете
содержание: содержание содержанием содержания
девочка: девочка девочки
мелкий: мелких мелкими
работа: работе работой работы работа
немного: немного
приучать: приучать
хвост: хвосте хвост
важный: важен важный
нагружать: нагружать
ширина: ширину
пропорционально: пропорционально
вероятность: вероятностью вероятность
вертикальный: вертикальном
мощный: мощный мощное мощная мощные
игра: играм
обернуться: обернется
рекомендовать: рекомендуют
численность: численность
титуловать: титулованного
победитель: победители победителя
окрас: окраса окрас окрасу окрасы окрасов
городской: городских городской
рослый: рослый
полноправный: полноправными
кстати: кстати
связь: связь
золотой: золотая
приобретение: приобретения
поджать: поджав
бояться: боятся
доверять: доверять
попасть: попавшие попав
набираться: набираются
тип: типов типу типы
мировой: мировая мировых
передний: передним передними передние передних
атопический: атопическим
внешность: внешность внешностью
российский: российская
естественный: естественная
старание: старания
срок: сроки
лоб: лба лбу
энергичный: энергичные энергичному
чувствовать: чувствующим чувствует
намного: намного
бедро: бедра бедрах
частный: частном частным
стать: стали стало стал станет
искусить: искушенных
от: ото
оба: обе
выставка: выставок выставкам
система: систему системы
энергия: энергией энергия
нрав: нрава
обладать: обладают
снегоступ: снегоступы
орудие: орудия
север: севера
твёрдый: твердым
давать: давать давая дают давайте
пссс: пссс
изогнутый: изогнуты
исключить: исключено
салюк: салюки
сосуществование: сосуществования
квалифицироваться: квалифицируются
сильный: сильных сильная сильной сильный сильные
европеец: европейцев
анализ: анализа
подтверждать: подтверждают
труд: труду труда
заниматься: заниматься
таскать: таскает таскать
дорогой: дорогими дороже
мебель: мебель мебелью
плотно: плотно
узко: узко
птица: птиц
преследовать: преследовать
чемпионат: чемпионате
крупный: крупный крупнее крупного крупному крупными крупные
сомкнутый: сомкнуты
смотреть: см смотрите смотрят смотреть
плюс: плюс плюсы
превышать: превышает
лёгкий: легкий
фотография: фотографии
четвероногий: четвероногие
широкий: широкие широкий шире широкая
работать: работать
взвесить: взвешенным
уход: уходе уход
знать: знать знаем
днк: днк
безделье: безделье
климат: климат климата климатом климату
страдать: страдают страдает
высокий: высокая высоким
особь: особь особи особей
питомник: питомники
верхний: верхней верхними верхняя
глаз: глаза глаз глазами глазам
характерный: характерные
эскимос: эскимосами эскимосы
хинван-ирвин: хинван-ирвин
серьёзный: серьезным серьезный
штанишки: штанишек
целый: целые целую
мягкий: мягкий
корм: корм корма
археологический: археологические
начаться: началась началось
вниз: вниз
неприхотливый: неприхотливы
сносить: снося
век: века веке веков
мускул: мускулы
конечность: конечностях конечностями конечностям конечностей конечности
психический: психических
поскольку: поскольку
природный: природного природной
проявлять: проявляют проявлять
ложиться: ложатся
посоветовать: посоветуйте
двигаться: движущиеся двигается
покупать: покупать покупайте
опрятность: опрятности
краткий: краткая
весьма: весьма
уроженец: уроженцы уроженца
привозить: привозили
долгий: долгое долгие
свой: своими своим своего своей своих свои
вычёсывание: вычесывании
отношение: отношение отношения
ездовой: ездовая ездовых ездовой ездовыми
вкупе: вкупе
место: место
начинаться: начиналась
требовать: требуя
малыш: малышей малыш малыши
поразить: поразить
эксперт: экспертов
редеть: редеет
направить: направлены направить
ранний: раннего раньше
упрямство: упрямством
требуха: требухи
слон: слон
ждать: ждут
любимец: любимцем любимцами любимца любимец
вконтакте: вконтакте
просмотр: просмотр просмотров
тысяча: тысячи тысяч
рядом: рядом
аляскинский: аляскинских аляскинского аляскинский аляскинские
сочетание: сочетание
широта: широтах
переход: переход
видный: виден
ожидать: ожидают
роль: роль
хозяин: хозяин хозяевам хозяина хозяева
мес: мес
регалия: регалии
добродушно: добродушно
трудоспособность: трудоспособностью
старатель: старатели
размер: размерах размеры размер размера
один: одного одна одной одну
дрессировочный: дрессировочной
сша: сша
привязываться: привязываются
маламут: маламуты маламуту маламута маламут маламутов маламутами
волос: волос волоса
какой: каком каким
длина: длины длиной длина
выбрать: выбрать
кусочек: кусочки
двор: двору двор дворе
хозяин-кочевник: хозяевами-кочевниками
скула: скулы
пс: пс
защитный: защитный защитная
основать: основана
сустав: сустава суставы
хотя: хотя
х: х
разочаровываться: разочаровываются
друг: друзей друг другом друга
общий: общее общего
детский: детском
отличный: отличное отличный отличным
который: которую которой которого которых которым которые который
понести: понесли
генетический: генетическое генетической
звук: звукам
северный: северных северную северным северного северные северной
осмотр: осмотре
подобный: подобный подобных
глубокий: глубокие глубокая
посильный: посильную
квартира: квартире квартиру
критический: критической критического
заметный: заметен
вид: видов виде вид
известный: известны
информация: информация информацию
закончиться: закончилась
телосложение: телосложение телосложения
эквивалент: эквиваленте
припомнить: припомнят
хотеть: хочет
шумный: шумным шумных
сначала: сначала
ремонт: ремонт
правление: правления
представить: представленной
выбор: выбор выборе
ниже: ниже
активный: активного активными
гонка: гонка гонки гонкам
родитель: родители родителей
тёплый: теплый
ухудшиться: ухудшилось
красавец: красавца
конец: концу конец концах
крепкий: крепкие крепкий крепкого
перемещение: перемещении
сухой: сухой
польза: пользу
габарит: габариты габаритами
среди: среди
различный: различным различные
небольшой: небольшая небольшом небольшой небольшими
золотоискатель: золотоискатели
экстерьерный: экстерьерные
лапа: лапах лапы
уговор: уговоров
восхитить: восхищенные
линия: линию линия линий линии линией
это: этим это
деться: делась
колено: колени
настроение: настроении
считаться: считается считаться
отнести: отнесешь
земля: землей
своеволие: своеволием
неприятность: неприятностями
развитой: развитыми развиты развитую
тонкий: тонкие
находиться: находится находятся
обучение: обучению
поклонник: поклонников
утверждение: утверждении
признать: признать
просто: просто
задний: заднего задние задних задней
полинейропатия: полинейропатии
недолгий: недолгих
вырасти: вырастет
подушка: подушки
иванов: иванов
желать: желающих
получить: получены получите получила получить
верх: верха
найти: найдет найти
ползти: ползя
последующий: последующих
соболиный: соболиный
смыкаться: смыкаются
хлынуть: хлынули
разбитый: разбитые
низкий: низкая
дерево: деревья
демодекоз: демодекозом
территория: территории
плохой: плохое плохой похуже плохие
усилие: усилия усилий
добавить: добавьте
груз: грузы груз грузов
прогулка: прогулки прогулок
деликатный: деликатны
команда: команде командам команда
проживание: проживание
умеренный: умеренная умеренной
происхождение: происхождения
заболевание: заболевания заболеваниями
точка: точка
резкий: резкий
измерить: измерить
готовый: готовы готовыми готовым готовый готовые
никакой: никакого
деньга: деньги
пища: пищи пищей
прочный: прочные
частично: частично
тягловый: тягловая
черта: черты черта
мороз: морозам
тщательно: тщательно
дрессировка: дрессировка дрессировке дрессировки
нервный: нервную нервной
добавлять: добавляя
время: время времена времен
сука: суки сук
пробежка: пробежках пробежкам
агрессивность: агрессивность
спиридов: спиридова
нм: нм
победа: победа
перевозка: перевозки перевозкой
жёсткий: жесткий
скорый: скор
животное: животным животного животными
местность: местности
заметить: заметил
деятельность: деятельности
противный: противном
пясть: пясти пястей
взрослый: взрослого взрослых
параллельно: параллельно
угловатость: угловатостью
русло: русло
терпение: терпения
избежание: избежание
мера: мере
толстый: толстые толстый
например: например
несколько: несколько нескольких
сетчатка: сетчатки
грозить: грозит
обнаружиться: обнаружились
ответ: ответа ответ
голова: головы голова
увалень: увальни
потомство: потомство
экстремальный: экстремальных
вне: вне
сила: силы силу
скучно: скучно
функция: функции
оценка: оценку оценке
жить: жить живут
субтильность: субтильность
резко: резко
реклама: реклама
соответственно: соответственно
соответствовать: соответствовать
непростой: непростая
волосяной: волосяной
собрат: собрата собратьев собратья
прогрессивный: прогрессивная
длительный: длительным
наклон: наклон
карантин: карантин
второй: второй вторая
отодрать: отодрать
оказаться: оказавшись оказалась окажется оказалось окажетесь
изогнутость: изогнутость
рекомендоваться: рекомендуется
пигментация: пигментация
мочка: мочки мочке мочка
вес: весе вес
проявляться: проявляются
воспитание: воспитание воспитании воспитанием
лгкий: лгкий
сохранять: сохраняя
дружелюбный: дружелюбны
крайний: крайнего
влиять: влияют
правильно: правильно
неуютный: неуютно
воспитанный: воспитанные
психология: психологию
метис: метисы
шпицеобразный: шпицеобразных
хороший: хороший хорошая хорошее
сайт: сайту
решение: решения
бывать: бывает
длинный: длиннее
особенность: особенностей особенностях особенности
кочевнический: кочевнический
клондайка: клондайке
позволять: позволяет
ресурс: ресурсам ресурсов
гипотиреоз: гипотиреоза
социализация: социализация социализации
уменьшаться: уменьшается
пойти: пойдет пойти
лишь: лишь
морозов: морозов
что-то: что-то
долго: долго
домашний: домашними
тримминговать: триммингуют
треугольный: треугольной
форум: форум форуме
вырастать: вырастают
спорт: спорта
протяжение: протяжении
приемлемый: приемлема
окончиться: окончится
закруглить: закруглены
обогатиться: обогатиться
наш: нашей нашего
порой: порой
положение: положение положении
планета: планете
член: членам членами
кость: кость
внешне: внешне
разорвать: разорванные
надевать: надевают
мясо: мяса мясо
двойной: двойной
посудный: посудной
племя: племена племени
близко: близко
серый: серый
значительно: значительно
лежебок: лежебокам
описание: описание
натуральный: натуральной
рано: рано
начало: начало
толчок: толчка толчок
слабый: слабее слабая слабые
соревнование: соревнований
оценивать: оцениваемые
наказывать: наказывайте
машина: машинам
подвижность: подвижности
приступать: приступать
лопатка: лопатки
забор: забором
землекопский: землекопской
поиск: поиске поиск
одомашнить: одомашненные
привлекать: привлекающую привлекают
стоячий: стоячие
собачий: собачьих
заводчик-энтузиаст: заводчиков-энтузиастов
однако: однако
искренне: искренне
играть: играть
преданность: преданность
становиться: становится становятся
поводок: поводком
смотреться: смотрится
поэтому: поэтому
огрызаться: огрызались
явный: явные
глубина: глубина глубину
бразда: бразды
копирование: копирование
короткий: короткий короткие короткой короткими
трудно: трудно
добрый: добрый добры
активность: активность
селекционер: селекционерам
зверушка: зверушек
дружелюбность: дружелюбность
равный: равна
мама: мамой
пострадать: пострадать
экономичность: экономичности
расклад: раскладе
подвижный: подвижные
отзыв: отзывах отзывы
нога: ноги
остепениться: остепенится
кошка: кошки кошек кошками
снег: снегу
следовать: следует
укрепить: укрепите
коммуникабельность: коммуникабельность
ветклиника: ветклиника
выделение: выделения
проигрывать: проигрывала
отсутствие: отсутствии
шум: шум
союз: союз
самостоятельный: самостоятельные
многочасовой: многочасовых
запоминать: запоминают
наблюдать: наблюдать
вывод: выводу
уровень: уровня
ввиду: ввиду
миля: миль
отличие: отличие отличия
густой: густая густой
подсказать: подскажите
допустимый: допустимо допустимы
утверждать: утверждать
востребовать: востребованными востребован
федерация: федерация
назад: назад
перспектива: перспективами
оттенок: оттенка
пожалуйста: пожалуйста
лето: летом
эскимосский: эскимосские эскимосского
почему: почему
поначалу: поначалу
цвет: цвет цветов
клиника: клинику
просторный: просторном
мочь: могут
умение: умению
влияние: влияния
завидный: завидным
гемофилия: гемофилия
округлый: округлый
лидерский: лидерскими
благополучие: благополучие
ухо: ушей ушами уши
целое: целом
объявление: объявления
медленно: медленно
голубой: голубые голубых
частное: частного
основной: основные
дурной: дурные
мускулистый: мускулистым мускулистые
мужчина: мужчинам
интеллект: интеллект
охранный: охранные
многие: многие
самоуверенный: самоуверенным
выйти: вышло
средне: средне
попадаться: попадается
ум: ум ума
постоянный: постоянного постоянная
поднять: поднят
спросить: спросите
электричество: электричество
никуда: никуда
нос: носа нос
разведение: разведение
результат: результаты результате
постав: постава постав
причина: причине
именно: именно
будущий: будущие будущему
бесспорный: бесспорным
ненужный: ненужные
работоспособный: работоспособным
отклонение: отклонения отклонений отклонение
последний: последних последнее последние
ободок: ободки
воображать: воображая
продолжительность: продолжительность
округло: округло
поспать: поспать
своеобразно: своеобразно
случаться: случаются
независимый: независимого
захотеть: захочет
обучать: обучая
дружелюбие: дружелюбием
грубость: грубостей
размёт: размет
отлично: отлично
уплощение: уплощением
гемералогия: гемералогия
потенциал: потенциалом
неизменно: неизменно
короче: короче
любитель: любителям любителей
говорить: говорят
спонтанно: спонтанно
мышца: мышцами
определяться: определяются
простой: простейший простыми простым
зависимость: зависимости
прийтись: пришлось
правило: правилами правило правилах правила
закладываться: закладываются
способ: способом
бороться: бороться
никак: никак
принимать: принимать
домочадец: домочадцами
слегка: слегка
тот: те тех тому той
здравствуйте: здравствуйте
посторонний: посторонним
фото: фото
основание: основании
звено: звенья
прибылой: прибылых
неодинаковый: неодинакова
допускаться: допускается
м: м
приличие: приличия
сибирский: сибирскими сибирских сибирские
десятилетие: десятилетий
сам: самого
яндекс: яндекс
обращение: обращение
переходящий: переходящий
дефект: дефект дефектом дефекты дефектами
жаркий: жарким
рука: руках рук
ускорение: ускорении
участие: участие участия
остальной: остальным
вперёд: вперед
оставлять: оставлять
просить: просили
череп: черепа череп
любопытный: любопытными
сравнение: сравнении
анвика: анвик
символ: символом
разный: разной разных
боков: боков
холка: холке
тяжеловесность: тяжеловесность
угол: углами углы
относить: относят
раздражитель: раздражителям
состояться: состоявшаяся
журнал: журнал
врожднный: врожднное врожднные
тяжеловес: тяжеловеса
весь: всей всеми
высота: высота высоты
месяц: месяца месяце месяцев
глаукома: глаукома
дерматит: дерматитом
семенник: семенники
удивить: удивит
страна: стране страна
кустарник: кустарники
гулять: гулять
определить: определить
внешний: внешним
трескучий: трескучим
исполин: исполинам исполины
научить: научите
уживаться: уживаются
стихия: стихия
покров: покров покрову
скучать: скучать
пение: пению
агрессивный: агрессивное
болезнь: болезни
постепенный: постепенным
косо: косо
быстрый: быстры быстрее быстром
полтора: полторы
превалировать: превалировать
загородный: загородном
огород: огород
чрезмерно: чрезмерно
ребёнок: детей
либо: либо
правильный: правильная правильным
пятно: пятен пятно
подталкивать: подталкивало
претить: претит
тяжёлый: тяжелых тяжелые тяжелой тяжелая
означать: означала
доля: доля
охота: охоте
доказывать: доказывать
достигать: достигать
показатель: показатель показатели
управляемый: управляемое
увеличивать: увеличивать
дисквалификация: дисквалификации
находка: находки
привлекательно: привлекательно
расселиться: расселились
дешёвый: дешевле
поправиться: поправиться
подшёрсток: подшерстке подшерсток подшерстка
пролив: пролив
суровый: суровыми
соседский: соседскими
престиж: престиж
присущий: присуща
седалищный: седалищных
гоняться: гоняться
корпус: корпуса корпусом корпус
кобель: кобели кобелей
движение: движения движении движений
скакательный: скакательные
перекус: перекус
прирождённый: прирожденный
природа: природа
заметно: заметно
лавка: лавке
умиление: умиление
взросление: взросления
дело: дело
защитник: защитника
этап: этап
риск: рисков
являться: являются является
убежать: убежать
проанализировать: проанализировали
перейти: перейти
скрещивание: скрещивания
сутки: сутки
статус: статус
из-за: из-за
главное: главное
красивый: красивый
верный: верного верной
регулярно: регулярно
костяк: костяком костяк
лихорадка: лихорадка
серьёзность: серьезности
выживать: выживали выживать
ослабить: ослабленные
сознательный: сознательным
копатель: копатель
выставочный: выставочным выставочными
белый: белая белый
глядеть: глядя
иной: иной
улучшить: улучшить
дополнять: дополняет
провести: проведенной
грудь: груди грудь
вместо: вместо
долголетие: долголетием
цепь: цепи
проводы: проводам
заводчик: заводчикам
слишком: слишком
одиночество: одиночеству
карликовость: карликовость
никто: никто
мой: моему
умный: умные умная
рытьё: рытьем
собранный: собранные
смешение: смешение
стальной: стальная
зарегистрировать: зарегистрированных зарегистрированные
посредством: посредством
всевозможный: всевозможных
сзади: сзади
клещ: клещом
день: день
атрофия: атрофия
неуёмный: неуемной неуемная
появляться: появляется
отойти: отойти
волчий: волчий
портить: портить
выпадать: выпадали
проезжать: проезжающим
избавлять: избавляет
ваш: ваш вашего
передвигаться: передвигаясь
вольер: вольере
проточина: проточина
снова: снова
всм: всм
рубль: рублей
спереди: спереди
развить: развить
чистокровный: чистокровной чистокровных
опасный: опасной
топ: топ
попасться: попадется
трх: трх
комфортный: комфортным
игривый: игривы
слабо: слабо
шерстяной: шерстяной
воевать: воевать
поясница: поясницу
пренебрегать: пренебрегать пренебрегают
жертва: жертвы
любой: любые
удалять: удаляют
варить: варят
количество: количестве
бассейн: бассейне
жилище: жилище
спасать: спасал
иметь: имеет иметь имеют имевшим
расходиться: расходится
переживать: переживать
падать: падая
стоимость: стоимость
перевозить: перевозить
сохраниться: сохранился
сантиметр: сантиметров
апрель: апреля
удерживать: удерживать
особенно: особенно
сочетаться: сочетающимися
стойка: стойке
диета: диет
организация: организаций
грюнендалить: грюнендаль
достаточно: достаточно
драться: дрались
затея: затеи
обрезок: обрезков
ебе: ебе
доминировать: доминировать доминирует
прилегать: прилегают
плече-лопаточный: плече-лопаточных
привычка: привычки
эффектный: эффектную
выть: выть
редко: редко
возраст: возраста возрасте
мошонка: мошонку
москва: москве
прикус: прикусом
группа: группе группа
входящий: входящий
нередкий: нередки
отходить: отходят
отметка: отметки
популярность: популярность
пять: пять
надеяться: надеялись
точнее: точнее
форма: формы
говяжий: говяжьей
поставить: поставили поставлены
несмотря: несмотря
горячо: горячо
купить: купить
плотный: плотный
часто: часто
бороздка: бороздка
ухаживать: ухаживать
прямой: прямые
первый: первый первая
руслан: руслан
красный: красного
предел: пределах
развитие: развитии
сбалансировать: сбалансированы
компактно: компактно
по-кошачьи: по-кошачьи
стричь: стригут
путь: пути
вывести: выведенная
свежий: свежем
период: периоды период
непременно: непременно
ньюфаундленд: ньюфаундлендов
задача: задача
недостаток: недостатки недостаткам недостаток
сделать: сделаете сделано
степень: степень
победить: победившей
тоска: тоски
рождение: рождения
вызвать: вызвала
потеря: потери
задаток: задатками задатки
басенджи: басенджи
волк: волки волком волка
скрещивать: скрещивая
живой: живой
наличие: наличие
мирный: мирного
проблема: проблему проблем
травмировать: травмировать
нежелательно: нежелательно
тест: тест
забывать: забывают
развивать: развивали
повторение: повторения
крупа: круп
сырой: сырое
начнт: начнт
патология: патологии
далеко: далеко
одноклассник: одноклассники
странно: странно
вс: вс
маленький: маленьких
традиционный: традиционную
прислать: пришли
великолепный: великолепной
дисплазия: дисплазия
аляска: аляски аляску
правда: правда правды
сходство: сходство
здоровье: здоровья здоровье
случайный: случайные
ровный: ровны
климатический: климатических
случай: случаи случае
пригодиться: пригодились
ведт: ведт
воля: воля
откровенно: откровенно
актёрский: актерские
среднее: среднем среднего
сторожевой: сторожевую сторожевые
сегодня: сегодня
потратить: потраченных
покровный: покровного
тащить: тащить
делать: делают
направление: направлению
распространить: распространен
замкнутый: замкнутого
тренировать: тренировать
тазобедренный: тазобедренного
зуб: зубы
питание: питании
туда: туда
мотивировать: мотивированы
объясняться: объясняется
экзотический: экзотической
кожный: кожными
себя: собой
выглядеть: выглядят
объединить: объединила
подготовка: подготовки
выходец: выходцами
вдоль: вдоль
миндалевидный: миндалевидные
обратиться: обратитесь
дерзкий: дерзким
сбоку: сбоку
наклонить: наклоненными
помощница: помощницей
устать: устанет
пребывание: пребывание
потребность: потребность
смесь: смесь
память: память памятью
река: реки
стандарт: стандарту стандарт стандартов стандартам
живт: живт
плечо: плечах плечи
младенчество: младенчества
недокус: недокус
остевой: остевой
вовсе: вовсе
селекционный: селекционная
линька: линьки линька
жизнь: жизни жизнь
два: двух
пушистый: пушистый пушистая
овчарка: овчарка
они: ними
весить: весят
пушистость: пушистости
кот: котами
едва: едва
любим: любим
мешать: мешает
выдержка: выдержка
благодаря: благодаря
диабет: диабет
предок: предками
минус: минусы
поражение: поражением
пространство: пространства
оцениваться: оцениваются
возвращаться: возвращаться
война: война
добродушие: добродушие
железа: железы
относительно: относительно
нужно: нужно
повседневный: повседневного повседневной
мимимишность: мимимишности
азия: азии
также: также
дисциплина: дисциплине
планировать: планируют
шёрстный: шерстный
момент: моменты момент
окружающий: окружающих
факт: факту
тыс: тыс
нижний: нижней
город: городе
бегать: бегать
официальный: официальных официальным
старший: старшего
бульон: бульоне
штат: штата
продолжать: продолжает
ограниченность: ограниченностью
лаять: лаять
американский: американского
текстура: текстурой
плюшевый: плюшевые
популярный: популярных
похожий: похож похожий
умеренно: умеренно
вернуться: вернувшись
стоить: стоить стоит
развиваться: развивалась
подзыв: подзыву
бугров: бугров
шарафутдинов: шарафутдинова
впоследствии: впоследствии
отличительный: отличительных
крушить: крушить крушат
область: области
идентичный: идентичен
хвостик: хвостик
расстройство: расстройствам
любить: любит любят
край: краям
закручиваться: закручивается
помочь: помочь
бурный: бурный
порка: порок
плоский: плоские
кормить: кормить
способный: способной способны
смочь: сможет
нуждаться: нуждается
недолго: недолго
профиль: профиль
приучение: приучения
красота: красоте
участок: участках
трусливый: трусливое
собрать: собрать
многий: многих
выносливость: выносливость
ножницевидный: ножницевидным
сохранить: сохранить
лента: ленту
словно: словно
одарить: одарила
воспитать: воспитать
достигнуть: достигла
интенсивно: интенсивно
лентяй: лентяям
новый: новый
вина: вины
слепота: слепота
дрессировать: дрессируя
специалист: специалиста специалисты
погодный: погодными
разделение: разделение
ям: ям
половина: половине
лай: лай
развлекаться: развлекаются
снизиться: снизилась
допустить: допустить
марья: марья
воздух: воздухе
принять: приняли
общаться: общаясь
значительный: значительная
снежный: снежному
последовательность: последовательность
ркф: ркф
вакансия: вакансии
адаптация: адаптации
превосходный: превосходной
путать: путают
толпа: толпы
вызывающий: вызывающие
площадка: площадки
приходиться: приходится
забавно: забавно
знакомство: знакомство
погрызть: погрызть
петь: поют
постоянно: постоянно
восстановить: восстановила
совладать: совладать
развлекать: развлекать
общительность: общительностью
североамериканский: североамериканского
дневный: дневная
дальнейший: дальнейшем
сыграть: сыграл
генетически: генетически
январь: января
нагрузка: нагрузку
выше: выше
кли-кай: кли-кая
возбраняться: возбраняется
регион: регионах
плавный: плавный
вместе: вместе
течение: течение
продуктивность: продуктивности
выгуливать: выгуливая
ещ: ещ
коцести: коцебу
о: обо
данный: данное
практически: практически
катаракт: катаракта
скоростной: скоростным
родство: родство
рейтинг: рейтинг
пропорция: пропорции
судить: судить
независимо: независимо
подписываться: подписывайтесь
шутка: шутку
обуздать: обуздать
обходить: обходят
недостаточно: недостаточно
источник: источникам
млут: млут
передаваться: передается
постановка: постановка
вести: вел
запретить: запрещено
очень: очень
обычно: обычно
обобраться: оберетесь
немало: немало
вели: вели
аппетит: аппетит
поддаваться: поддаются
произойти: произошло
неосторожный: неосторожного
паспорт: паспорта
наиболее: наиболее
неравномерно: неравномерно
вырыть: выроет
наоборот: наоборот
швейцарский: швейцарская
маска: маски
похудеть: похудеть
кличка: клички
теория: теории
довольно: довольно
прежде: прежде
прививка: прививкам
поверить: поверить
касаться: касается
одновременно: одновременно
горшок: горшки
причислять: причисляют
пускаться: пускаются
ошибка: ошибок
проект: проекте
сразу: сразу
число: числе
склонный: склонны
недопустимо: недопустимо
круп: крупе
исключать: исключает
кг: кг
николаевич: николаевич
необходимость: необходимости
энергичность: энергичность
заинтересовать: заинтересованы
надежда: надежд
ошейник: ошейник
будничный: будничная
восточный: восточной
массивность: массивностью
потенциальный: потенциальные
низко: низко
темперамент: темперамент
тмный: тмные
щитовидный: щитовидной
вор: вор
стая: стае
психологический: психологическими
наедине: наедине
посадка: посадка
необыкновенный: необыкновенной
опытный: опытным
тонко: тонко
вздутие: вздутия
гавкать: гавкать
подробно: подробно
спортивный: спортивная
расставить: расставлены
повзрослеть: повзрослеют
губа: губы
шуба: шуба
доллар: долларов
сезон: сезона
сенбернар: сенбернаров
посещение: посещение
встречаться: встречаются
подскакивать: подскакивают
гуща: гуще
полоса: полоса
