ясно: ясно
прибыть: прибыв
туалет: туалет
развеваться: развевается
существование: существование
повод: поводом
семя: семян
баловать: балуйте
тело: тела телом тело
выпадать: выпадает
стоять: стоять стоят
широко: широко
средний: средняя среднее средней
типовой: типовых
глава: главы
добавляться: добавляется
расти: растет росла
загородный: загородные
чёрный: черный черной
красный: красный
сколько: сколько
терять: теряйте
ботинок: ботинок
предсказать: предсказать
уметь: умеют
колтун: колтунов
нежирный: нежирного
бояться: боитесь
название: название названия
милый: милы
собака: собаку собаками собакой собак собака собаке собаки
примерно: примерно
угадайка: угадайку
путаться: путаться
созвучный: созвучное
переезд: переезда
общение: общением общение общении
ограждение: ограждения
обусловить: обусловлены
обсуждение: обсуждения
предпочтительный: предпочтителен предпочтительный
страдание: страдания
приветствоваться: приветствуется
трогать: трогают
осень: осени
цена: цена цену
сводистый: сводистыми
никто: никому никто
недостаточный: недостаточной
откладывать: откладывайте
материал: материалов материал
племенной: племенные племенного
подшёрсток: подшерстком подшерсток
рыбий: рыбий
собрат: собратьям
восток: востока
поведение: поведения
сторона: стороны стороне
долгий: дольше долгий
дисквалифицировать: дисквалифицирующие
инстинкт: инстинкты
больший: большим
семейство: семейства
субпродукт: субпродукты
россия: россия россии
тазик: тазик
морда: морде морду морда
земля: землям
обратный: обратная
утрачивать: утрачивают
отчётливо: отчетливо
великобритания: великобритании
ради: ради
светский: светская
мероприятие: мероприятия
представитель: представителей представителем представителями представители
перевести: перевести
упражнение: упражнений
шея: шея шеи
волос: волосом волос
упрямец: упрямцев
способный: способные способна способен
шерсть: шерсть шерсти шерстью
низкий: низкий низкая низкой низкие
влажный: влажные влажная
высушить: высушите
кинолог: кинологи
зверь: зверь зверя
смяться: сомнется
челюсть: челюсти челюсть
воспитание: воспитания воспитание
тип: тип типом типа типы
породный: породного породный породных породные
говядина: говядина
управлять: управляете
творог: творога
уступать: уступают уступающие
трёшка: трешках
вычёсывать: вычесывая
сегодняшний: сегодняшних сегодняшние
необходимый: необходимы необходима
вытирать: вытирают
череда: череды
столь: столь
равно: равно
вырасти: выросшим
размёт: размета
масть: масти
включая: включая
учитывать: учитывайте
отличаться: отличается отличающихся отличаются
стильный: стильные стильным
расчёсывать: расчесывают расчесывайте
душа: душе душой
центральный: центральной центральную
придавать: придающих
история: история
созревание: созревания
гипотиреоз: гипотиреоз
щенок: щенка щенков щенки щенок щенку
завидеть: завидев
ненароком: ненароком
нормально: нормально
белок: белка
выгул: выгул
внимательный: внимательны
мыть: моют
настолько: настолько
расчёска: расчесок
высохший: высохшую
классический: классическая
тихня: тихонь
питомец: питомцев питомцу питомец питомцам питомца
форма: форма формы
голова: голове головы голову голова
приятно: приятно
забывать: забывает забывайте
защитный: защитные защитный
полноценный: полноценная
характеристика: характеристика характеристики характеристик
род: рода
выставка: выставках выставок выставке
руб: руб
поздний: поздний
эмоция: эмоции
диковинка: диковинок
гармоничный: гармоничное
длинноногий: длинноногая
купание: купания
навык: навыков
вид: виды виду виде
заворот: заворот
ежедневный: ежедневная
порода: породе породы пород породами порода породой
разрешение: разрешения
спина: спине спиной спины
обладать: обладать обладают
пёс: псу
быстро: быстро
кардинально: кардинально
добавлять: добавляют
чувствовать: чувствовало
основное: основном
вест-хайленд-уайт-терьер: вест-хайленд-уайт-терьер
видео: видео
длинношёрстный: длинношерстных
прыгучий: прыгучи
позиция: позиция
подойти: подойдет
супер-премиум-класс: супер-премиум-класса
защитить: защитить
глупый: глупы
обойти: обошел
переработать: переработан
внимание: внимания внимание
меню: меню
полностью: полностью
вода: воды водой
лидерство: лидерству
подопечный: подопечные
условие: условии условиям условия
вскорости: вскорости
машина: машинами
быть: будьте будут
улица: улицу
гость: гости
закрепиться: закрепилась
потешить: потешить
разделение: разделении
нормальный: нормальная
незнакомец: незнакомцами
седло: седло
становиться: становился становится
владелец: владельца владельцев владельцу владелец владельцем
лохматый: лохматого лохматые лохматый
вечер: вечер
отварный: отварного
своенравный: своенравных
охотник: охотника охотников
называть: называют называемых называли
открыться: открылись
опускать: опуская
содержание: содержание содержания
ген: гены
нечастый: нечастые
ложиться: ложиться
гипертрофированный: гипертрофированным
расстроить: расстроена
снизу: снизу
игра: играм игры игра игрой
бок: боках бокам
витаминный: витаминные
приятный: приятное
загадочный: загадочной
рекомендовать: рекомендуют
физиологический: физиологические
кривизна: кривизны
численность: численность
оставаться: остаются оставался остается
окрас: окраса окрас окрасов
чёткий: четкого
догонялки: догонялки
помёт: пометов
облик: облика облику
кстати: кстати
афган: афганов афган афганы афганам афгана
связь: связь
расставить: расставленные
покрыть: покрыты покрытыми
квалификация: квалификацию
чесать: чесать
внешность: внешность
ветер: ветра
прижать: прижатые прижаты
достойный: достойных
лоб: лба
профессионал: профессионалу
переводиться: переводится
напасть: напасть
проходить: проходить
пока: пока
стать: стали стать ставшее
жир: жира жир жиры
красота: красоты
от: ото
выложиться: выложиться
инбридинговый: инбридинговые
жильё: жилья
состояние: состоянии
осанка: осанкой
потерять: потерять потеряет
забор: забор
собачий: собачьего собачьей собачьи собачий
нутряной: нутряного
яйцо: яйца
территория: территорией территории территориях
вязка: вязки
выставочный: выставочной выставочными выставочных
увлажнение: увлажнения
тази: тази
пучок: пучок пучки
утвердить: утвержден
год: годах года лет году
лёгкий: легким легкий легче легкой
древний: древнее древнейших древняя
выполнение: выполнения выполнением
салюк: салюки
великолепие: великолепие
безжалостный: безжалостного
хилый: хилые
требовать: требовавшей требует
право: права право
сало: сала
плотно: плотно
куриный: куриного
аптечный: аптечные
признак: признаки
качество: качестве качества
бывать: бывают бывает
смотреть: см
клещеобразный: клещеобразный
смысл: смысла
еда: едой еде
пошатнуть: пошатнуть
склад: складом
фотография: фотографии
широкий: широкие широкой
свешиваться: свешивался
современный: современные современного
уход: уходе ухода уход уходом
голубой: голубой
создание: создания
столько: столько
сварить: сваренного
результат: результат
страдать: страдают
высокий: высокая высоком высокий
особь: особь особи особям особей
питомник: питомники питомника питомник
верхний: верхней
пакистан: пакистане пакистана
афганский: афганских афганская афганским афганской афганские афганскими афганскую
пара: пары
переносить: переносят
сродни: сродни
глаз: глаза
проказа: проказы
летний: летний
район: районе
спрашивать: спрашивать
самый: самый самых
собственный: собственном собственным собственные собственной собственному
прийтись: придется
мягкий: мягкий мягким
корм: корм корма
валенок: валенок
часть: части часть
вниз: вниз
сказать: сказать
век: века
грызть: грызя
буквально: буквально
ветеринарный: ветеринарным
поскольку: поскольку
нерешённый: нерешенным
обучение: обучения
лето: лета
покупать: покупать
краткий: краткая
чистота: чистотой
весьма: весьма
радужка: радужка
любой: любого любое любой
мантия: мантии мантия
отношение: отношение
вкупе: вкупе
место: место месте
поясница: поясницей
конкурс: конкурсах
исключительно: исключительно
эмоционально-физический: эмоционально-физическая
сородич: сородичей
весь: весь
комплекс: комплекса комплексы
первый: первом первый первую
эксперт: экспертов
черно-подпалый: черно-подпалой
рискнуть: рискнули
стремление: стремление
таз: тазы
подходящий: подходящей
вконтакте: вконтакте
создать: создать
агрессивный: агрессивны
средство: средств
пол: пол
поинтересоваться: поинтересуйтесь
ценник: ценник
животное: животных животным животного животными животные животное
один: одного одна одной одни
сырой: сырую
размер: размерах размеры размер
усваивать: усваивают
привезти: привезенные привезли
вырывать: вырывает
сша: сша
альбинизм: альбинизм
привязываться: привязываются
затылочный: затылочным
бег: беге бег
воздушность: воздушность
характер: характером характеры характер
какой: каком каким
длина: длины
охотничий: охотничьих охотничьими охотничьей
спокойный: спокойным
выбрать: выбрать выбраны
западный: западного
систематический: систематическим
докучать: докучать
свисать: свисает свисающая
поочерёдный: поочередным
считать: считанные считать
желание: желании
основать: основана
шёрстный: шерстного шерстным
брюки: брюки
хотя: хотя
нижний: нижняя нижней
позволить: позвольте позволят
восточный: восточные
раз-два: раз-два
взбрести: взбредет
х: х
расстояние: расстоянии расстояния
внешний: внешней внешним
тримминговочный: тримминговочный
видный: видны видна
четверолапый: четверолапым
хвост: хвостом хвоста хвост
полный: полные
заведение: заведения заведении заведение
избирательный: избирательны
познакомиться: познакомиться
нога: ногам ноги ногой
трудоёмкий: трудоемкий
хорошенько: хорошенько
лесной: лесным
квартира: квартире
мера: меру
информация: информация
телосложение: телосложения
хотеть: хочет хотите
палец: пальцами
гребень: гребнем гребней
отправиться: отправится
сначала: сначала
активный: активного
родитель: родители родителей
обитание: обитания
крепкий: крепкие крепкая
ссылаться: ссылаются
удовлетворить: удовлетворит
сухой: сухой
половина: половина
польза: пользу
сбалансированный: сбалансированную
явный: явного
кончик: кончик
сравнительно: сравнительно
индия: индии
среди: среди
скромный: скромных
дом: дом дома
пастух: пастухов
записать: запишите
серьёзный: серьезных
лапа: лапах лапой лапами лапы лапа
лежанка: лежанка
веко: веки
невостребованный: невостребованные
сквер: скверам
ласковый: ласковые
длинный: длинные длиннее длинный длинным длинная длинными
считаться: считается
подготовка: подготовка
норма: нормы
расчёсывание: расчесыванием расчесывания
увидеть: увидите
облачать: облачают
просто: просто
затратить: затратить
белл-мюррей: белл-мюррея
порция: порция
объятие: объятиям
причинять: причиняет
борзая: борзой борзым борзая борзых борзые борзую борзыми
выйти: выйти
пачкать: пачкает
британский: британских британском
частый: частые чаще
подчеркнуть: подчеркнуто
распоряжаться: распоряжаться
сушка: сушка сушку
прочий: прочих
доверять: доверяете
природный: природное
проследить: проследите
малыш: малышам малыш малыши малыша
перемахнуть: перемахнет
обходиться: обходится
который: которое которыми которой которого которая которых которым которые который
заменить: заменить
несправедливый: несправедливо
миссис: миссис
сердце: сердцем сердце
наесться: наесться
добавить: добавьте
светлый: светлой
прогулка: прогулки прогулке
происхождение: происхождения
тёмный: темные
лапка: лапки
должный: должно
необходимо: необходимо
укладка: укладке
огородить: огороженных
выходец: выходцы
удлинённый: удлиненная удлиненные
прядь: прядями пряди
задний: задние
горный: горный
похвастаться: похвастаться
терпеть: терпеть
дрессировка: дрессировка дрессировке
майор: майора
нравиться: нравиться
стандартный: стандартный стандартного
время: время времени
отдельно: отдельно
сука: суки сук
колечко: колечко
агрессивность: агрессивность
ушной: ушной ушного
слово: слову
юный: юные юному
иметься: имеющемуся
самолюбивый: самолюбивая
погода: погоду
пясть: пясти
они: ими
другой: другие другого других другими другая другим
электризоваться: электризуется
яркий: яркая
взрослый: взрослого взрослая взрослым
предпочитать: предпочитает
кабульский: кабульских
трепетно: трепетно
подкормка: подкормки
отказаться: откажутся отказаться
характерный: характерна
интерчемпионский: интерчемпионскими
клубный: клубных клубного
например: например
несколько: несколько
сетчатка: сетчатки
превосходно: превосходно
кондиционер: кондиционер
родина: родиной родине
топ-кнота: топ-кнот
рост: рост роста
оброслость: оброслости
подобный: подобными подобные
болевой: болевой
покупатель: покупателей
умеренный: умеренное
экзотический: экзотических
реклама: реклама
силуэт: силуэта
соответственно: соответственно
фен: феном
репутация: репутация
полотно: полотна
использование: использованием
затрата: затрат
винить: винить
нюанс: нюанс
кристал: кристал
вселенский: вселенского
бегун: бегуны
остальной: остальные
провисать: провисающих
южный: южной
лакомство: лакомствами
водяной: водяной
посадка: посадки посадка
определённо: определенно
диагностировать: диагностируемые
незначительный: незначительным незначительная
выраженный: выраженным
эталон: эталоном
сеточка: сеточкой
окд: окд
селекционер: селекционерами селекционеры
рекомендоваться: рекомендуется
качественный: качественную
мочка: мочки
мозговой: мозговые
спокойно: спокойно
скрещивание: скрещиванию
переехать: переехать
атласный: атласной
расселиться: расселившейся
высворивание: высворивании
застенчивый: застенчивых
курица: курица
личный: личной
дама: дама
прихватить: прихватите
дичь: дичи дичь
блестящий: блестящая
диагноз: диагнозами
наследственный: наследственных
сформироваться: сформировавшимся
захотеться: захочется
засветиться: засветились
сам: самой самих
серебристый: серебристый
оба: обоих
добиться: добиться
поддержание: поддержания
сайт: сайту
свободный: свободного свободное
клёш: клеш
колючка: колючек
критиковать: критикует
недуг: недугов
карапуз: карапузов
кожа: кожа
сюрприз: сюрпризу
лишь: лишь
изысканность: изысканности
что-то: что-то чем-то
грумерский: грумерских
вариант: вариант
стрижка: стрижка
соперничать: соперничать
выводить: выводить выводя
тот: теми те тому
степной: степной
треугольный: треугольной
домашний: домашним домашнего домашнему
иметь: имеющий имеет иметь имеющие
форум: форум форуме
азия: азию азии
печень: печень
стоп: стопом
конец: конце конец
брак: брак
боль: боль
ость: ость
сила: сил силой
подвиг: подвиги
наш: нашей
рельефный: рельефным
такой: такие
весомый: весомым
кость: кость
мясо: мяса мясо
обработка: обработки
изрядно: изрядно
шоу-класс: шоу-класса
экзема: экземы
натуральный: натуральной
описание: описание
бороться: борющимися
начало: начало начале
влага: влага
мыльный: мыльной
ящик: ящик
оттенок: оттенки оттенка оттенок
военный: военных военными
коричнево-печёночный: коричнево-печеночного
лопатка: лопатки
лоск: лоск
середина: середине
косметический: косметических
здоровяк: здоровяки
подростковый: подростковом
консервы: консервами
однако: однако
огромный: огромные
пробор: пробор
подмешивать: подмешивают
соприкосновение: соприкосновения
перенести: перенести
смотреться: смотрится
поэтому: поэтому
ночь: ночи
фосфат: фосфат
особа: особа
копирование: копирование
трудно: трудно
победа: победу
активность: активность
удивительный: удивительную
дружелюбность: дружелюбность
сквозняк: сквозняк
размножаться: размножались
тратить: тратить
подвижный: подвижные
создаваться: создававшаяся
отзыв: отзывах отзывы отзывами
пелёнка: пеленками
чей: чье
переходить: переходить
завозить: завозили
бугор: бугром
работёнка: работенки
кошка: кошки кошками кошкам
плохой: плохим
животный: животному
привлечь: привлечь
шум: шум
декоративный: декоративную декоративных
собираться: собирается
трон: трон
курсинга: курсинг
спускать: спуская
наказать: наказать
счастливо: счастливо
густой: густая
подмышка: подмышками
зверёк: зверьком
королевский: королевских
назад: назад
наносить: наносят
состоять: состоят состоящий
поначалу: поначалу
помогать: помогать
казахский: казахских
отвести: отведенные
интерес: интерес
мочь: могут мог можете
локоть: локти
скрыться: скроется
маршрут: маршрут
воздушный: воздушным
вернуться: вернувшимися
хватать: хватает
депигментировать: депигментированные
полно: полно
обидчивый: обидчив
иной: иное
целое: целом
прививать: прививать
объявление: объявления
размещать: размещает
конкурировать: конкурировали
делать: делайте делать делали
попрыгушка: попрыгушкам
прищемить: прищемленный
наполовину: наполовину
сложный: сложный
основной: основные
финансовый: финансовых
диплом: дипломами
редкий: редкая
интеллект: интеллект
охранный: охранные
репейник: репейника
проявление: проявления
неправильный: неправильный
вес: вес
полотенце: полотенцем
помочь: помогут
выгуливать: выгуливайте выгуливают
линять: линяют
противопоказанный: противопоказана
свой: своим свое своих свои
жировой: жировой
планироваться: планируется
быстромчащийся: быстромчащиеся
именно: именно
чрезвычайно: чрезвычайно
злоупотреблять: злоупотреблять
продолжительность: продолжительность
счёт: счета
стремительный: стремительного
питаться: питающимся
расположить: расположенные
чувствительность: чувствительностью
страна: страны странах страна
короче: короче
положение: положении
возмущение: возмущения
подвергнуться: подверглись
облачить: облаченная
кавказский: кавказская
капризуля: капризуль
подчёркивать: подчеркивая
жить: жили
обязывать: обязывал
фото: фото
вы: вами
заодно: заодно
два: две
кошачий: кошачьим
сустав: суставами
попутешествовать: попутешествовал
готовый: готов
яндекс: яндекс
тренироваться: тренируется
давать: дают давайте
осенний: осеннюю осенним
покупаться: покупается
ножницы: ножницы
выглядеть: выглядеть
нестись: несется
помета: помет помета
проникнуть: проникли
череп: черепа
различный: различного
социализация: социализации
дикий: диким
ухо: ушах уши
холка: холке
досушивать: досушивают
официальный: официальной
журнал: журнал
линия: линии
покрывать: покрывающая покрывать
высота: высота высоты
ближний: ближнего
игривый: игривые
месяц: месяца месяцев
кличка: кличке клички
клан: клан
государство: государств
минута: минуты
насилие: насилие
ванна: ванны
обычный: обычному обычного
хозяин: хозяину хозяев
стихия: стихия
пожертвовать: пожертвовать
превосходный: превосходные
болезнь: болезни
золотистый: золотистый
ребёнок: дети
косо: косо
хороший: хорошая хорошей
виноватый: виноваты
заводчик: заводчиков
жёсткий: жестче
о-о-очень: о-о-очень
совершенно: совершенно
покров: покровом покрова
либо: либо
наряд: нарядом
вдоволь: вдоволь
активно: активно
упрямство: упрямство
хилоторакс: хилоторакс
доля: доля
предварительный: предварительного
человек: человека
охота: охоте
доказывать: доказывать
покатый: покатым
простой: проще
смазка: смазки
пёс-афган: пес-афган
внимательно: внимательно
вводить: вводя
отличник: отличники
приусадебный: приусадебной
отход: отходы
зрелый: зрелая зрелые
схожий: схож
белый: белой белый
утратить: утратили
соседский: соседскими
кобель: кобели кобелей
сваливаться: сваливаются
плохо: плохо
встречаться: встречающиеся
заметно: заметно
выносить: выносящая
иран: иране
дело: дело делам
день: дня
темп: темпе
немой: нем
минеральный: минеральные
превращаться: превращается превращаясь
убежать: убежать
перейти: перейти
реально: реально
образоваться: образуется
статус: статус
физический: физические
неприязнь: неприязни
азиатский: азиатских азиатской
разный: разные
из-за: из-за
пятнышко: пятнышки
заморачиваться: заморачиваться
менее: менее
щенок-афган: щенка-афгана
дальнейший: дальнейшего
чистый: чистым
откуда: откуда
свежий: свежего
организм: организма
зной: зной
кочевник: кочевники
родословный: родословные
попробовать: попробуют
мусор: мусора
ровный: ровной
область: область
слишком: слишком
одиночество: одиночеству
обзавестись: обзавелись
требоваться: требуется
маскировать: маскировать
притравочный: притравочных
свиной: свиное
туркменский: туркменских
стандарт: стандарта стандарт
всевозможный: всевозможных
посредством: посредством
спрос: спросом
появляться: появляется
гигиена: гигиена
второй: втором
бахилы: бахилы
поочерёдно: поочередно
относиться: относятся
браковаться: бракуются
передний: передней передних
оценка: оценке
появиться: появился
бдительность: бдительности
принцип: принципы
рубль: рублей
команда: команд команды команда
постигать: постигать
пользоваться: пользоваться
разведение: разведения
перекос: перекосом
возможный: возможен
спорить: спорящими
зверьё: зверьем
истина: истины
прикус: прикуса прикус
тапочки: тапочках
дегенерация: дегенерация
видеть: видят
аристократка: аристократка
морковка: морковку
газни: газни
присутствовать: присутствующие
срыв: срыва
знать: знаем знают
стоимость: стоимость
послойно: послойно
дерматит: дерматиты
осмотреть: осмотрите
последний: последнее
иначе: иначе
особенно: особенно
луг: лугам
стойка: стойке
использовать: использовали
бишон: бишон
вытянутый: вытянутое вытянутая
строго: строго
клетчатка: клетчатке
довести: довести
афганистан: афганистана афганистан
заблуждение: заблуждение
поглощаться: поглощаются
надбровье: надбровья
достаточно: достаточно
дрессировать: дрессировать
обязательно: обязательно
чемпион: чемпионы
накануне: накануне
пет-класс: пет-класс
стимулировать: стимулировать
показатель: показателям
станция: станциях
ранка: ранка
кровь: кровей
группа: группе
отправляться: отправляясь
европа: европы
щетина: щетины
неопрятный: неопрятный
поводок: поводке поводка
англия: англии англию
любитель: любителей
мечтать: мечтаете
несмотря: несмотря
исследователь: исследователи
ходить: ходить
друг: другом
купить: купить
часто: часто
поставить: поставлены поставленные
ухаживать: ухаживать
самолюбие: самолюбие
эра: эры
двушка: двушках
заболевание: заболеваний
практиковать: практикует
массив: массивам
вкрутую: вкрутую
грациозность: грациозность
лишённый: лишенная
малышня: малышни
пэласа: пэлас
корона: корону
вертикально: вертикально
путь: пути
один-два: один-два
разводить: разводили
дёшево: дешево
тысячелетие: тысячелетий
предок: предки предков
опрятный: опрятнее
содержать: содержат
газета: газетами
аскетичный: аскетичным
корпус: корпусу корпус
нервный: нервного
обильный: обильный
наличие: наличие
выставляться: выставляется
грозить: грозят
распространить: распространить распространенные
племя: племени
аргумент: аргумента
промозглый: промозглую
ревновать: ревнуя
неправильно: неправильно
ум: ума
одноклассник: одноклассники
подавать: подает
трусца: трусцой
приобрести: приобрели
волосок: волоски
застелить: застелите
мнение: мнение
здоровье: здоровья здоровье
сравнение: сравнению
случайный: случайные
ограничить: ограничен
базовый: базового
случай: случаи случае
кроме: кроме
эффектно: эффектно
эмпс: эмпс
пустырь: пустырях
каждый: каждая
среднее: среднем среднего
суть: сути
сегодня: сегодня
бульон: бульона
недовольство: недовольства
профессиональный: профессиональным
поиск: поиск
слышный: слышно
привести: привело
идеальный: идеальный идеального
участок: участков
удлиняться: удлиняется
туда: туда
познакомить: познакомьте
безопасный: безопасный
первичный: первичных
прибавиться: прибавилось
некоторый: некоторые
себя: собой
поменять: поменять
образовать: образует
белые: белые
период: период
указать: указать
шампунь: шампунем
тонкость: тонкости
приказ: приказов
порыв: порывами
короткий: короткая короткой
рыбный: рыбного
щётка: щеткой
тигровый: тигровый
сделать: сделано
нос: нос
учесть: учтите
ранний: раньше раннее
новый: нового новый
присмотреться: присмотритесь
потребность: потребность
обожать: обожающая
периодически: периодически
общительный: общительны
порок: пороки
натянуть: натянуть
хозяйский: хозяйского хозяйской
комфортность: комфортность
прокладывать: прокладывать
упитанность: упитанности
недотрога: недотроги
гордый: гордая
малый: малейший
опытный: опытных
жизнь: жизни жизнью
нужный: нужная
абсолютно: абсолютно
комбинезон: комбинезон
овчарка: овчарка
выдающийся: выдающиеся
отмереть: отмершие
слабый: слабые
ждать: ждите
сильно: сильно
пыль: пылью
затем: затем
раз: разы
плечо: плечи
арсенал: арсеналу
пространство: пространства
неприхотливый: неприхотливой
начать: начнете
шоу-особь: шоу-особям
проживание: проживания
относительно: относительно
шоу: шоу
надоедливый: надоедливые
нужно: нужно
мимимишность: мимимишности
также: также
процесс: процесс
банный: банного
чувствительный: чувствительная
достаточный: достаточной
любопытный: любопытным
эпатажный: эпатажно
катастрофа: катастрофе
проработать: проработайте
момент: моменты
сюда: сюда
фамильярность: фамильярности
мощный: мощные
двухчасовой: двухчасовая
миелопатия: миелопатия
постоянный: постоянное
нож: нож
изучить: изучите
послужить: послужил
баранина: баранина
обрезка: обрезки
неженка: неженки
начинать: начиная
исключение: исключения
косточка: косточки
изначально: изначально
подбадривать: подбадривать
попасть: попала
впоследствии: впоследствии
хождение: хождении
порог: порог
похвала: похвалы
сложно: сложно
крипторхизм: крипторхизм
крайне: крайне
мэри: мэри
кипеть: кипит
стоить: стоит
это: это
жена: жене
обнюхивание: обнюхивания
естественный: естественной
укоротить: укоротить
интересно: интересно
когда-то: когда-то
квартирный: квартирного
филе: филе
закручиваться: закручивается
зависеть: зависит
вопрос: вопрос
тихий: тихих
принадлежать: принадлежавший
миролюбивый: миролюбивым
афганкий: афганкие
вполне: вполне
потренироваться: потренироваться
прервать: прервет
примерный: примерные
детский: детской
смочь: сможет
ласка: ласки
медленный: медленном
кусочек: кусочек
невоспитанный: невоспитанные
общий: общем
любить: любят
нуждаться: нуждается
гаванский: гаванский
служба: службы
мешать: мешают
какой-нибудь: каким-нибудь
тренировка: тренировка
сезон: сезон
притязание: притязаниями
повседневный: повседневной
формироваться: формируется
набор: набором
контрастный: контрастной
легко: легко
идеально: идеально
слабенький: слабеньких
обделить: обделенным
лента: ленту
словно: словно
премиум: премиум
интенсивно: интенсивно
хватка: хваткой
возникать: возникает
кто-то: кому-то
загон: загона
специалист: специалиста специалисты
многое: многом
выщипывать: выщипывая
безопасность: безопасности
разновидность: разновидность
месячный: месячные
вакансия: вакансии
угощение: угощение
допустимый: допустимым
мир: мира
приписывать: приписывают
придерживать: придерживая
репрессия: репрессии
суховатый: суховатая
минутный: минутное
клинообразный: клинообразная
утро: утро
вор: вора
независимость: независимости
выше: выше
расцениваться: расценивается
формировать: формируя
низкокалорийный: низкокалорийны
занятие: занятия
хрупкий: хрупок
палевый: палевый
извлечение: извлечение
вместе: вместе
вырвать: вырвал
рис: рисом
погоняться: погоняться
столетие: столетия
проживать: проживающих проживали
жара: жару
кишечник: кишечника
покупка: покупка
ламинария: ламинарию
тёплый: теплой
главный: главная
практически: практически
катаракт: катаракта
родство: родство
рейтинг: рейтинг
генетический: генетических
рабочий: рабочую
претендент: претендентов
проход: проход
подписываться: подписывайтесь
создавать: создающие
повышенный: повышенной
следовательно: следовательно
задеть: задеть
длинноволосый: длинноволосых
сильный: сильные
самостоятельно: самостоятельно
красавица: красавицы
экстрасенс: экстрасенс
экскурсия: экскурсий
запретить: запрещено
очень: очень
обычно: обычно
мелкий: мелким
особенность: особенности особенность
поддаваться: поддаются
аборигенный: аборигенных
нагрузка: нагрузки
утончить: утонченная
наиболее: наиболее
ирландский: ирландский
наоборот: наоборот
постепенно: постепенно
разрядка: разрядка
маска: маски
круп: крупом
правило: правила
довольно: довольно
частность: частности
готовиться: готовьтесь
возможность: возможность
пробежка: пробежка
удалённый: удаленном
исполнение: исполнения
касаться: касается
ощущение: ощущение
окрасить: окрашена
самочувствие: самочувствие
вырастить: вырастить
индивидуальность: индивидуальность
развести: разведенным
согнутый: согнутыми
проект: проекте
сразу: сразу
склонный: склонны
обширный: обширной
спаниель: спаниель
пора: пор
кг: кг
городской: городской
апартамент: апартаменты
темперамент: темперамента
сей: сих
риск: риск
линька: линька
идти: идти
рацион: рацион
сдержанный: сдержанны
контроль: контроль
низко: низко
прямой: прямой
личность: личности
комнатный: комнатной
важный: важный
несхожий: несхожие
резвый: резвым
лизнуть: лизнуть
причём: причем
подогнать: подогнать
тотальный: тотальный
плащ: плащ
ареал: ареал
вывести: вывели
кормление: кормление
конечность: конечности
небезызвестный: небезызвестный
дикальций: дикальций
американский: американскими
дефицит: дефициту
губа: губы
возраст: возрасте
элитный: элитных
основный: основных
царственный: царственной
грызун: грызунами
интеллигентный: интеллигентных
особый: особый
посещение: посещение
зардин: зардин
типичный: типичные
обаятельный: обаятельны
