процесс: процессе
овощ: овощи
дисквалификация: дисквалификация
использовать: используя используйте использовать
отдавать: отдавайте
тело: тела теле
стоять: стоять
натаска: натаской натаска натаски натаске
ощущать: ощущать
восходить: восходит
отбор: отбор
сколько: сколько
трехцветный: трехцветный
соплеменник: соплеменниками
соседний: соседних
миссия: миссия
служебник: служебника
название: название названия
собака: собаку собак собака собаке собаки
тон: тонах
примерно: примерно
сухой: сухого
губа: губах губ губы
ноздря: ноздри
обсуждение: обсуждения
неконфликтный: неконфликтен
отношение: отношениях отношение отношения
ведение: ведением
миска: миску
английский: английских
цена: цена
эпаньоля: эпаньоли эпаньолей эпаньоль эпаньоле эпаньоля эпаньолю
рельефный: рельефные
материал: материалов
гладкошёрстный: гладкошерстными
вещь: вещи
спинка: спинку
шампунь: шампунями
обратить: обратите обратить
отапливать: отапливаемом
владелец: владельцам владельца владельцев
заметить: замеченном
больший: большим
влажный: влажных
субпродукт: субпродукты
россия: россия россии
морда: морде морды морда
карьера: карьеру
обратный: обратная
температура: температуры
ради: ради
представитель: представителей представителям
искать: искать ищи
начинающий: начинающих начинающим начинающего
команда: команду команд команды команда
легавый: легавая легавые легавых легавыми легавую легавой
появляться: появляются появляться
высококвалифицированный: высококвалифицированного
шея: шея шее
волос: волосом волос
шерсть: шерсть шерстью
чалый: чалый
выразить: выражены
по-разному: по-разному
печеночно-рыжеть: печеночно-рыжей
челюсть: челюсти
метод: метод методы
должный: должны должен должна
появиться: появившимся появилась
тип: тип типа
контур: контуром
говядина: говядина
взгляд: взгляд
обозначить: обозначенным
бретон: бретон бретонов бретона бретоны
поселить: поселить
большой: большой большому
тонкий: тонкий тонкие
тарелка: тарелке
общение: общения общении
масть: масти
экземпляр: экземпляра
отличаться: отличается
рычать: рычит
ограничение: ограничений
важно: важно
подружейный: подружейная подружейной
история: история
хороший: хорошего лучшей лучший лучшее хорошая хорошее
щенок: щенка щенков щенки щенок щенку
взрослый: взрослое взрослую взрослом
нормально: нормально
белок: белка
выгул: выгул
успешно: успешно
сбалансированный: сбалансированного
морозный: морозную
проявлять: проявляет
форма: форма
голова: голове головы голова
приятно: приятно
обучение: обучении обучение
ласковый: ласковый
попасть: попасть
характеристика: характеристика
стоп: стоп
выставка: выставках выставок выставке
выставочный: выставочные выставочного выставочных
поздний: поздний
куропатка: куропатками куропатка
заводчик: заводчик заводчиков заводчики
бретонский: бретонских бретонскому бретонский бретонском бретонского
зарождение: зарождения
купание: купания
треугольник: треугольников
пятно: пятна
лесник: лесников
состоятельность: состоятельность
профессионально: профессионально
вид: виды видами виде
страховать: страхует
пегий: пегая пегий
еда: еды еду
родиться: родившихся
индивидуальный: индивидуальных
переключать: переключает
общаться: общаться
стать: стала стало статей
выявить: выявить
осуществлять: осуществлять
слить: слить
палец: пальцы
быстро: быстро
французский: французским французской
подбор: подбору
сайт: сайте сайту
связывать: связывают
водоём: водоемах
раз: раза
видео: видео
использоваться: использоваться
физический: физическую физической
минус: минусами
полностью: полностью
кошка: кошка кошки
возможный: возможные
по-прежнему: по-прежнему
домашний: домашних домашнюю домашней
выглядеть: выглядел выглядит
печеночно-белый: печеночно-белого
средневековый: средневековой
нужный: нужна нужен
вечер: вечер
рацион: рациона рационе
документация: документации
охотник: охотника охотниками охотник охотником охотники охотникам охотников
полевой: полевых полевой
речь: речь
генрих: генрих
содержание: содержание содержания
услышать: услышав
собственный: собственного
сера: серы
работа: работе работы
написать: написанных
немного: немного
замечательный: замечательно
приучать: приучать
негустой: негустая
универсальный: универсальным универсальный
рекомендовать: рекомендуют
настоящий: настоящим
энтропия: энтропией
жить: живет
сходство: сходстве
диплом: дипломов дипломы
примирить: примирить
покупка: покупкой покупке
подвес: подвес
конвергенция: конвергенция
связь: связь связи
бретань: бретани бретань
раздражающий: раздражающих
точно: точно
клуб: клуб клуба
усложнять: усложняют
квалификация: квалификацию квалификация
угол: углом
перевернуть: перевернув
бедренный: бедренной
орган: органам
май-июнь: мае-июне
радужный: радужной
бедро: бедра
опрятно: опрятно
котёнок: котенком
пока: пока
бумажный: бумажный
полный: полная полный
маленький: маленький маленькими меньше
добавить: добавят добавьте
официальный: официальный
роять: роял
вязка: вязки
коробка: коробка
стиль: стиля
ситуация: ситуацию
заниматься: заниматься занимались занимался
старший: старше
пинкон: пинкон
проверить: проверить проверьте
бумага: бумаги
формировать: формируют
остальной: остальную остальное
поле: поле
смотреть: см смотрите
сходиться: сходятся
морфологический: морфологические
лёгкий: легкий легкие
доверие: доверие
обзаводиться: обзаводитесь
фотография: фотографии
широкий: широкие широкой широкую
помогать: помогает
агрессивный: агрессивная
уход: уходе уход
отменять: отменяет
суточный: суточный
столько: столько
помнить: помните
страдать: страдать
высокий: высокая высокой высокий
питомник: питомники
иметь: имевшая иметь
находиться: находиться
выбирать: выбирайте
глаз: глаза глаз глазах
лосьон: лосьоны
район: районе
прийтись: придется
бежать: бегущие
реалия: реалии
получать: получаете
часть: части часть
профилактика: профилактики
век: века
конечность: конечностях конечностей конечности
год: года лет год году
хитрость: хитрость
дом: домах дом дома
краткий: краткая
оставить: оставленные
врождённый: врожденная врожденной
свой: своими своих
масса: массы массу
исключительно: исключительно
гигиена: гигиеной гигиена
эксперт: экспертов
умный: умный умен умная
остаточный: остаточная
плюс: плюсами
вконтакте: вконтакте
свет: свет
помахать: помашите
создать: создать
далее: далее
съедать: съедать
добывать: добывала
плоскость: плоскостями
среда: среде
посадить: посаженных посадите
экстерьерный: экстерьерный экстерьерные
типичный: типичная
животное: животных животным животного животные животное
одинаково: одинаково
обожать: обожаемого обожал
дупель: дупель
склонность: склонностью
нелла: нелл
питомец: питомец питомца питомцем
бракоподобный: бракоподобный
охотничий: охотничьих охотничьим охотничья
выбрать: выбрать
российский: российские
скула: скулы
открытый: открытый открытых
франция: францию франция франции
основать: основана
хотя: хотя
скандалить: скандалят
требование: требованием требования
подвижный: подвижной подвижные
одевать: одевайте
видный: видны
соответствовать: соответствующей
выгуливать: выгуливать
отвисать: отвисать
установить: установить
свернуть: свернуть
нестись: нестись несется
мероприятие: мероприятиях
квартира: квартире
увлечь: увлеченным
официально: официально
информация: информация информацию
местный: местными местного
друг: друг другу
послушный: послушного
доминанта: доминант
литература: литературе литература литературу
влюбить: влюбленная
гребень: гребнем гребень
трижды: трижды
универсальность: универсальность
выбор: выбор
порча: порчи
окрас: окрас окрасов
бело-рыжий: бело-рыжий
крепкий: крепкие крепкая
первичный: первичная
природный: природной
рембрандт: рембрандта
среди: среди
истинный: истинный
предел: пределами
линия: линию линий линии
это: этим это
веко: веки
знакомый: знакомых
разговаривать: разговаривают
рощица: рощицу
немотивированный: немотивированную
чувствительный: чувствителен
считаться: считается
собаковод: собаководов
рабочий: рабочих рабочие рабочей
подготовка: подготовка
запечатлеть: запечатлены
развитой: развитыми
загрязнение: загрязнения
пол: полу
плескание: плескания
просто: просто
проходиться: проходиться
порция: порция
бело-коричневый: бело-коричневый
снизить: снизить
конец: конца конец
собираться: собираетесь
принять: принято
смыкаться: смыкаются
час: часа
провинция: провинции
любить: любивших
опытный: опытными
пожить: пожить
заинтересоваться: заинтересовался
дисквалифицироваться: дисквалифицируются
улечься: уляжется
гладкий: гладкий
который: которое которого которых который
локоть: локтей
проживание: проживание
предрасположенность: предрасположенность
умеренный: умеренная
происхождение: происхождения
следующий: следующими следующим
фазан: фазанами
остановиться: остановитесь
задний: задние
редкий: реже
тщательно: тщательно
гончий: гончая
укладываться: укладываются
лакомство: лакомство лакомства
дрессировка: дрессировка
горизонтально: горизонтально
базовый: базовый
семя: семена
умелый: умелый
время: время времени
сука: суки сука
толстый: толстыми
прямой: прямым прямая
плохой: хуже худшем
агрессивность: агрессивность
насекомое: насекомые
чёрно-белый: черно-белой
погода: погоду
начать: начали
другой: другие других другими
коммуникабельный: коммуникабелен
злак: злаки
предпочитать: предпочитает
классика: классика
двухразовый: двухразовые
логический: логическую
мера: мере
например: например
сетчатка: сетчатки
осенний: осенних
рост: рост
цвергпинчер: цвергпинчер
скрытый: скрыты
зимний: зимних
подобный: подобными
регистрация: регистрацией
эпаньол: эпаньола
вне: вне
куцый: куцым
хотеться: хочется
оценка: оценку оценке
прошлый: прошлом
твёрдый: твердые
к: ко
реклама: реклама
наклон: наклоном
исполниться: исполнится
получить: получите получить
средний: среднее средние
пособие: пособий
перепел: перепел перепелами
полотно: полотна полотнах
небольшой: небольшую небольшие
норма: норму
звук: звук звуки
сторона: стороне
рекомендоваться: рекомендуется
напоминать: напоминает
пигментация: пигментация
получиться: получится
обильный: обильным
воспитание: воспитание
явно: явно
пробуждаться: пробуждающимися
малыш: малыш малыша
мирно: мирно
дичь: дичи дичь
выводить: выводили выводить выводят
правильно: правильно
девиз: девиз
добавлять: добавлять
задача: задачу
мясной: мясной
составлять: составляющей
длинный: длиннее
округлый: округлым
особенность: особенностей
волнистый: волнистой
гипотиреоз: гипотиреоза
реагировать: реагирует
работать: работающих работают работает
этот: эта
пытаться: пытается пытаются
долго: долго
ризеншнауцер: ризеншнауцер
компактный: компактная компактном
форум: форум форуме форумах
натаскать: натаскать
готовый: готового готовый
определиться: определиться
близкий: ближайшую
требовать: требуют
капля: капли
петрункевич: петрункевич
выразительный: выразительный
ровный: ровные
один: одна одной
описание: описание
погодный: погодные
рано: рано
породный: породных
начало: начало
добыча: добычу
суровый: суровы
вероятность: вероятности
лопатка: лопатки
налёт: налета
найти: найти
зубной: зубного зубные
искренне: искренне
национальный: национальный
обитать: обитает
ножницевидный: ножницевидного
поэтому: поэтому
отводиться: отводится
живность: живность
аптечка: аптечке
увеличить: увеличьте
копирование: копирование
дружелюбный: дружелюбная
короткий: короткий короткие короткая короткими
черепной: черепная
активность: активность активности
помещение: помещении
основание: основания
серый: серой
русский: русская
покрепче: покрепче
дружелюбность: дружелюбность
обидеться: обидятся
плавно: плавно
отзыв: отзывах отзывы
колено: коленями
нога: ноги ногах
чистокровный: чистокровного
коммуникабельность: коммуникабельность
доступ: доступе
резкий: резкие
отсутствие: отсутствии отсутствие
мимо: мимо
поясница: поясницы поясница
шум: шум
спаниель: спаниеля спаниель
висячий: висячие висячего
особь: особи особей
пах: паха
верхний: верхние
разрядка: разрядки
осенне-зимний: осенне-зимний
актуально: актуально
крап: крапом
оттенок: оттенка
лето: летом
рассчитываться: рассчитывается
поначалу: поначалу
кость: кости
спариваться: спаривались
сеттер: сеттер
всерьёз: всерьез
сегодняшний: сегодняшний
мочь: могут можете
минимум: минимум минимуме
порода: породы порода
конина: конина
хватать: хватает
любитель: любителя любителей
ухо: ушей ушах уши
объявление: объявления
неугомонный: неугомонную
белый: белым белого
хвостик: хвостиком
основной: основные
интеллект: интеллект
охранный: охранные
вес: вес
охотиться: охотиться охотится охотящихся охотились
француз: француз
называться: называется
поощрительный: поощрительный
возить: возить
бег: бега
пара: пар
съедаться: съедается
подлиза: подлиз
именно: именно
полезный: полезные полезная
отсутствовать: отсутствуют
самый: самыми самые
продолжительность: продолжительность
молодой: молодые
сообщать: сообщайте
затылочный: затылочный
считать: считайте
рябчик: рябчиками
поза: позе
эктро: эктро
визг: визгом
подъём: подъем
мышца: мышцами
счёт: счету
следить: следите
блуждать: блуждающий
наблюдать: наблюдайте
дополнять: дополняют
слегка: слегка
тот: те тех
щенок-подросток: щенков-подростков
фото: фото
сходить: сходить
бобовый: бобовых
фенотип: фенотипа
стена: стенах
кончик: кончика
м: м
вы: вами
будущий: будущий
сустав: суставами суставам суставов
яндекс: яндекс
некапризный: некапризная
количество: количество
давать: дают
крестьянство: крестьянства
мясо: мясу мясо
аналогичный: аналогичного
вперёд: вперед
оставлять: оставлять оставляли
хотеть: хотите
конкретный: конкретный конкретные
череп: черепа
тренировочный: тренировочную
поведение: поведением поведение
бретонуть: бретону
бросить: бросьте
холка: холке холкой
вентилироваться: вентилирующиеся
азартность: азартность азартностью
птица: птицу птице птицей
экстерьер: экстерьеру
гетерохромный: гетерохромные
двор: дворе
журнал: журнал
выстраивание: выстраивания
характеризовать: характеризовать
сильный: сильнее
высота: высота
загривок: загривок
месяц: месяца месяцев
подача: подачу
кличка: кличке клички
удивить: удивит
страна: стране страна
подтянутый: подтянутую
повышенный: повышенных
картофель: картофеля
механический: механический
покров: покров
болезнь: болезни
ребёнок: дети
косо: косо
изогнутый: изогнута
совершенно: совершенно
чрезмерно: чрезмерно
либо: либо
решать: решает
активно: активно
образ: образом
доля: доля
вода: воду
охота: охоте охоты охоту
доказывать: доказывать
простой: проще
формирование: формирование
действовать: действующий
изображение: изображения
внимательно: внимательно
терять: теряя
легаш: легаша легашей
укусить: укусить
зверь: зверя
важный: важнейших важных
условие: условий условиях условия
дополнение: дополнения
рассматривать: рассматривать
создавать: создающую
предать: преданного
допустимый: допустимы
кобель: кобели кобелей
встречаться: встречающиеся
плохо: плохо
движение: движения
перекус: перекус
неторопливый: неторопливой
заяц: зайца
бретонец: бретонцем
перейти: перейти
климатический: климатические
постный: постные
неворсистый: неворсистой
каждый: каждом
неспециалист: неспециалиста
из-за: из-за
главное: главное
запрет: запретом
действие: действием
максимум: максимум
бело-чёрный: бело-черный
контакт: контакты
оболочка: оболочки
уголок: уголках
болотно-луговой: болотно-луговой
менее: менее
идти: идут идет
тест: тестов тест
рыжий: рыжих
грудь: груди
состязание: состязаниях
вместо: вместо
ткань: тканью
слишком: слишком
европа: европе
одиночество: одиночеству
будущее: будущего
уделить: уделите
опираться: опираясь
дружелюбие: дружелюбие
оппиан: оппиана
день: день
атрофия: атрофия
пигментировать: пигментированные
подросток: подростков
птичий: птичьи
жильё: жилье
убитый: убитой
грохот: грохот
легашатник: легашатниками
относиться: относился
упоминание: упоминания
сложный: сложнее
гора: горы
смело: смело
отрабатывать: отрабатывать
сообразительность: сообразительностью
правило: правило правила
опустить: опущенным
слабо: слабо
внимание: внимание
ряд: ряды
самолюбивый: самолюбивый
бережный: бережного
прикус: прикуса прикус
ушной: ушного
племенной: племенных
зашкаливать: зашкаливают
стоимость: стоимость стоимости
иначе: иначе
особенно: особенно
воля: волю
строго: строго
устало: устало
гобелен: гобеленах
длина: длина длину
позволять: позволяющих
выход: выходы
предельно: предельно
достаточно: достаточно
обязательно: обязательно
современный: современный современного
хозяин: хозяина
фактор: факторов
аникеев: аникеев
переход: переходе
негатив: негатив
неделя: неделю
мерка: меркам
боковой: боковыми
признать: признаны
англия: англии
несмотря: несмотря
купить: купить
часто: часто
плотный: плотные
азарт: азартом
подпал: подпалом
бороздка: бороздка
поставить: поставлены
длительный: длительное
семья: семье
вопрос: вопросом
первый: первый первая первую
бессмысленно: бессмысленно
экстремальный: экстремальные
наслать: нашли
овальный: овальные
коренастый: коренастом
понимать: понимающий
комочек: комочком
осуществляться: осуществляется
спина: спина
следопыт: следопытом
вывести: выведенная
период: периоды период
свободный: свободном
рождение: рождения
подстраиваться: подстраивается
стол: столу
отвлекать: отвлекающих
галоп: галоп
простудиться: простудился
отработать: отработать
наличие: наличие
семейный: семейный
низкий: низкой
чистый: чистой
крупа: круп
эпилепсия: эпилепсии
выстрел: выстрел выстрела
рыбный: рыбные
похожий: похожими
холод: холода
совокупность: совокупности
одноклассник: одноклассники
кровь: кровь
энергичный: энергичный
скорее: скорее
удовлетворить: удовлетворили
разный: разного
даун: даун
появление: появлению
сам: самому
аристократ: аристократов
дисплазия: дисплазия
мнение: мнение
интересоваться: интересуется
нашествие: нашествием
проходимый: проходим
растение: растений
предок: предках
случайный: случайные
бретоня: бретоне
кроме: кроме
чуткий: чуткого
жестоко: жестоко
выбрасываться: выбрасываются
приказ: приказ
щенячий: щенячьем
поиск: поиск поиска
привести: привело
встреча: встрече
предмет: предметом
зуб: зубы
вообще: вообще
выделяться: выделяющимися
есть: ест
привлекать: привлекать
характер: характер
некоторый: некоторые
оптимальный: оптимальное
учить: учить
помета: помета
выделить: выделенные
лежать: лежать
представить: представлен
сторож: сторожа
зрение: зрения
светлый: светлые
нос: носом нос
сделать: сделано сделает
гонять: гоняет
новый: нового
вписываться: вписывается
гигиенический: гигиенические
потребность: потребность
влиять: влияет
порок: пороки
уметь: умеет
хвост: хвостами хвоста хвост
браконьер: браконьеров
недокус: недокус
жизнь: жизни
рука: руку
смешанный: смешанный
сильно: сильно
едва: едва
дело: дела
легенда: легенды
затем: затем
поэт: поэта
способность: способностями
плечо: плечами
апортировка: апортировке
точка: точке
холостой: холостого
группа: группы
насыщенный: насыщенная
бесхвостый: бесхвостых
переходить: переходит
царить: царили
нужно: нужно
мимимишность: мимимишности
спокойный: спокойной
также: также
греческий: греческого
идеал: идеале
шёрстный: шерстный
любимец: любимца любимец
момент: моменты момент
принудительный: принудительный
принести: принесли
корпус: корпус
стандарт: стандарт
бочкообразность: бочкообразности
удерживать: удерживая
пустой: пустую
дискомфорт: дискомфорт
оставаться: остается
здоровый: здоровое здоровее
высоко: высоко
агрессия: агрессию
автомат: автоматом
тёмный: темный
подходить: подходят
безоговорочно: безоговорочно
книга: книгах книг
складка: складки
задаток: задатки
стоить: стоит
столетие: столетиями
альтернативный: альтернативные
приобрести: приобрел
бумажка: бумажку
прибылой: прибылые
присущий: присущими
зависеть: зависит
вариация: вариации
вернуться: вернулся
перестать: перестанут
заканчиваться: заканчиваются
крупный: крупные
рм: рм
усечь: усеченный
пёс: псами
недуг: недуги
имущество: имущества
убрать: убрать
отвесный: отвесные
начинать: начинайте
пыль: пыль
качество: качества
трусливый: трусливое
чистка: чистки
какой: какую
прочь: прочь
лишаться: лишаетесь
положение: положения
актуальный: актуальную
легко: легко
объём: объема объем
утеплить: утепленную
лента: ленту
производитель: производителей
специальный: специальную
здоровье: здоровье
очёс: очесами
паутина: паутина
детство: детстве
обтекаемый: обтекаемые
мороз: морозы
основательно: основательно
пойменный: пойменных
лицо: лицо
равномерный: равномерные
регулярный: регулярной
тюльпан: тюльпанов
лидерский: лидерские
лошадь: лошадей
спецсредство: спецсредства
наваррский: наваррский
тыльный: тыльной
сопротивляться: сопротивляется
попона: попону
вакансия: вакансии
обратно: обратно
существующий: существующих
специалист: специалисты
скаковой: скаковых
лобный: лобная
далёкий: далеком
гибкий: гибкими
дальнейший: дальнейшем
утро: утро
голень: голени
зрелый: зрелые
выше: выше
четвероногий: четвероногий четвероногого
сорт: сорта
сужаться: сужающиеся
похвала: похвала
вот-вот: вот-вот
мускулистость: мускулистость
печёночный: печеночных
судья: судей
жара: жару
кто: ком
памятливый: памятлив
внезапно: внезапно
добыть: добыть
рыже-белый: рыже-белого
изгиб: изгиб
распространить: распространенные
корм: корма
главный: главная
цениться: ценится
рейтинг: рейтинг
весь: всеми
дефект: дефекты дефектами
проблема: проблем
проход: проход
обновить: обновленного
подписываться: подписывайтесь
купироваться: купируется
разочаровываться: разочаровываться
присутствие: присутствие
самостоятельно: самостоятельно
затягиваться: затягивается
запретить: запрещено
очень: очень
обычно: обычно
всевозможный: всевозможные
отит: отитам
ирландский: ирландский
грубо: грубо
постепенно: постепенно
слуховой: слуховой
совместный: совместное
мочка: мочку
частность: частности
неподтверждённый: неподтвержденное
список: список
труд: трудах
приемлет: приемлет
заметный: заметными
дефицит: дефицита
одновременно: одновременно
провести: проведите
проект: проекте
схватить: схватил
кг: кг
необходимость: необходимости
среднее: среднего
минимальный: минимальная
линька: линька
дистанция: дистанции
рф: рф
подопечный: подопечного
жёсткий: жесткие
кормление: кормления кормление
вариант: варианты
причём: причем
шкодливый: шкодливую
косой: косые
ширина: ширина
конус: конус
трофей: трофей
сила: силе
сезон: сезона
возраст: возрасте
случай: случае
несанкционированный: несанкционированных
ребро: ребер
подчинённый: подчиненное
ранний: раннее
мускулистый: мускулистые
луг: лугах
гораздо: гораздо
параллельный: параллельными
гуща: гуще
известность: известности
побег: побегов
