портильо: портильо
иметь: имели имеет имеют
раскрытый: раскрытыми
ситуация: ситуациях
противник: противника
тело: тела телу
широко: широко
средний: средняя средних средней средний
отвечать: отвечать
защита: защиту защиты защите
скот: скота скот
активный: активные активная активную
красный: красный
сколько: сколько
своевременный: своевременной
ранний: ранней ранняя раньше
обида: обиду
уходить: уходит
предоставить: предоставить предоставили
название: название
домой: домой
прошлое: прошлое
собака: собаку собакой собак собака собаке собаки
вывести: вывести
обсуждение: обсуждения
агрессия: агрессии агрессию
ваш: вашему вашей ваш вашего вашем
сочленение: сочленений
цена: цена цене
рыба: рыбу
путешествовать: путешествовал
выжть: выжла
псиный: псины
подушечка: подушечки подушечек
мастиф: мастифы мастифа мастифами мастиф мастифом мастифов
материал: материалов
испания: испания испании
казаться: кажется кажутся
обнажить: обнажена
отбор: отбору
трусость: трусости
злоупотребление: злоупотребление
широкий: широкого широкие широким широкую широкая
известный: известными
обременить: обременены
сакариес: сакариеса
стоять: стоят
внимательность: внимательность
сторона: стороны сторон
испанец: испанцы испанца испанец испанцем испанцев
инстинкт: инстинкты
положительный: положительных
волков: волков
насадка: насадка
россия: россия
живот: живот
морда: морде морду морда
раковина: раковины
миска: миска
обратный: обратная
маленький: маленьким маленьких меньше
длительный: длительные
атака: атака атаку
размер: размеров размеры размерами размер
представитель: представителей представитель представители
соответствовать: соответствует
команда: команду команд команда
шея: шея шее
волос: волосом
гражданский: гражданская
отмечать: отмечают
русский: русскому
шерсть: шерсть
низкий: низкий низкая
выразить: выражены
кальций: кальция
крупа: крупа круп
качество: качеств качестве качества
челюсть: челюсти
моляр: моляров моляры
должный: должны должен должна
самый: самая самых
килограммовый: килограммовой
идт: идт
содержать: содержать
колоссальный: колоссальная
взгляд: взгляд
исключение: исключение
сторож: сторож сторожа
скучать: скучающее
центр: центру
долголетие: долголетия
человек: людям человеке людей человек
пастуший: пастушья
относиться: относится относятся
месяц: месяц месяцы месяца месяцев
сверху: сверху
безоговорочный: безоговорочный
подвергать: подвергали
спустя: спустя
теория: теория
выраженный: выражен выраженной
длинноногость: длинноногость
верный: верный верным
важно: важно
упругий: упругие
душа: душе
история: история
кинологический: кинологических
щенок: щенка щенки щенок щенками
худоба: худоба
гарантировать: гарантированы
питомец: питомцев питомец питомцы питомца
вычсываться: вычсываются вычсывается
чувствовать: чувствуют чувствуете чувствовал
тплый: тплой
семья: семьи семью
половой: полового
парикмахерский: парикмахерскую
стрижка: стрижкой
ширина: ширине
характеристика: характеристика характеристики
быть: е будь
стоп: стоп
исключить: исключите
римский: римский
чрный: чрный чрную
дом: дому
предать: преданным преданном
около: около
год: годы годах года лет году
камень: камня
компаньон: компаньоне
залог: залог залоге
слизистый: слизистых слизистые слизистая
купец: купцами
коготь: когти когтями
унаследовать: унаследовали
значит: значит
стать: стала станут стали стал станет
палец: пальцы палец
яичко: яичек
сужаться: сужается
основное: основном
еда: еду
удаться: удалось
состояться: состоялось состоялась
раз: раза
видео: видео
помимо: помимо
вторжение: вторжения
беспокойно: беспокойно
защитить: защитить
участвовать: участвуя
психический: психическое
меню: меню
полностью: полностью
возможный: возможные
компания: компании компанией
скотовод: скотоводов скотоводы
домашний: домашних
смелость: смелость
эффектный: эффектные
наследник: наследники
последний: последняя
рацион: рациона рацион
вынужденный: вынужденному
опустить: опущена
нависать: нависает
речь: речь
трхлетний: трхлетнего
содержание: содержание содержанием содержания
чреватый: чревата
собственный: собственного
щека: щекам
обращать: обращали
повествование: повествование
важный: важен важным важна
экзема: экземе
регистрация: регистрация
плодотворный: плодотворном
мощный: мощный мощная мощные
составлять: составляет составлять
ноздря: ноздрями
оставаться: остаются оставались
эль: эль
пирамида: пирамиды
предел: пределы пределах
подобрать: подобранный
подвес: подвес
специальный: специальная специальным специальный
ушной: ушные
территория: территорию территории
численность: численностью численности
родитель: родителях
связь: связь
приподниматься: приподнимаются приподнимается
угол: углом углы угол
отличный: отличной отличные
вода: воде водой
ворчание: ворчанием
внешность: внешность внешностью
признать: признает
количество: количествах
прижать: прижатые
мягкий: мягкой мягком мягкого
лоб: лба лоб
владелец: владельцев владельцы
длина: длине длины длина
характерный: характерного характерна
прослеживаться: прослеживается
пастух: пастухами пастухам
войдт: войдт
намного: намного
пока: пока
флегматичный: флегматичные
чувство: чувства чувство
от: ото
сводистый: сводистые
полный: полная
состояние: состоянии
внешний: внешние внешнее внешних внешний
подойдт: подойдт
чрезмерный: чрезмерную
забор: забор
собачий: собачьего собачьи собачьем
яйцо: яйца
невозможный: невозможны
дважды: дважды
мир: мир мире мира
дальнейший: дальнейшему дальнейшей
наполнить: наполнена
ночь: ночам
катаракт: катаракте
трудолюбивый: трудолюбивыми
шарпланинский: шарпланинскими
выставка: выставки
наружный: наружных
попасться: попавшегося
плотно: плотно
кинолог: кинологам
причина: причина причиной
формировать: формируют формирует формируя
смотреть: см
друг: друзья друг другом друга другу
превышать: превышает
коренастость: коренастость
фотография: фотографии
работать: работать
уход: уходе уход
чтко: чтко
создание: создания
больший: наибольшую больших большей
губа: губа
сокращение: сокращения
вариант: вариантов вариант
высокий: высокая высоким высокий
питомник: питомники питомников питомник
верхний: верхней верхняя
конъюнктив: конъюнктиву
наслаждаться: наслаждаться
глаз: глаза глаз
квадратный: квадратной квадратную
ахилловый: ахиллово
щтка: щтка
порок: порокам пороки
гол: голов
часть: части
участник: участник участников
профилактика: профилактики
век: века
лояльный: лояльным
вести: вести
право: праву
буквально: буквально
дрожжевой: дрожжевого
реакция: реакция
поскольку: поскольку
охотничий: охотничьи
формула: формула
краткий: краткая
обзавестись: обзавестись
недостаточный: недостаточная недостаточным
долгий: долгое долгие
свой: своими свой своего своей своих свои
сильный: сильная сильнее сильные
появление: появлением
заноситься: заносятся
литературный: литературное
отношение: отношение отношению
заболевание: заболеваниям
формироваться: формироваться
место: место
завязаться: завяжется
приводить: приводит
край: края
отметить: отметить
эксперт: экспертов
направить: направлены направит
высота: высоте высота
купание: купании
вконтакте: вконтакте
версия: версии
создать: создать
шрстный: шрстный
желать: желающие желающим желая
переход: переход
видный: виден
тазобедренный: тазобедренных
ярко: ярко
обращение: обращения
роль: роль
проявлять: проявлять
далкий: далких
веселить: веселить
туловище: туловища туловищем
связывать: связывает
животное: животных животным животного животными животные животное
один: одного одна одной одну
старый: старая
земля: земле
лидер: лидер лидере
продемонстрировать: продемонстрирует
спокойный: спокойным спокойные
выбрать: выбрать
экземпляр: экземпляров
копчность: копчности
свисать: свисает
оба: обеих обоих
мясистый: мясистые
изделие: изделия
отполировать: отполировать
основать: основана
тибетский: тибетскими
хотя: хотя
прогулка: прогулками прогулки прогулок
охранник: охранника
подкоп: подкоп
х: х
игрушка: игрушками игрушки
усилие: усилиями
манер: манер
самостоятельность: самостоятельность
менять: менять
незначительный: незначительные
земледелие: земледелии
ворс: ворса
программа: программу
форма: форму
нянька: нянька няньки
порода: породам породы пород породу порода
веко: веко веки
полость: полостью
угощение: угощением
информация: информация информацию
подходить: подходит
поставить: поставлена поставлены
послушный: послушного
масса: масса массу
скосить: скошенный
сво: сво
сустав: суставы суставов
надеяться: надеяться
независимость: независимостью
мочь: могли могут можете
спинка: спинка
интуиция: интуицию
авторитет: авторитет
ниже: ниже
пегий: пегий
окрас: окрас окрасы
такой: такое
малый: малейшей
крепкий: крепкие крепкое крепче крепкий крепкая крепкого
депигментация: депигментацию
прятаться: прятаться
гармоничный: гармоничны
протянуть: протянутой
сухой: сухой сухие
дикий: диких
ребёнок: детям детей детьми
габарит: габариты габаритам
среди: среди
число: число числу числе
превосходить: превосходит
любой: любое любых любом
кризис: кризис
лапа: лапах лапы лап
это: этим это
выпас: выпаса
новый: новых новую новыми нового
лучезапястный: лучезапястные
длинный: длинные длинную длинным длинная
считаться: считается
пушистый: пушистым пушистые пушистого
новичок: новичков
рабочий: рабочих рабочие
находиться: находится
виляние: вилянием
психологически: психологически
терпимо: терпимо
контакт: контакте
рука: руки
колтунорез: колтунорезом
вырасти: вырастет
кишка: кишок
размягчить: размягчит
соболиный: соболиный
исполнять: исполняли
усечнной: усечнной
провинция: провинции
учитывать: учитывая
обратить: обратить
вперд: вперд
нападение: нападения
угроза: угрозы угроза угрозу
молочный: молочные
считать: считают
вмешательство: вмешательства
добавить: добавьте
хороший: лучший лучшее хорошее
ореховый: ореховый
социализация: социализацию социализация социализации
справедливый: справедливом
холка: холка холке
пьеть: пьето
умеренный: умеренная
происхождение: происхождения
зуб: зубьями зубы зубов
профессиональный: профессиональные профессиональным
резкий: резкий
резец: резцы
необходимо: необходимо
ломать: ломать
первый: первые первое первого первый первая первую
исторически: исторически
пища: пищи пищу
охотный: охотнее
задний: задние задних задними
бдра: бдра
покрывать: покрывает
редкий: реже редкими
черта: черты
вакцинация: вакцинации
кавказский: кавказскими
тщательно: тщательно
пройдт: пройдт
деятельность: деятельность
оставлять: оставляйте
дрессировка: дрессировка дрессировки
предплечье: предплечья
время: время времени
сука: суки сук
испачкаться: испачкался
агрессивность: агрессивность
слово: слову
требовать: требует
день: дней день
настоять: настоянной
чей-то: чьих-то
закрытый: закрытый
противный: противном
пясть: пясти пястей
сила: сила силы силой
задолго: задолго
деревянный: деревянная
параллельно: параллельно
русло: русло
красочный: красочное
знакомство: знакомстве
сказаться: сказались
заострнный: заострнную
грозить: грозит
рост: рост
голова: головы голова
вверить: вверенной
манало: манало
нерешительный: нерешительном
обладатель: обладатель
гриб: грибы
вне: вне
изучать: изучал
совет: советы
реклама: реклама
получить: получите
плоский: плоский
пропорциональный: пропорциональный
выделять: выделяют
испанский: испанскую испанских испанские испанскими испанского испанским испанский
грызун: грызуны
дисквалифицировать: дисквалифицирующим
затруднительный: затруднителен
мускулатура: мускулатурой мускулатура мускулатуру
карлос: карлос
второй: второй вторая
ум: умом
процедура: процедуру процедуры процедурами
рекомендоваться: рекомендуется
привлекать: привлекали
мочка: мочки мочке мочку
спокойно: спокойно
получиться: получится
проблема: проблемами проблем проблемой
воспитание: воспитание воспитании воспитанию
укрепить: укрепит
атаковать: атаковать
обнаружить: обнаружите
малыш: малыш малыши
последовать: последовавший
заячий: заячьи
плачевно: плачевно
кофеин: кофеином
изучение: изучении
руководство: руководством
сайт: сайту
родословная: родословной
следствие: следствие
выпуклый: выпуклым выпуклую
вычсывания: вычсывании
позволять: позволяет позволяя
получаться: получаются
конечность: конечностями конечности
внутренний: внутренних
картофель: картофель
дорогой: дорогое дороже
крупный: крупная крупных крупнейших
кожа: кожа
купировать: купированные
этот: эта этих
лишь: лишь
соотношение: соотношении
медведь: медведей
опытный: опытные
соперничать: соперничать соперничают
половина: половиной
включить: включите
форум: форум форуме
заворот: завороту
нести: несут
убегать: убегают убегать
единолично: единолично
игрушка-грызунка: игрушками-грызунками
обсохнуть: обсохнет
желза: желз
наш: нашей
положение: положение
гигант: гиганта
член: членам
расставить: расставить
корректный: корректное
начинающий: начинающий
окончательный: окончательный
пигментировать: пигментирована
двойной: двойной
играть: играли
амодель: амодель
напротив: напротив
признак: признак
описание: описание
той-терьер: той-терьеру
руина: руины
разработать: разработал
начало: начало начале
слабый: слабее слабые
налта: налта
эрминьо: эрминьо
декоративный: декоративные
алехандро: алехандро
жестокий: жестокого
здоровье: здоровьем здоровья здоровье
найти: найти
зубной: зубного зубная
однако: однако
огромный: огромные огромным
дель: дель
внушительный: внушительные
иноходь: иноходь
отличаться: отличаются
преданность: преданность
обработка: обработка
поэтому: поэтому
пилочка: пилочка
близкий: близком ближе ближайший
случай: случаев случаях случае
копирование: копирование
дружелюбный: дружелюбная
победа: победу
предупреждение: предупреждение
прекрасно: прекрасно
активность: активность
подверженный: подвержены
существовать: существует
основание: основания основанием
списывать: списывать
дружелюбность: дружелюбность
плавно: плавно
иммунитет: иммунитет
отзыв: отзывах отзывы
освежить: освежит
десятка: десяток
настоящий: настоящая
кошка: кошки кошками
одерживать: одерживает
отвар: отвар
хлопоты: хлопот
животный: животному
поясница: поясницы поясницу
шум: шум
физический: физическое
продиться: продатся
висячий: висячие
постав: поставом постав
тврдуть: тврдую
сквозняк: сквозняков
лишний: лишних
пах: паха
прямой: прямая прямые прямой
тврдый: тврдые
густой: густая
местность: местность
придться: придтся
мачако: мачако
погрызт: погрызт
назад: назад
кандидатура: кандидатура
цвет: цвет
кость: кости
сегодняшний: сегодняшний
локоть: локти локтями
игра: играх игры
пищеварительный: пищеварительной
возраст: возрастом возраста возрасте
другой: других другими
маршрут: маршрут
груз: грузом
видеть: видеть
ухо: ушей ушах уши
римлянин: римлян
объявление: объявления
предпочтительный: предпочтительны
основной: основные
упитанность: упитанность
полова: половой
поэма: поэма
какой: каким
интеллект: интеллект
охранный: охранные
вес: вес
уважение: уважение уважения
спина: спину спины спина
виднеться: виднеются
подрастить: подрасти
конец: конец
нос: носа нос
перегон: перегона перегонов
неподходящий: неподходящая
именно: именно
полезный: полезные
таскон: таскона
отклонение: отклонения
рот: рта
проворный: проворны проворная
третий: третьего
попытка: попытках
регламентировать: регламентирован
холодное: холодное
добродушный: добродушный
продолжительность: продолжительность
курс: курс
межпальцевый: межпальцевые
острый: острые
отлично: отлично
рыхлый: рыхлую
приоритет: приоритеты
линия: линия линий линии
пёс: пес
щенокиспанскогомастиф: щенокиспанскогомастифа
принадлежать: принадлежит
самец: самцы
расположить: расположены
входить: входит
сезонный: сезонной
шампунь: шампунь
навязывать: навязывает
зависимость: зависимости
несколько: нескольких
подход: подход
принимать: принимать
слегка: слегка
возражать: возражает
нелюдимый: нелюдимым
самка: самок
бутилировать: бутилированной
посторонний: посторонним
строгий: строгому
фото: фото
питание: питание
насторожить: насторожена
вы: вами
регулярный: регулярном регулярная
коровий: коровью
наказание: наказаний
комбинация: комбинация комбинации
яндекс: яндекс
почувствовать: почувствовав
затаить: затаит
раскошелиться: раскошелиться
цитрусовый: цитрусовые
нижний: нижнее нижней
ребнка: ребнка ребнку
кто: кого
череп: черепа череп
отвисать: отвисает
нрав: нрав
сравнение: сравнении
овчарка: овчарками
собрать: собраны
рык: рык
относить: относят
сухожилие: сухожилие
премиум-класс: премиум-класса
журнал: журнал
поглаживание: поглаживанием
привязь: привязи
кличка: кличке клички
делать: делать
диван: диван
виноградарство: виноградарстве
нуждаться: нуждаются нуждаетесь нуждается
уголок: уголков уголках
эластичный: эластичная
тот: та тех
разведнный: разведнным
атмосфера: атмосфера
уживаться: уживаются
покров: покров покровы
обеспечить: обеспечьте
болезнь: болезни
трепетный: трепетная трепетные
косо: косо
карман: карманы
кария: карий
чрезмерно: чрезмерно
клык: клыков клыки
добыча: добычи
пятно: пятен
предплюсна: предплюсны
птичий: птичьего
белый: белого
напиток: напитки
оценивать: оценивая
подсказать: подскажет
четвероногий: четвероногую четвероногом
тяжесть: тяжести
гулять: гуляйте
счастливчик: счастливчиком
величественный: величественные
ринуться: ринется
признание: признание
комната: комнате
ночью: ночью
аденома: аденоме
безграничный: безграничную
наклонный: наклонный наклонные
хватать: хватать
гонартроз: гонартрозу
селекция: селекции
овца: овец
тяжлай: тяжлая
прилегать: прилегает прилегают
нагрузка: нагрузке
смазывание: смазывания
кроткий: кротком
допустимый: допустимы
присущий: присуща
корпус: корпуса корпус
кобель: кобели кобелей кобель
движение: движения движении
скакательный: скакательные скакательных
перекус: перекус
общество: обществом обществе общество
условие: условиях условие условия
подойти: подойти
сородич: сородичами сородич
обостряться: обостряются
диморфизм: диморфизм
защитник: защитника
стремительный: стремительная
глубина: глубину
нужный: нужен
наклоняться: наклоняются
перейти: перейти
банный: банным
обозначить: обозначена
главное: главное
соперник: соперника
соласа: солас
который: которая которые который
закончиться: закончиться
фурминатор: фурминатор
менее: менее
показать: покажут
закинуть: закинутый
определять: определяет
причинить: причинить
дефект: дефектов
тест: теста
сведение: сведения
потенциал: потенциал
цель: целью целей
костяк: костяк
корень: корнями
ножка: ножку
отсутствие: отсутствие
ткань: тканью
испанскиймастиф: испанскиймастиф
одиночество: одиночеству
гипертрофирование: гипертрофированием
развить: развита развитая
ограничиться: ограничьтесь
комок: комок
лисий: лисью
расценить: расценить
отвага: отвагу
забыть: забыть
образование: образованию
письменный: письменного
дидактический: дидактическая
веслой: веслой
волчий: волчий
гигиена: гигиена
интерес: интересах
эктропий: эктропию
тёмный: темнее
некрупный: некрупные
путаться: путаются
мускулистый: мускулистая
неуравновешенный: неуравновешенный
небольшой: небольшие небольшими
опекать: опекая
необходимый: необходимую
прямоугольный: прямоугольного
оценка: оценке
помогать: помогающая
появиться: появился появились
рубль: рублей
положиться: положитесь
птица: птицы
золотистый: золотистому
обходиться: обходясь обходятся
круг: кругу
развлечь: развлечь
разведение: разведения
беспокойство: беспокойства
неплохо: неплохо
трх: трх
слабо: слабо
отара: отарой
колея: колеи
внимание: внимание внимании
наличие: наличии
подчркнут: подчркнут
варьироваться: варьируется
тысяча: тысячу
развитой: развиты
каждый: каждый
здоровый: здоровые
отрицательно: отрицательно
чеснок: чеснок
скрывать: скрывает
сон: сны
стоимость: стоимость
приобрести: приобрести
иначе: иначе
особенно: особенно
отменный: отменный
австралийский: австралийская
отметина: отметины
сочтта: сочтт
использовать: использовали
промакиваться: промакиваются
строго: строго
древность: древность
час: часов
организация: организаций
достаточно: достаточно
подтянутый: подтянуты
повышенный: повышенное
международный: международной
хозяин: хозяина
обязательный: обязательное обязательна
слаборазвитый: слаборазвитый
кабанов: кабанов
расположение: расположение
редко: редко
генетика: генетикой
аффенпинчер: аффенпинчер
когтереза: когтерез
охранять: охраняя
неделя: неделю
переходить: переходят переходит
отходить: отходят
днм: днм
пять: пять
заниматься: занимаются
несмотря: несмотря
сладость: сладости
закрепляться: закреплялась
купить: купить
подопечный: подопечных
облегчать: облегчают
скотоводство: скотоводстве
натуральный: натуральную
эра: эры
бльшать: бльшая
пожилой: пожилым
альф: альфы
масло: маслом
профиль: профилем
укорачивать: укорачивать
гость: гостей
упоминание: упоминание
понадобиться: понадобятся
свежий: свежем
что: чему
период: периоды период
кончик: кончики кончику
предок: предки предков предка
пиренейский: пиренейский
попросить: попросить
накаляться: накаляется
ласковый: ласковым
демонстрировать: демонстрирует
полуостров: полуостров
порадовать: порадуйте
паразит: паразитов
леон: леон
адрес: адрес
начать: начал
сохранять: сохраняют сохраняет
поощрение: поощрение
ромашка: ромашки
водный: водными
мальтийский: мальтийская
заслуживать: заслуживают
мартинеда: мартинеда
миндалевидный: миндалевидную
агрессивный: агрессивным
сертифицированный: сертифицированный
самоотверженность: самоотверженность
чистый: чистой чистый
непроизвольно: непроизвольно
уверенность: уверенность уверенностью
меланхоличный: меланхоличным
сырой: сырое
восхищать: восхищают
строгость: строгость
одноклассник: одноклассники
удержание: удержание
кожный: кожные кожных
прислать: пришли
лосьон: лосьон
волосок: волоски
подержать: подержать
скорость: скорость
близкие: близким
сходство: сходство
против: против
грудь: грудь
случайный: случайные
передний: передние
сабля: сабли
ведт: ведт
мясо: мясо
закрепить: закреплена
выступить: выступить
треугольник: треугольника
олений: олений
испытывать: испытывают
тратить: тратит
сопровождение: сопровождения
частый: чаще почаще
подшрсток: подшрсток
поиск: поиск поисках
захват: захват
общий: общего
слышный: слышно
молосский: молосским
идеальный: идеальный идеальная
отклонить: отклонены
вершина: вершиной
выбирать: выбирают
раскосый: раскосые
молосса: молоссы
прародитель: прародителями
характер: характер
существование: существовании
партнр: партнр
официальный: официальное официальных
помощь: помощь
выглядеть: выглядят выглядит
веслый: веслые
ротовой: ротовой
лежать: лежать
короткий: короткая короткими
орех: орехи
обратиться: обратитесь
светлый: светлые
дисплазия: дисплазии
сугубо: сугубо
сделать: сделано
родственник: родственниками
присмотреться: присмотритесь
пребывание: пребывание
колтун: колтуны
потребность: потребность
периодически: периодически
влиять: влияет
вред: вред
хозяйский: хозяйского
пудель: пуделю
средство: средство средством
воспользоваться: воспользоваться
пристроить: пристроят
недокус: недокус
луис: луиса
кочевник: кочевниками
линька: линьки линька
элегантный: элегантные
жизнь: жизни
современный: современных
воспринимать: воспринимает
забывать: забывайте
отказаться: отказаться
говорить: говорить
благодаря: благодаря
уйти: уйти
искренний: искреннего
щенкииспанскогомастиф: щенкииспанскогомастифа
система: системой
облегчение: облегчения
вид: виде вид
плечо: плечи
пространство: пространства
служить: служит
запах: запаха
премоляр: премоляров премоляры
вспомогательный: вспомогательным
молоссова: молоссов
привязать: привязаны
обеспечивать: обеспечивает
война: война
желудок: желудка
нужно: нужно
мимимишность: мимимишности
поймт: поймт
урбанизация: урбанизация
азия: азии
вызывать: вызывают
также: также
обзаведтесь: обзаведтесь
умный: умная
настроение: настроение
лук: лук
любопытный: любопытным
покупка: покупки
любимец: любимца
превосходный: превосходным
момент: моменты
окружающий: окружающих
игривый: игривым
звание: звания
уплощить: уплощены
пуходрка: пуходрка
свирепый: свирепый
выходить: выходит
окантовка: окантовку
угрюмый: угрюмого
стандарт: стандарт
заметный: заметны
вергилий: вергилия
расчска: расчска
мадрид: мадриде
элемент: элементом
продолжать: продолжали продолжают
однотонный: однотонные
плюшевый: плюшевые
умеренно: умеренно
вернуться: вернувшись
пользоваться: пользовались
определнный: определнным
высоко: высоко
образовать: образуют
уравновешенность: уравновешенность
радостный: радостным
смочь: смогут
ошейник: ошейника
наблюдательность: наблюдательность
сложно: сложно
крайне: крайне
сдержать: сдержанный
стоить: стоит
сторожевой: сторожевые
массивный: массивные
ласка: ласку
брыть: брыли
нервозность: нервозности
прибылой: прибылые
привлекательный: привлекательной
ножницеобразный: ножницеобразный
трудный: трудная
стадо: стадо
образоваться: образуются
выбор: выбору
заканчиваться: заканчиваются
спреть: спреем
равновесие: равновесия
несправедливый: несправедливых
любить: любят
недолго: недолго
параллельный: параллельным
предупредительный: предупредительный
отвесный: отвесные
умение: умения
стол: стола
легко: легко
выносливость: выносливость
идеально: идеально
манера: манера
рынок: рынка
сохранить: сохранить
лента: ленту
металлический: металлическая
импровизированный: импровизированной
словно: словно
смачивать: смачивают
основа: основу
отчтливый: отчтливо
тип: типа
специалист: специалиста
заоблачный: заоблачную
лай: лай лаем
альтернатива: альтернативы
воздух: воздухе
проявить: проявит
визуально: визуально
патологический: патологических
покачивание: покачиваний
вакансия: вакансии
прямо: прямо
продукт: продукты
покой: покоя
прикус: прикус
нездоровый: нездоров
питомникиспанскихмастиф: питомникиспанскихмастифов
крик: крики
выделение: выделений
инструмент: инструментов
украсить: украшены
поступь: поступь
рысь: рысь
достоинство: достоинства
голень: голени
выше: выше
вихляние: вихляние
заводчик: заводчика
большинство: большинстве
селекционер: селекционер
вместе: вместе
течение: течение
научиться: научиться
затылок: затылке
горизонтальный: горизонтальное
счёт: счетов
четырхлетний: четырхлетнего
корм: корма
обнажать: обнажая
душевный: душевного
главный: главная
встать: встанет
рейтинг: рейтинг
последовательный: последовательным
похвастать: похвастать
хищник: хищников
мышца: мышцы
треть: трети
подписываться: подписывайтесь
ценить: ценили
геракл: гераклов
мопс: мопсу
человеческий: человеческом
перевернт: перевернт
запустить: запущенных
датироваться: датировалось
хвост: хвоста хвост
окружение: окружении
наградить: наградите
запретить: запрещено
очень: очень
всевозможный: всевозможные
горбатый: горбатую
вели: вели
бок: бокам
тврдость: тврдость
энтропия: энтропию
нога: ногах
конфликт: конфликта
демонстрация: демонстрация
правило: правила
довольно: довольно
прежде: прежде
удаление: удаления
касаться: касается
ретривер: ретриверу
подвергаться: подвергаются
проект: проекте
властелин: властелином
пора: пор
кг: кг
необходимость: необходимости
заинтересовать: заинтересованы
втирание: втирания
правильный: правильное
минимальный: минимальная
развитие: развитием
страна: страна
темперамент: темперамент
волнистый: волнистую
окрепнуть: окрепшим
встречать: встречает
забрасываться: забрасывается
стая: стае
наедине: наедине
робость: робость
ответственный: ответственном
ненамного: ненамного
венгерский: венгерская
тонко: тонко
георгик: георгика
глазок: глазки
плюсна: плюсны
дружба: дружба
закруглнный: закруглнной
вольер: вольер
бугор: бугор
раздвоить: раздвоенную
превращаться: превращаются
сложиться: сложился
питательный: питательным
собаковод: собаковод
болонка: болонка
пинотар: пинотара
основный: основных
жлтый: жлтый
скромный: скромные
способный: способны
проигнорировать: проигнорирует
г: г
неопущение: неопущение
финикийский: финикийскими
кондиционер: кондиционером
