живот: животе живот
уход: уход уходе
охотничий: охотничья охотничьими охотничьи
гигиенический: гигиеническим
ценовый: ценовые
бэрд: бэрд
предположительный: предположительный
забирать: забирать
пёс: пес
питание: питанию
овощ: овощи
потенциал: потенциалом
поиск: поиск поиску
кость: костями
отличный: отличное
шерсть: шерсти шерсть шерстью
пробираться: пробираться
тело: тела теле
определить: определено
готовиться: готовлюсь
маленький: маленькое
стоячий: стоячими
объединяться: объединялась
средний: средняя среднее
интересный: интересный интересными
поза: позе
тазобедренный: тазобедренного
контактный: контактные
зуб: зубы зубов
проблема: проблемы
подвиг: подвигов
расположить: расположены расположена
оттенок: оттенок
время: времен время
свободно: свободно
густо: густо
расти: растет
познакомиться: познакомиться познакомились
собака: собака собакам собаке собакой собак собаки
выстрел: выстрела
следить: следить
цвет: цвета
беспощадный: беспощаден
выбирать: выбирают
сколько: сколько
волосок: волосков
соплеменник: соплеменниками
свой: своей своего свои своим
полотно: полотно
линия: линий линию линиях
страсть: страсть
приезд: приезду
манчестер: манчестера
характер: характер характера
название: название названием
квартира: квартире
опыт: опыта
злобный: злобен
жесткошёрстный: жесткошерстными жесткошерстные жесткошерстных
образовать: образует
округлый: округлой
подход: подход
нора: нору норе
белый: белыми белый
нерезкий: нерезкая
черно-подпалый: черно-подпалый
сырой: сырым
присутствовать: присутствуют
фоксикидевочка: фоксикидевочка
влажный: влажным
информация: информация
переезд: переезда
охотник: охотник охотники
вельштерьер: вельштерьер
дополнять: дополняют
слегка: слегка
получить: получило
состоять: состоит
стабильный: стабильную
ходьба: ходьбе
здравствуйте: здравствуйте
фокстерьер: фокстерьеров фокстерьера фокстерьер фокстерьером фокстерьеры фокстерьерами
послушный: послушного
расчёт: расчет
обсуждение: обсуждения
отношение: отношениях отношение
максимально: максимально
создание: создание
оставаться: оставаться
подозрительность: подозрительность
год: год лет годах
остров: островах
обитать: обитали
цена: цена
фото: фото
бигль: биглями
грейхаунд: грейхаунда
сустав: суставы сустава
обращаться: обращаться
палец: пальцами
лежать: лежать
короткий: короткая короткой короткие короткий
общение: общении
щётка: щеткой
прогулка: прогулку прогулке
позитив: позитив
светлый: светлые светлую
инициатор: инициатором
лисёнок: лисят
тот: той
осуществить: осуществили
сначала: сначала
скула: скул скулы
сосед: соседи
разнообразный: разнообразными
сука: сука суки
генетический: генетические
дополнительно: дополнительно
сделать: сделано сделать
игра: игры играх
остальной: остальных остальные
природа: природы
выбор: выбор
самый: самое самый
материал: материалов
эктопия: эктопия
животное: животного животное животным животных
потребность: потребность
секретиковый: секретиков
неутомимый: неутомимый
окрас: окрас окраса
бело-рыжий: бело-рыжий
лис: лис
порок: пороки
натаскивать: натаскивать
путешественник: путешественник
курс: курса курсе
коммуникабельный: коммуникабельный
английский: английским английские
такой: такое таком таких
ушной: ушное ушной
идеальный: идеальные
дефект: дефект
спокойный: спокойное
давать: дают давать
россия: россии россия
сухой: сухой сухие сухая
грызун: грызунов
бело-чёрный: бело-черной бело-черный
ребёнок: детям
жизнь: жизни
натаска: натаска натаску
разновидность: разновидностью
два: двух
кончик: кончик
старший: постарше
силиконовый: силиконовой
стоять: стоят
среди: среди
кто: кого
вперёд: вперед
резиновый: резиновые
сторона: стороны стороне сторону
выдающийся: выдающиеся
подстригать: подстригают
дисквалифицировать: дисквалифицирующие
череп: черепа череп
фокс: фокс фоксу фоксы
ухо: уха ушами уши ушей
сильно: сильно
пятно: пятнами пятен
подушечка: подушечками
приятный: приятной
веселие: веселье
процедура: процедурам
подсолнечный: подсолнечного
это: этим это
питомник: питомника питомников питомники
полярный: полярный
лапа: лапы
который: которых которого которым которые которыми которой
ограниченный: ограниченного
фрисби: фрисби
холка: холке
хороший: лучшее хорошей
обратный: обратная
бесконтрольно: бесконтрольно
здоровье: здоровью здоровье здоровья
великобритания: великобритании великобритания
вид: виде
застенчивый: застенчивыми
начинать: начинают
эмоциональный: эмоциональны
видеть: видит
журнал: журнал
поведение: поведении
учёт: учетом
пространство: пространства
земля: землей земле
рекомендация: рекомендаций рекомендации
представитель: представителей представителями представители
группа: группы
искать: искать
рабочий: рабочих рабочие рабочий
перекусомнедокус: перекусомнедокусом
высота: высота
охранник: охранник
загривок: загривок
попробовать: попробовать
месяц: месяца месяцев
шея: шея
четырежды: четырежды
разучивание: разучивания
противопоказание: противопоказаний
язык: языках
привязь: привязи
сайт: сайтах сайту
развитой: развитым
кличка: кличке клички
просто: просто
компаньон: компаньон
обучение: обучение
предстоять: предстоит
нужно: нужно
мимимишность: мимимишности
брутальный: брутально
позиция: позиции
британский: британских
постав: постав
пара: паре парой
один: одним одну одной одном одна
корень: корни
угс: угс
умный: умная умный
челюсть: челюсти челюстях
сажать: сажают
пятнистый: пятнистый
должный: должны должна должно должном должен
уживаться: уживаются
тип: тип типу
прилегать: прилегающей
смыкаться: смыкаются
весёлость: веселостью
заменять: заменять
болезнь: болезни болезнь
нарушение: нарушения
момент: моменты момента момент
угадываться: угадываются
взгляд: взгляд
выключаться: выключается
внутри: внутри
шрам: шрамы
фрукт: фрукты
кормить: кормят
белок: белок
дисквалифицироваться: дисквалифицируются
утолщаться: утолщается
гладкий: гладкий
клеймо: клеймом
низкий: низкая
светопреставление: светопреставление
отзыв: отзывы отзывах
хрупкий: хрупких
мария: мария
чёрный: черные
охота: охотой охоте охоты
совершенно: совершенно
вывести: выведена
чрезмерно: чрезмерно
территория: территории
неприятный: неприятным
висячий: висячими
зона: зоны зоне
либо: либо
запечатлеть: запечатлен
охотиться: охотится охотящихся
побег: побегам побегов
требование: требование
рыба: рыбой
владелец: владельцем владельцы владельца владельцев владельцу
корпус: корпус
добавить: добавьте
молодой: молодой
чистка: чистка
некоторый: некоторых
норный: норные
спустя: спустя
одинаковый: одинаковой
равно: равно
стандарт: стандарт
самоочищающийся: самоочищающаяся
мытьё: мытьем
масть: масти
поясница: поясница
мусор: мусор
плечо: плечам
гладкошёрстный: гладкошерстный гладкошерстному гладкошерстные гладкошерстного гладкошерстных
отличаться: отличается отличаться
атопический: атопические
будущий: будущих
выраженный: выражен
сердечно-сосудистый: сердечно-сосудистой
отлов: отлова
шоу-звезда: шоу-звезды
сузить: суженная
умеренный: умеренная умеренным умеренное
происхождение: происхождения
заболевание: заболевания
шоу-класс: шоу-классу
важно: важно
список: списках
небольшой: небольшое небольшие
неопытный: неопытных
резец: резцы
необходимо: необходимо
вечный: вечным
травма: травмы травмой
обязательный: обязательны обязательное
история: история
выявить: выявлены
брать: брать
свисток: свистку
гипотиреоз: гипотиреоз
князь: князь
терьер: терьер
эксперт: экспертами экспертов
керн-терьер: керн-терьер
марк: марк
щенок: щенка щенку щенки щенков щенок щенками
компактность: компактность
признание: признание
оставить: оставленный
зверь: зверем зверя
серный: серных
команда: команда команды
проход: прохода
энергичность: энергичностью
черта: черты
психика: психику
дешёвый: дешевле
живить: живя
кобель: кобеля кобели кобелей
успешно: успешно
деятельность: деятельность
десятилетие: десятилетие
сложно: сложно
дрессировка: дрессировку дрессировка дрессировки
отмереть: отмерших
подвес: подвеса
терпеть: терпеть
настолько: настолько
задаток: задатки
производительница: производительницы
шубка: шубка
предплечье: предплечья
записать: запишет
думать: думают
стоить: стоит
подбирать: подбирать
умелый: умелый
питомец: питомцев питомца питомцы питомцем питомец
итог: итог
придумать: придумать
каждый: каждого
распространить: распространены
проверка: проверка
разный: разных разные
важный: важная важный
мочка: мочкой
плохой: хуже плохой худший
агрессивность: агрессивность
той-терьер: той-терьерами
позиционироваться: позиционировались
бультерьер: бультерьерами
портрет: портрет
шнауцеры: шнауцеры
требовать: требует
движение: движения
скакательный: скакательные
трусливый: трусливый
вести: ведет
диплом: дипломы дипломами
условие: условиях условии
проверять: проверяют
характеристика: характеристика характеристики
цитрусовый: цитрусовых
продолжительный: продолжительными
сгиб: сгиб
вопрос: вопрос
выставка: выставках выставок
выплёскивать: выплескивая
пясть: пясти
супермаркет: супермаркета
руб: руб
другой: другие других
безболезненно: безболезненно
забросить: заброшен
приобретение: приобретение
хозяин: хозяином хозяин
исходить: исходя
сведение: сведению
просмотр: просмотров просмотр
ламинария: ламинарии
вполне: вполне
выступать: выступает
основательность: основательностью
напористый: напористый
шитце: шитцу
профессиональный: профессиональной
разделять: разделять
немой: нем
зарождение: зарождения
анималист: анималисту
променад: променадов
избежание: избежание
приподнять: приподнято
пушистиковый: пушистиков
перейти: перейти
мера: мере
реально: реально
категория: категории
пекинес: пекинесами
отдельный: отдельные отдельных
голосистый: голосисты
частота: частотой
расщепляться: расщепляться
недуг: недуги
несколько: несколько нескольким
казазаев: казазаева
регулярно: регулярно
век: век века
известный: известный известные
коготь: когти когтей
главное: главное
занятие: занятие занятия
преобладать: преобладающим
медный: медный
рост: рост
игривый: игривой игрив
своевременно: своевременно
ответ: ответа ответ
котон-де-тулеар: котон-де-тулеар
потомство: потомство
подбираться: подбирается
двигаться: двигалась
пыль: пыль
живописный: живописного
качество: качества качестве
подобный: подобными
быстро: быстро
определяться: определяется
собранный: собранными
сила: силы
мочеточник: мочеточников
первый: первой первый первую
барсук: барсуку
менее: менее
оценка: оценку оценке
тренировка: тренировка
чисто: чисто
уровень: уровне
к: ко
раз: раза
реклама: реклама
матёрый: матерым
плоский: плоский
выставочный: выставочным выставочных
легко: легко
розовый: розовой
свора: своре
родиться: родились
безбашенность: безбашенностью
рыжий: рыжих
склонный: склонна
затрата: затрат
идеально: идеально
болото: болотах
тренироваться: тренируются
карликовый: карликового
лента: ленту
лосьон: лосьоном
вещь: вещам
базовый: базовые
пуходерк: пуходерками
переход: переходом
итак: итак
меню: меню
месячный: месячном месячного
полностью: полностью
неисправимый: неисправимые
пропитание: пропитание
шоколадный: шоколадная
отложение: отложений
незапамятный: незапамятных
порция: порции
мелкий: мелкой мелких
сочетание: сочетании
вверх: вверх
ошибочно: ошибочно
обильный: обильная
сахарный: сахарные
томас: томасу
домашний: домашних
второй: второй вторую
успевать: успевает
добавка: добавки
нюанс: нюансах
слишком: слишком
рекомендоваться: рекомендуется
одиночество: одиночеству
фауна: фауны
спокойно: спокойно
естественный: естественному
запретить: запрещенных запрещено
воспитание: воспитание воспитании
фигурировать: фигурировали
лиса: лисе
временной: временных
кеннел-клуб: кеннел-клубом
разделение: разделение
мило: мило
комок: комок
отучить: отучить
работа: работы работе работу
лисий: лисью
игрушка: игрушках игрушки
рацион: рациона
фоксова: фоксов
общаться: общается
влиять: влияют
усваиваться: усваивается
правильно: правильно
ричард: ричард
слуховой: слухового
содержание: содержание содержания
день: день
девочка: девочка
тыльный: тыльной
гладкошрстный: гладкошрстный
калорийность: калорийности
стейн: стейн
умеренный-агрессивный: умеренно-агрессивен
немного: немного
принятие: принятием
трудозатратный: трудозатратное
морда: морда
мясной: мясной
гигиена: гигиена
застревать: застревать
повтор: повторов
черепной: черепной
бывать: бывает
грызунок: грызунки
родословная: родословной
крепкий: крепкая
вой: вой
схватка: схватки
продукт: продуктами продуктов
избегать: избегать
штатный: штатном
обернуться: обернется
вакансия: вакансии
рекомендовать: рекомендуют
добыча: добыче
слоиться: слоиться
жёсткость: жесткостью
жёлтый: желтые
привыкать: привыкает
полезно: полезно
относиться: относятся
агрессивно: агрессивно
соответствие: соответствие
бесстрашный: бесстрашный
мускулистый: мускулистая мускулистый
заказать: заказавшему
специалист: специалисты
число: числу
семья: семью
натуральный: натуральном натуральное натуральными натуральные
гранат: гранатов
книзу: книзу
недлинный: недлинная
лишь: лишь
поведенческий: поведенческие
прикус: прикус прикуса
игроман: игроман
стрижка: стрижка
компаньонский: компаньонские компаньонское
опытный: опытные
отруби: отрубей
покупка: покупкой
елизаров: елизарова
сангвиник: сангвиники
искажать: искажают
нерафинированный: нерафинированного
пообщаться: пообщаться
нелюбитель: нелюбителей
постоянно: постоянно
план: плане
форум: форум форуме
бедро: бедер бедра
связь: связь
разведение: разведения
плата: плата
приближение: приближения
подтянутый: подтянутый
находить: находит
полковник: полковнику
ветеринар: ветеринара
нежирный: нежирную
выше: выше
испачкаться: испачкалась
правило: правило правила
режим: режиме
энергичный: энергичной
манипуляция: манипуляциям
заводчик: заводчика
кошачий: кошачьих
обойтись: обойтись
зарегистрировать: зарегистрировал
догхантер: догхантеров
управлять: управлять
удобно: удобно
достойный: достойных
незнакомый: незнакомыми
соурить: соури
жёсткий: жесткими
двигатель: двигателем
столетие: столетия столетию
варежка: варежкой
разбросать: разбросанных
приучение: приучение
проходить: проходить
пока: пока
особый: особых
фон: фоне
ровный: ровные
выложиться: выложиться
антонин: антонина
добывать: добывавшие
подразделять: подразделяют
страстный: страстному
добродушный: добродушен
корм: корма корм
племенной: племенных
ошейник: ошейнику
независимый: независимых
пройти: пройти
терьерский: терьерские терьерской
торнтонуть: торнтону
предназначить: предназначенная
описание: описание
прямой: прямыми прямая
главный: главная
слабовыраженный: слабовыраженные
чужак: чужаком
морской: морской
объявление: объявлений объявления
упражнение: упражнениями
начало: начало
внушительный: внушительной
стоимость: стоимость
рейтинг: рейтинг
полгода: полугода
шоу-чемпион: шоу-чемпионов
выгул: выгулы
приобрести: приобрести
состояние: состояния
дерматит: дерматиты
корсет: корсетом
удлинённый: удлиненные
возможность: возможностей возможность возможности
особенно: особенно
возникнуть: возник
подписываться: подписывайтесь
пожалуйстау: пожалуйстау
лопатка: лопатки
переключаться: переключается
менять: меняют
строго: строго
середина: середине
кольцо: кольцом
свернуть: свернут
сбор: сбору
удалённый: удаленными
форд: форд
живность: живности
использовать: используют
очертание: очертания очертаний
двухчасовой: двухчасовую
включать: включать
предельно: предельно
вкусняшка: вкусняшек
искусственный: искусственной
однако: однако
модельер: модельер
достаточно: достаточно
крупный: крупного
хвост: хвостов хвоста хвост
раздражать: раздражает
задорный: задорный
приготовиться: приготовиться
выносить: выносит
устраивать: устраивать
пальчик: пальчиках
глубина: глубины
поэтому: поэтому
особь: особей особям особи
обычно: обычно
гилпин: гилпину
явный: явные
четыре: четырех
обязать: обязан
привычка: привычки
принадлежать: принадлежала
обожать: обожавший
глаз: глазами глаза
мышечный: мышечным
оптимист: оптимисты
круглый: круглые
пертёс: пертеса
ученик: ученик
смотреть: см
выпуклый: выпуклая
безразличие: безразличия
друг: друзья
образный: образных
любой: любых
порода: пород породу породы порода
возраст: возраста возрасте
копирование: копирование
произойти: произошло
фотография: фотографии
активность: активность активности
конфликт: конфликта
неделя: неделю
согласный: согласен
авокадо: авокадо
исключаться: исключаются
работать: работать
дружелюбность: дружелюбность
выемка: выемка
незнакомец: незнакомцам
организатор: организатор
чрезмерный: чрезмерной
заполнить: заполненная
кисломолочко: кисломолочку
охотно: охотно
форма: формы
довольно: довольно
частность: частности
иметь: иметь имеющих имеют
держать: держать
позитивный: позитивен
ходить: ходить
высокий: высокая высокий
купить: купить
любопытство: любопытству любопытством
часто: часто
такса: таксы
предок: предок
кошка: кошки кошками кошек
силуэт: силуэте
спорт: спорт
прародитель: прародители
сложение: сложения
касаться: касается
беззерновой: беззерновую
район: районе
враждебно: враждебно
проводить: проводит
хлопоты: хлопот
отсутствие: отсутствии
задор: задора
помощник: помощника
популяризировать: популяризировал
мимо: мимо
шум: шум
удалить: удалить
дело: деле
заслонка: заслонкой
одновременно: одновременно
скопиться: скопилось
принимать: принимает
приблизить: приближено
новый: новому
мопс: мопсами
часть: части
болтать: болтает
проект: проекте
быт: быту
ножницеобразный: ножницеобразную
спина: спина спину
недопустимо: недопустимо
питаться: питающегося
разводить: разводили
персона: персоны
судейский: судейскую
подсказать: подскажите
голова: голова
мощный: мощных
одаривать: одаривает
аллергический: аллергических
звук: звуку
сводиться: сводится
кг: кг
бладхаунд: бладхаунд
покупать: покупать
породный: породные
краткий: краткая
демонстрировать: демонстрирует
расчёска: расческами
этап: этапов
болезненный: болезненных
чистота: чистотой
назад: назад
исследователь: исследователь
яндекс: яндекс
основание: основание
радужка: радужка
темперамент: темперамента темперамент
сидеть: сидеть сидящего
среднее: среднего
постоянный: постоянному
долгий: долгое
ласковый: ласковее
голицын: голицын
линька: линька
виноград: винограда
тусовщик: тусовщик
поступать: поступают
дать: дадут
реакция: реакций
общий: общая
дом: дома доме
малыш: малышей
костистый: костистые
мочь: могут
эпоха: эпохи
исключительно: исключительно
страна: страна
фокса: фокса
низко: низко
минимум: минимум
периодически: периодически
этот: этих
стоп: стопа
пищеварительный: пищеварительной
система: системы
мать: матерью
живой: живой
купать: купать
быть: будем
игнорироваться: игнорируется
плодиться: плодившиеся
любитель: любителю
факт: факт
подпасть: подпала
подопечный: подопечного
трофей: трофеями трофеи
вконтакте: вконтакте
пейзаж: пейзажа
человек: людьми человек
непросто: непросто
рядом: рядом
поднимать: поднимать
находиться: находящегося
судорога: судороги
кормление: кормления кормление
крупа: круп
основной: основные
сочетать: сочетает
дерзкий: дерзких
возиться: возиться
усилие: усилий
староанглийский: староанглийский
весь: всем
задиристый: задиристых
интеллект: интеллект
охранный: охранные
скрещивать: скрещивали
правильный: правильной
ярко: ярко
далеко: далеко
происходить: происходящего
выдержка: выдержки
дорога: дорог
вес: вес
негативный: негативное
той-пудель: той-пуделями
продажа: продажу
некачественный: некачественные
бродяжничество: бродяжничеству
родитель: родителей
одноклассник: одноклассники
обычный: обычным
протирание: протиранием
поднять: поднят
полотенце: полотенцем
конец: конец
конечность: конечности
какой: какого
ощущать: ощущает
выносливый: выносливый
тёмный: темного
бордер-терьер: бордер-терьер
являться: является
нос: носа
дисплазия: дисплазия
бег: беге
лидер: лидер
усиленный: усиленные
волос: волос
длина: длины
неизлечимый: неизлечимый
доставлять: доставляет
аристократ: аристократы
сушка: сушку
выбрать: выбрать
чей: чью
плевать: плевать
масло: масла
токсикоз: токсикоз
стремительно: стремительно
конструкция: конструкцию
определённый: определенных
мнение: мнения
сам: самом
грудь: грудь
наследовать: наследуемые
свисать: свисает
случайный: случайные
коробка: коробкой
отклонение: отклонения
городской: городским
будущее: будущее
злоупотреблять: злоупотреблять
питч: питч
основать: основана
мясо: мясо
г: г
классический: классические
дрессироватьнатаскивать: дрессироватьнатаскивать
черно: черно
встречаться: встречаются
продолжительность: продолжительность
депигментировать: депигментированной
сплошной: сплошной
борзая: борзые
х: х
осмотр: осмотр
сторожевой: сторожевую
спортивный: спортивными
