желательный: желательная
процесс: процессе
понимать: понимали понимать
взяться: взялись
противник: противника
средний: средняя среднее
агрессия: агрессия агрессию
ныне: ныне
расти: растет
автор: автором
участвовать: участвовать
сколько: сколько
склонный: склонен
уходить: уходит
недостаток: недостатке
название: название названием
погоня: погоню
собака: собаку собаками собакой собак собака собаке собаки
фон: фон фоне
примерно: примерно
настоящий: настоящих настоящего настоящий
рассесть: рассела рассел
хороший: лучшим хорошим хороший лучших
хитрый: хитры
четверть: четверти
хроника: хрониках
ноздря: ноздри
физический: физических физические
обсуждение: обсуждения
отношение: отношениях отношение отношении отношению
ваш: вашему ваш
цена: цена
бульмастиф: бульмастиф
запаривать: запаривающей
материал: материалов
природа: природы
организация: организации организаций
напрямую: напрямую
идеальный: идеальные
собрат: собратьям
оксфордский: оксфордского
владелец: владельцам владельца владельцев владелец
эффективность: эффективности
поведение: поведения поведении поведением поведение
след: след
собственный: собственных собственная собственные
качество: качествами качеств качестве качество качества
любовь: любовь
сторона: стороны стороной
культурный: культурного
инстинкт: инстинкты
традиция: традиции традиция
пятно: пятнами пятна пятен
больший: большим
субпродукт: субпродукты
зато: зато
клиника: клиниках
россия: россия
морда: морде морда
ряд: ряда
обратный: обратная
великобритания: великобритании великобритания
представитель: представителей представителя представители
отважный: отважного
шея: шея
отмечать: отмечают
шерсть: шерсть шерсти шерстью
священник: священником священник священника
одиночество: одиночества одиночестве одиночеству
запретить: запрещена запрещено
пожилой: пожилыми
челюсть: челюсти
должный: должны должен должно должна должном
недобросовестный: недобросовестных
потомство: потомства
узкий: узкая
главный: главной главная
говядина: говядина
класс: класса
норматив: нормативов
мила: мил
чёрный: черные черного
вельша-корги: вельш-корги
человек: людям людьми человека человеком
фризбить: фризби
питомец: питомцами питомцев питомцу питомец питомцы питомца
месяц: месяц месяца месяцев
проявлять: проявлял проявляет проявлять
ушной: ушных
мы: нам
ориентироваться: ориентируясь
общий: общим
назвать: назвать
прародительница: прародительница
независимый: независимы
нанесение: нанесение нанесением
называть: называя называемая
выраженный: выражен
определённый: определенными
важно: важно
породистый: породистой
история: история историю
свирепость: свирепость
высокорослый: высокорослым
бельгийский: бельгийская
щенок: щенка щенков щенки щенок
придумывать: придумывайте
проявляться: проявляется
новый: новые новых новой нового
круглый: круглой
выносливый: выносливыми
слава: славу
юный: юного
семья: семьи семей
досуг: досуг
защитный: защитные защитный
вероятный: вероятнее
выбрать: выбранного выберите выбрать
характеристика: характеристика
коррекция: коррекции
выставка: выставках выставки
помощь: помощью
физически: физически
приглашаться: приглашался
визит: визитов
зарождение: зарождения
купание: купания
год: годы годах года лет год годов году
вид: виды видом виде
хейнеманна: хейнеманн
водыгра: водыгр
порода: породе породы порода
сигнал: сигналы
значит: значит
ирландский: ирландские
варёный: вареная
осмотр: осмотров осмотре осмотр
появление: появление появления
палец: пальцы
популяризация: популяризации
быстро: быстро
студент: студенту
викарий: викарий
территория: территория территорий
раз: раза
видео: видео
стратегия: стратегию
энергичный: энергичным
стремиться: стремятся
фоксхаунд: фоксхаунды
внимание: внимания внимание внимании
полностью: полностью
никакой: никаких
возникновение: возникновения возникновением
лидерство: лидерству
любоваться: любуется
кладбище: кладбище
несовместимый: несовместима
поставить: поставил поставлены
деревушка: деревушке
средневековый: средневековой
охотник: охотника охотников
коленный: коленные коленной
сьюаллис: сьюаллисом
образ: образ образом образу
содержание: содержание содержании содержания
стать: станут стали стал
отапливать: отапливаемая
мелкий: мелких
конфликт: конфликтам
слово: слово
резвый: резвых
составлять: составляет составлять
постройка: постройка
холка: холки холке
уклон: уклон
компонент: компонентов
чистота: чистота
ветеринар: ветеринару ветеринара
задача: задачей задачу
связь: связь связи
появляться: появляться
уделять: уделять
многовековый: многовековые
старый: старейший
затемнить: затемнены
развивать: развивает
клуб: клуб клуба
глазной: глазному
бедренный: бедренной
кеннела: кеннел
тип: типов типа
красный: красные
разрушительный: разрушительные
внешность: внешность
домашний: домашние домашнем домашнему
собираться: собирались
единственный: единственный
лоб: лба
формирование: формировании
переводиться: переводится
профилактический: профилактических
примешивать: примешивал
нынешний: нынешних
состояние: состоянии
гурман: гурман
хранить: хранить
дважды: дважды
способ: способами способ
месть: мести
бояться: бояться
член: члена членам
обувь: обувь
шиповник: шиповником
протирать: протирать
мебель: мебель
длинный: длинных
плотно: плотно
тёмный: темными темные
свидетельство: свидетельств
сомкнутый: сомкнуты
мощь: мощи
смотреть: см смотрите
крепко: крепко
чувствовать: чувствуете
увидеть: увидел
фотография: фотографии
четвероногий: четвероногие
окружность: окружность
уход: уходе ухода уход уходом
смотреться: смотрятся
знать: знать знает
церковь: церковью церкви
яблоко: яблоку
излом: изломом
высокий: высокая высоком высокий
сокровище: сокровище
питомник: питомники питомниках
череп: черепом черепа череп
глаз: глаза глаз глазах
испания: испании
район: районе район
склера: склеры
прийтись: придется
вопреки: вопреки
самый: самым
начаться: началась
сказать: сказать
век: века веке
периодический: периодической
существовать: существуют
считать: считал
мир: миром
неконтролируемый: неконтролируемым
поскольку: поскольку
охотничий: охотничьи охотничий
покупать: покупать
краткий: краткая
весьма: весьма
долгий: долгое долгую
свой: своими своим свой своего своей своих
сильный: сильная сильные
продолжить: продолжил
натуральный: натуральная натуральный
место: место месте
малыш: малышей
чёткий: четкой
первый: первом первые первого первый первая
медведь: медведю
эксперт: экспертов
ранний: раннего ранняя раньше
таков: такова
сохраниться: сохранившимся сохранились сохранился
следовать: следуя следует следуйте
вконтакте: вконтакте
просмотр: просмотр просмотров просмотра
постоянный: постоянной
свет: свет
рядом: рядом
консервы: консервы консервами
далее: далее
любимец: любимцев любимцу
переход: переход
тазобедренный: тазобедренных
чихуахуа: чихуахуа
экономить: экономить
хозяин: хозяин хозяевами хозяину хозяина
обойтись: обойдутся
кожа: коже
развитие: развитие развития
кинологический: кинологической
животное: животных животным животными животные
раковина: раковин
одинаково: одинаково
наследие: наследия
привязываться: привязываются
преследование: преследования преследование
коллега-заводчик: коллег-заводчиков
характер: характером характера характер
столкнуться: столкнулась
птица: птица
перегрузить: перегружены
основать: основана основан
классический: классические
хотя: хотя
х: х
серьёзный: серьезные
джек-рассел-терьер: джек-рассел-терьер джек-рассел-терьеров джек-рассел-терьеры джек-рассел-терьера джек-рассел-терьером
прочный: прочный
форма: форму формы
опытный: опытный опытным
доставлять: доставлять
джек: джеков джеку джек
собаководство: собаководства собаководству
фоторепортаж: фоторепортажах
мама: мамы
сложный: сложного
достижение: достижения
квартира: квартире
бридер: бридер бридера бридеров
размер: размеры
нора: нору норах
официально: официально
влажный: влажным
информация: информация
подходить: подходит подходят
рабочий: рабочими рабочих рабочие
поход: походов
масса: масса
приобрести: приобретенных приобрести
компактный: компактным компактные
прохожий: прохожим
сустав: суставы суставов
выбраковывать: выбраковывать
будущее: будущем
мочь: могли могут мог
прогулка: прогулку прогулки прогулок
проводить: проводить проводите
ребро: ребра ребер
скроить: скроенные
кошка: кошкой кошки кошкам
интеллект: интеллекте интеллект
окрас: окрас окрасе
неприятность: неприятности
сообразительность: сообразительность
крепкий: крепкие
десяток: десятком
вплоть: вплоть
половина: половина
польза: пользу
увлечься: увлекся
небольшой: небольшая небольшие небольшой небольшим
вступать: вступая
салфетка: салфетками
нормальный: нормальное
джон: джону джон джона
любой: любое любой
подушечка: подушечками
горожанин: горожане
веко: веки
разведение: разведении разведение
строгий: строгих
развитой: развитые
излишек: излишек
полный: полной
имущество: имуществу
близкий: ближайшего ближе
просто: просто
забывать: забывать
аллергия: аллергия
мало: мало
миндалевидный: миндалевидной
козырь: козыря
конец: конца конец
частый: частые чаще
свимбридж: свимбридж
тысяча: тысяч
пёс: псов пса
воплощать: воплощавшую
находить: находить
час: часа часов
обратить: обратить
врач-дерматолог: врач-дерматолог
попытка: попытка попыток
растиражировать: растиражированному
чей: чьем
зрительный: зрительного
вывих: вывих
окружающие: окружающим
екатерина: екатерина
молодой: молодой
добавить: добавьте
компания: компания
австралиец: австралийцы
умеренный: умеренная умеренное
происхождение: происхождения
наследственный: наследственные наследственных
необходимо: необходимо
закат: закатом
терьер: терьер терьеры терьерам терьеров
соотношение: соотношение
задний: задние
ситуация: ситуация ситуации
авторитет: авторитета
гладкий: гладкая
оставлять: оставляйте оставляли
дрессировка: дрессировка дрессировке
симптом: симптомов
время: время времен времени
исследовать: исследует
край: краю
агрессивность: агрессивность
устроить: устроить
варьироваться: варьироваться
защищать: защищать
вес: веса вес весу
начать: начали
учёба: учебы
другой: другие другими другим
рассматривать: рассматриваем
взрослый: взрослого взрослые взрослых
побочный: побочной
знакомство: знакомстве
мера: мере
например: например
несколько: несколько
сетчатка: сетчатки
грызть: грызть
консерв: консерв
алдрес: алдрес
рост: рост роста
трудность: трудностями
заниматься: занимайтесь занимался
сила: силы силу
покладистый: покладист
жить: жить живут живем
шотландский: шотландские
резко: резко
документальный: документальных
рыжий: рыжего
реклама: реклама
плоский: плоский
проникнуть: проникнуть
сознательный: сознательная
линять: линяет
истинный: истинной
кормить: кормлю
мускулатура: мускулатурой
соседство: соседство
нестабильность: нестабильности
соответствие: соответствия
общительный: общительным
часть: частью часть
напоминать: напоминает
проблема: проблемами проблем
точный: точных
воспитание: воспитание воспитании воспитанию
мирно: мирно
дичь: дичи дичь
прибыль: прибыли
добиться: добиться
лапа: лапами лапы
прямоугольный: прямоугольный
процедура: процедур
решение: решения
чрезмерный: чрезмерных
сайт: сайту
молочник: молочнику
черепной: черепной
врождённый: врожденные врожденных
парфорсный: парфорсная
родословная: родословной
энтузиазм: энтузиазмом
сосуществовать: сосуществовать
замечательный: замечательными
активный: активный активных активны
занять: занять
бокс: боксом
добыча: добыче
джек-рассесть: джек-рассела джек-рассел
увечье: увечий
социализация: социализация
знаковый: знаковая
этот: эта этих
быть: будут
лишь: лишь
относиться: относиться
долго: долго
выносливость: выносливости
крысолов: крысоловы
постановка: постановки
репутация: репутацией
противодействие: противодействия
рисунок: рисункам
форум: форум форуме
скончаться: скончался
защитить: защищенное
спорт: спорта
джеймс: джеймса
жестокость: жестокости
ветка: ветки
требовать: требуют
закруглить: закруглены
плохой: худшие плохом
такой: такие
приступ: приступы
внешне: внешне
беспокойство: беспокойство
лейкленд: лейкленды
журнал: журналов журнал
снискать: снискали
конкретный: конкретному
пастор: пастора пастор
близко: близко
генофонд: генофондом генофонде
тосковать: тоскуют
описание: описание описания
некрупный: некрупную
коротконогий: коротконогие
начало: начало
пространство: пространство
доставить: доставит
приход: приход
подниматься: поднимается
сосудистый: сосудистой
шотландия: шотландии
лопатка: лопатки
здоровье: здоровьем здоровье
середина: середине
доминировать: доминирующем доминировать
верхом: верхом
еда: еда
джек-расселов: джек-расселов
однако: однако
психика: психики
отличаться: отличаются
отсутствие: отсутствием отсутствие
поэтому: поэтому
пертёс: пертеса
копирование: копирование
прекрасно: прекрасно
активность: активность активности
основание: основания основании
дружелюбность: дружелюбность
выслеживание: выслеживания
пострадать: пострадать
наскучить: наскучит
тратить: тратить
силуэт: силуэт
подвижный: подвижные
отзыв: отзывах отзывы
громкий: громкий
остаться: остались
тримминг: тримминге
уступить: уступил
доходить: доходить
хлопоты: хлопот
привлечь: привлечь
шум: шум
гость: гостям
широкий: широкий широкая
висячий: висячие
пола: полы
стандартный: стандартных стандартные
активист: активисты
аккуратный: аккуратный
сквозняк: сквозняков
сомнение: сомнений
акт: акт
подсказать: подскажите
заново: заново
обходить: обходит
назад: назад
пожалуйста: пожалуйста
фокстерьер: фокстерьерами фокстерьеры
цвет: цвет цвета
кость: кости
сердце: сердца
произойти: произошла
формат: формата
выведение: выведения
ухо: ушей уши
продавать: продавал
целое: целом
объявление: объявления
шалость: шалости
основной: основные
важный: важна
охранный: охранные
многие: многие
преобладать: преобладающий
средне: средне
каша: кашей каши
охотиться: охотиться
святой: святого
полотенце: полотенцем
своенравный: своенравного
тёмно-каштановый: темно-каштанового
голос: голос
неотъемлемый: неотъемлемой
специалист-кинолог: специалисту-кинологу
судья: судьи
краснодар: краснодаре
именно: именно
планомерно: планомерно
чрезвычайно: чрезвычайно
встреча: встреча
последний: последних последний последнем последние
локоть: локтями
местный: местному
продолжительность: продолжительность
страна: страны стран страна
питание: питанию питание
вряд: вряд
неизменно: неизменно
обеспечить: обеспечить
повреждать: повреждают
скрещивать: скрещивать
короче: короче
опустить: опущен
современность: современности
расположить: расположены расположенное
хоз: хоз
оставить: оставили
чистокровный: чистокровный
результат: результате
парк: парка
регулярный: регулярного регулярные регулярных
основный: основными
знаменитый: знаменит
утром: утром
домочадец: домочадцами
здравствуйте: здравствуйте
равный: равных
доктор: доктор
фото: фото
сталкиваться: сталкивался сталкиваться
достоверно: достоверно
незаселённый: незаселенных
здравствуйтеподсказать: здравствуйтеподскажите
выделяться: выделяются выделялись
игрушка: игрушек игрушки
уэльс: уэльсе
яндекс: яндекс
считаться: считаются считались
участие: участие участия
гармонично: гармонично
остальной: остальным
кто: кого
известный: известной известные
пытаться: пытаться
помнить: помнить
техника: техника
азарт: азарт
допустить: допущены
дикий: диким
альбион: альбион
оценить: оценить оценили
фрисби: фрисби
настойчивый: настойчивому настойчивым
вытянутый: вытянутый вытянутым
дружелюбный: дружелюбным
плюшевый: плюшевому
высота: высота
что-то: чем-то
минута: минуты
нуждаться: нуждаются
шипёрка: шиперке
линия: линией
генетик: генетиков
уживаться: уживаются
скучать: скучать
болезнь: болезни болезнь
ребёнок: дети детьми
вызвать: вызвать
керн: керны
который: которого которым которые который
один: одной одном
заводчик: заводчиков заводчика
совершенно: совершенно
публично: публично
либо: либо
активно: активно
парсон-джек-рассел-терьер: парсон-джек-рассел-терьер
цезарь: цезаря
тяжёлый: тяжелых
татьяна: татьяна
апатия: апатия
упрямство: упрямство
прийти: пришло
охота: охоте охота
европейский: европейских
ущерб: ущерба ущерб
барсук: барсуки
знаменитость: знаменитостей
специализировать: специализированной
парсон-рассел-терьер: парсон-рассел-терьера
признание: признание
похоронный: похоронен
окрестный: окрестных
очистка: очистку
принять: принял приняты
каждый: каждые
такса: таксами
плохо: плохо
глухота: глухота
сопровождаться: сопровождаться
скакательный: скакательные
терпение: терпение
заметно: заметно
стычка: стычки
джек-расселом: джек-расселом
упомянуть: упомянутые
противопоказанный: противопоказаны
римский: римских
нерв: нерва
нужный: нужен
перейти: перейти
внести: внесли
продажа: продаже
последующий: последующие
из-за: из-за
главное: главное
регулярно: регулярно
джеки: джеки
маленький: маленькие меньше
яма: яму
являться: являлась является
оболочка: оболочки
тот: тех той
жёсткий: жестким жесткая
сравнение: сравнение
ген: генов генах
момент: момента моменты момент
иной: иной иные
улучшить: улучшить
норный: норной норных
полагать: полагают
принадлежать: принадлежало
требование: требования
сложиться: сложилась
цель: целью
вести: ведут вел
слишком: слишком
готовый: готовый
бесстрашие: бесстрашие
стандарт: стандарта стандарту стандарт
работа: работа
рекомендация: рекомендациям
сзади: сзади
выдвигаться: выдвигаются
габарит: габаритов
белый: белый белом
экспонировать: экспонировал
слезать: слезали
эксетерский: эксетерском
бдительность: бдительность
двигатель: двигатель
мускулистый: мускулистая мускулистые
появиться: появилось
совет: советом
копание: копание
атака: атаки
оценка: оценке
рубль: рублей
спереди: спереди
твёрдость: твердостью
мочка: мочка
значительный: значительную
вечером: вечером
служить: служил
крепыш: крепышам
подвернуться: подвернувшейся
проигрывать: проигрывали
природоохранный: природоохранных
неизвестно: неизвестно
зелёный: зеленом
риск: риска
старое: старого
ретинальный: ретинальных
бордер: бордеры
глубокий: глубокая
забавный: забавных
защита: защитой
повышать: повышать
австралия: австралии
джек-рассел: джек-расселы
кино: кино
чесапик-бей-ретривер: чесапик-бей-ретривер
стоимость: стоимость
отменить: отменить
самочувствие: самочувствии самочувствие
телятина: телятина
вудос: вудос
иначе: иначе
коллега: коллега
особенно: особенно
образный: образную
поворачиваться: поворачиваться
использовать: использовали использовал
открытый: открытые
строго: строго
книга: книгой
длина: длина
непогода: непогоды
состязание: состязание
энтузиаст: энтузиасту
достаточно: достаточно
поддаваться: поддается поддаются
принимать: принимали
обязательно: обязательно
покинуть: покинуть
международный: международной
ответ: ответов
чесаться: чешется
прилегать: прилегают
обязать: обязан
возраст: возраста возрасте
компаньон: компаньонами
нагрузка: нагрузках нагрузки
неделя: неделю
матрас: матрас
запись: записями
группа: группе группы
слушать: слушать
умственный: умственными
получение: получению
колледж: колледже
беглец: беглеца
семейный: семейной
англия: англии
несмотря: несмотря
исследователь: исследователи
купить: купить
род: роду
находиться: находятся
прямой: прямые
заболевание: заболеваний
твёрдый: твердыми
многолетний: многолетняя
хромота: хромоты
плановый: плановых
кулагин: кулагина
спина: спина
один-два: один-два
снимать: снимали
упускать: упускают
причина: причины
голова: голова
мощный: мощных мощные
кончик: кончики
сериал: сериалом
ширлить: ширли
вырыть: вырыть
туловище: туловищем
судьба: судьба
внушительный: внушительную
нрав: нравом
смерть: смерти
аномалия: аномалия
прочно: прочно
оказаться: оказались
наличие: наличие
заломить: заломлены
разграничение: разграничения
александрович: александровна
нежелательно: нежелательно
отдать: отдавший
чистый: чистой
просуществовать: просуществовавший
крупа: круп
английский: английский английское английские
безупречный: безупречной
различный: различных различные
убежище: убежище
безнаказанно: безнаказанно
выдержать: выдержать
одноклассник: одноклассники
реакция: реакцию
кровь: кровь
перспективность: перспективности
единомышленник: единомышленников
посещать: посещайте
узнать: узнать
дисплазия: дисплазия
команда: команды команда
предать: преданных
возможность: возможности
сходство: сходство
коробка: коробки
такгра: такгр
чистить: чистить
грудь: грудь
случайный: случайные случайным
передний: передние
движение: движении
популярный: популярная популярных
беднокостный: беднокостной
выпучить: выпучены
сегодня: сегодня
три: трех
поиск: поиск
эксперимент: экспериментах
сопрячь: сопряжено
квадратный: квадратного
заботиться: заботятся
проект: проекта проекте
зуб: зубы зубов
преклонный: преклонных
вялость: вялость
параллельный: параллельны
согнутый: согнуты
сбалансированный: сбалансированная
привлекать: привлекать
себя: собой
белые: белые
официальный: официальное официальных
гончая: гончие
промах: промахи
лис: лисами лис
вымереть: вымершие
заставить: заставить
обитать: обитающую
короткий: короткая короткими
сосуд: сосудов
помогать: помогали
обратиться: обратитесь
сбоку: сбоку
попросту: попросту
сделать: сделано
нос: нос
игра: игры игра
схватка: схватке
потребность: потребность
кнопка: кнопки
селекционный: селекционная
требоваться: требовались
жизнь: жизни
современный: современных
овчарка: овчарка
они: ними
вычёсывание: вычесывания
сильно: сильно
тело: тело
аппетит: аппетита
баранка: баранка
жизнерадостный: жизнерадостным
содержательный: содержательную
предок: предками
данные: данных
видеть: видит
нежелательный: нежелательными
установление: установление
корень: корнях
супер-премиум: супер-премиум
нужно: нужно
мимимишность: мимимишности
девонширский: девонширского
спокойный: спокойной
также: также
умный: умная
вывести: выведены
игривый: игривым
возможно: возможно
илиинет: илиинет
мария: мария
неказистый: неказистые
упоминаться: упоминалось
корпус: корпус
специальный: специальных
поясница: поясница
служение: служение
гладкошёрстный: гладкошерстный
детство: детства
умеренно: умеренно
юг: юге
стоить: стоить стоит
уважать: уважать
привести: привести
ранее: ранее
роза: роз
сосед: соседями
смочь: смогут сможет
жесткошёрстный: жесткошерстного жесткошерстные
крайне: крайне
ужиться: ужиться
завоевать: завоевали
это: это
эпилепсия: эпилепсия
возглавить: возглавил
ножницеобразный: ножницеобразный
чашечка: чашечки
зависеть: зависит
оставаться: оставалось
чередовать: чередуйте
исходить: исходя
оранжерейный: оранжерейных
вполне: вполне
крупный: крупные
способный: способен
занятие: занятие
страх: страх
диверсия: диверсия
артур: артур
справляться: справляетесь справлялись
страсть: страстью
ровный: ровный
континент: континенте
легко: легко
многий: многих
привыкнуть: привыкли
лента: ленту
премиум: премиум
превосходный: превосходных
звонкий: звонкий
хх: хх
растительный: растительных
преднизолон: преднизолоном
выглядеть: выглядит
пробуждение: пробуждения
британия: британии
отличный: отличные
корякин: корякина
лай: лай
дорогой: дороже
заложить: заложенные
нарушать: нарушать
сложить: сложенная
вакансия: вакансии
прямо: прямо
крючкообразный: крючкообразного
специалист: специалисты
определить: определен
университет: университета
убийство: убийством
достоинство: достоинству достоинства
покой: покоя
прикус: прикус
приходиться: приходится
постоянно: постоянно
инструмент: инструментов
тренировка: тренировок
выше: выше
ритуал: ритуалы
большинство: большинстве
вместе: вместе
течение: течение
столетие: столетия
самолечение: самолечением
ландшафт: ландшафтом
корм: корма
крайний: крайний
подземный: подземное
сознательно: сознательно
рейтинг: рейтинг
скорость: скорости
весь: всеми
дефект: дефекты
судить: судить
независимо: независимо
подписываться: подписывайтесь
гигиенический: гигиенических
весёлый: веселая
недостаточно: недостаточно
источник: источникам
киноэкран: киноэкране
незамеченный: незамеченными
создание: создании
какой-то: какую-то
хвост: хвоста хвост
узнавать: узнаваемая
очень: очень
порицать: порицал
немало: немало
горячий: горячую
бок: бокам бок
достаточный: достаточное
спутник: спутников
нога: ногах
одежда: одежда
остеохондропатия: остеохондропатия
грубо: грубо
рассело: расселу
кличка: клички
глянцевый: глянцевых
правило: правила
мясной: мясных
прививка: прививок
свидетельствовать: свидетельствуют
сельский: сельской
поиграть: поиграем
впереди: впереди
вечный: вечный
документ: документов
бульдожий: бульдожьи
необходимый: необходимым необходим
причислять: причисляют
число: числе
пора: пор
сплющить: сплющены
колли: колли
кг: кг
городской: городской
превратиться: превратились
удовлетворить: удовлетворить
энергичность: энергичность
сидеть: сидеть
сей: сих
вознаграждение: вознаграждении
трамп: трамп
минимальный: минимальная
рожок: рожка
пузырик: пузырик
линька: линька
головка: головки
перчатка: перчатки
естественный: естественный
низко: низко
любимый: любимым
сказаться: сказалось
бойцовский: бойцовских
встречать: встречает
ответственный: ответственном
подходящий: подходящим
марго: марго
парсон: парсон
плюсна: плюсны
давно: давно
тепло: тепла
энергия: энергии
застраховать: застрахованы
вызывать: вызывает
конечность: конечности
закрепить: закреплено
свободный: свободное
ожидание: ожидании
оба: оба
слой: слой
губа: губы
дерево: деревьев
доступный: доступными
случай: случае случай
дом: доме
жюри: жюри
паста: пасты
грызун: грызунами
иметь: имеют
условие: условия
встречаться: встречаются
низкий: низкое
улучшение: улучшения
товмасян: товмасян
