движение: движениями движении
замаскированный: замаскированные
короткий: короткую короткие
заметить: заметили
овощ: овощи овощей
персона: персоне персон
орган: орган
отличать: отличают отличает
линейный: линейное
упитанный: упитанным
хаск: хаски
тело: тела телу
пигментация: пигментацию
кровь: крови
держаться: держатся держится
широко: широко
средний: средняя среднее
пять: пяти
параллельный: параллельные параллельный
четвероногий: четвероногих четвероногим четвероногое четвероногими
подарить: подарили
включаться: включаются включается
следить: следить
улица: улицам улицу улице
чёрный: черный черного черную
посторонний: посторонних посторонние
сколько: сколько
название: название
шорох: шорохов
ость: остью
примерно: примерно
собака: собаку собаками собакой собак собака собаке собаки
округлый: округлой
щётка-стриппинг: щеткой-стриппингом
состоять: состоит состоят
похожий: похожей
заранее: заранее
обсуждение: обсуждения
рыбный: рыбное
сдвоить: сдвоенные
свёкла: свекла
ваш: вашему вашего вашем ваших
миска: миску миске
сочленение: сочленений
обитать: обитали
цена: цена
рыба: рыбу
лечение: лечение
обновляться: обновляется
зачастую: зачастую
удаваться: удается
подсушивать: подсушивающими
смысл: смыслах
предка-чемпион: предка-чемпиона
материал: материалов
племенной: племенные
подшёрсток: подшерстком подшерсток подшерстка
питомец: питомце питомцев питомцу питомец питомцы питомца питомцем
оставить: оставить
массивный: массивным
туманный: туманного
гельминт: гельминтами
поведение: поведения поведении поведению поведением поведение
выщипываться: выщипывается
мазь: мазь
миниатюрный: миниатюрные миниатюрное миниатюрный миниатюрную миниатюрная миниатюрным
стоять: стоят
сторона: стороны
дисквалифицировать: дисквалифицирующие
больший: большим большая большие
семейство: семейства семейством
режим: режиму режим
холка: холку холке
расщелина: расщелины
зато: зато
россия: россия
живот: живот
раковина: раковины
гигиенический: гигиеническое
обратный: обратная
итог: итоге
овёс: овес
обаяние: обаяние обаянию
невоспитанный: невоспитанной
выворот: выворота
начинать: начинают начинать
радужка: радужки
ради: ради
представитель: представителей представителем представитель представителями представители
обитатель: обитателями обитателям
шея: шея шеи
полезный: полезнее полезны
жарко: жарко
развитой: развитым
компаньон: компаньон
шерсть: шерсть шерсти шерстью
блеск: блеск
ринуться: ринулись
использование: использования
по-разному: по-разному
кальций: кальция
кинолог: кинологи
челюсть: челюсти челюстям челюсть челюстей
должный: должны должен должна
самый: самая самым самое
нетипичный: нетипичные
потомство: потомства потомство
проживать: проживало
гриффоновский: гриффоновской
содержать: содержать
санация: санацию
созреть: созревшая
дозировка: дозировке
середнячка: середнячкам
влчак: влчак
сохранение: сохранения
человек: людям людей человеку человека
интервал: интервалы
относиться: относится относиться
месяц: месяц месяца месяцев
брюсселец: брюссельцев
терпеливо: терпеливо
спустя: спустя
равно: равно
гриффон-подросток: гриффоны-подростки
включая: включая
рост: росту рост
отличаться: отличается
формат: формат
объявлять: объявляя
финальный: финальные
однородный: однородную однородного
важно: важно
прикрикивать: прикрикивать
глазной: глазной глазного глазные
промышленный: промышленной
многий: многим
история: история
брать: брать
щенок: щенка щенков щенки щенком щенок щенкам щенками
откликаться: откликаться
среда: среда
проявляться: проявляется
гармоничный: гармоничном
бесконфликтность: бесконфликтность
белок: белка белок
платье: платья
классический: классическая классического классическим
выдающийся: выдающаяся
обычный: обычный обычное
каждый: каждого каждым
планка: планку
расслабленно-доверительно: расслабленно-доверительно
чувствовать: чувствуют
соседский: соседского
масло: масле
негромко: негромко
семья: семьи семье
портрет: портрет
характеристика: характеристика
антисептический: антисептическими
выставка: выставках выставки выставкам
фигура: фигуры
помощь: помощью
поздний: позднее
целесообразно: целесообразно
цинковый: цинковая
жесткошёрстный: жесткошерстный жесткошерстных
брюссельский: брюссельский брюссельскими
пол: пола полу
пятно: пятна
захват: захвата
гравюра: гравюрах
сомкнутый: сомкнутых сомкнута
пти-брабансон: пти-брабансонами пти-брабансонах пти-брабансонов
отнестись: отнеситесь
подбираться: подбирается
обладать: обладать обладающие
тримминговочный: тримминговочного тримминговочных
систематически: систематически
быстро: быстро
почистить: почистить
благородный: благородным
бельгийский: бельгийский бельгийские бельгийское бельгийских бельгийским бельгийского бельгийскому
аккуратный: аккуратное
еда: еду едой еде еда
густой: погуще
видео: видео
выщипывание: выщипывание
откровенный: откровенной
подойти: подойдет
крошечный: крошечный крошечными крошечные
разрешаться: разрешается
полностью: полностью
забавный: забавные забавных
компания: компании
заключение: заключения
вдобавок: вдобавок
фауна: фауны
владелец: владельца владельцев
гриффон: гриффоном гриффон гриффону гриффона гриффонами гриффонов гриффоны гриффонам
такой: таких такое такая таким
тримминг: триммингами триммингу тримминга
вынужденный: вынужденному
лошадиный: лошадиный
содержание: содержание содержанием содержания
стать: станут стали стать
ген: гены гена
сказочный: сказочное
мордочка: мордочки мордочке
присутствовать: присутствовать
приучать: приучать
подол: подолу
проморозить: промороженными
достигать: достигающая
попытка: попытки
представление: представления
выпучить: выпученные
мощный: мощный
составлять: составляет
зона: зона зонах зоны
рекомендовать: рекомендуют
похрапывать: похрапывают
альбрехт: альбрехта
привыкать: привыкает
стимулировать: стимулирующей стимулировать
трехразовый: трехразовый трехразового
древнегреческий: древнегреческой
ноздря: ноздрями
окрас: окраса окрас окрасы окрасам
давать: дает давать
бельгиец: бельгийцы бельгийцев бельгийцем бельгийца бельгиец
посягать: посягать
ветеринар: ветеринару ветеринара
морщинка: морщинках
ушной: ушные ушной ушное
комнатный: комнатный
облик: облика облик
ценный: ценно
помёт: пометов
кстати: кстати
связь: связь
примерный: примерный
уделять: уделять
бояться: боятся бояться
расставить: расставленные
переносить: переносит
обедать: обедающих
трусливый: трусливые
потешный: потешные потешный
гиперчувствительный: гиперчувствительная
брида-особь: брид-особей
крыса: крыс
старание: старания
выяснить: выяснить
комфорт: комфорту
выполняться: выполняться
налёт: налет
родство: родстве
надобность: надобности
основный: основную
обязывать: обязывает
пет-питомец: пет-питомцев
бедро: бедра
проходить: проходить
пока: пока
тролль: троллей
чрезмерный: чрезмерную
наружу: наружу
выпадение: выпадения
управляемый: управляемом управляемые
дважды: дважды
выполнение: выполнения
подпалина: подпалины
образовать: образовано
анус: ануса
напоминать: напоминающие
сердечно-сосудистый: сердечно-сосудистым
атмосфера: атмосферы
пресекать: пресекать
крысарик: крысарик
плотно: плотно
психика: психика
комплекция: комплекцию
достигнуть: достигнута
ежедневный: ежедневного
качество: качестве качества
тримминговать: тримминговать триммингуют
смотреть: см
превышать: превышает
плюс: плюс
фотография: фотографии
потешно: потешно
развлечение: развлечений
невзирая: невзирая
раствор: растворы
хороший: хорошие хорошей
уход: уходе уход
остроконечный: остроконечную
знать: знать
сахалинский: сахалинский
помнить: помните
результат: результат результате
страдать: страдают страдает
высокий: высокая высоким
питомник: питомники питомниках
перекорм: перекорм
карликовость: карликовости
чета: четы
мутация: мутациях
отдавать: отдавать отдавая
глаз: глаза глазом глаз глазами
индивидуальный: индивидуальную индивидуальный
эндокринный: эндокринным
серьёзный: серьезным серьезные серьезный
тип: типом типа
прийтись: придется
круг: круга
гипнотизировать: гипнотизировать
часть: части часть
морда: морды морда
серный: серный
сказать: сказать
ус: усы усами
мокнуть: мокнет
век: века век веками
фосфор: фосфора
питаться: питающегося питается
малыш: малышу малышей малыш
год: года лет год году
предпочтительный: предпочтительный
рычание: рычание
поскольку: поскольку
сука: сукам
создание: созданий создание
косматый: косматый косматых косматые
существо: существо
краткий: краткая
подравнивание: подравнивание
общий: общую общего
язык: язык языком
свой: своими своем своих
отношение: отношение
заболевание: заболеваниям
место: место
эпоха: эпохи
исключительно: исключительно
сородич: сородичей
сушка: сушкой сушка
пришелец: пришелец
первый: первом первому первую
эксперт: экспертов
купать: купать
камень: камнем
несклонный: несклонна
озлобить: озлобленные
упрямство: упрямством
высота: высоте высота
вконтакте: вконтакте
свет: свет
рядом: рядом
повтор: повторы
сходить: сходит
секция: секции
создать: создать
разновидность: разновидности
безобидный: безобидные
роль: роль
хозяин: хозяин хозяином хозяевами хозяину хозяина
кожа: коже кожа кожи
немаловажный: немаловажный
развитие: развитие развития
ценник: ценник
французский: французского
животное: животных животным животного животными животное
различие: различия
осуществляться: осуществляться
моляр: моляры
временной: временные временным
переводить: переводить
делить: делят делить
волос: волос
длина: длины длина длину
источать: источает
выбрать: выбрать
свисать: свисает
оценить: оцените
неприкосновенный: неприкосновенных
основать: основана
хотя: хотя
нижний: нижняя нижними нижней
кесарев: кесарево
хозяйский: хозяйский хозяйских хозяйского
видный: видны
сам: сами самой самого само
прочный: прочный
герой: героев
скула: скулах
рубиновый: рубиновых
форма: форму формы
пасть: пасть
проблема: проблемы проблема проблем
породный: породный
редкий: редчайшее редкая пореже редкий
убедиться: убедившись
носов: носовых
мероприятие: мероприятиях
заметный: заметный
предрасположенность: предрасположенности
разъезжать: разъезжающих
прядка: прядки
обходить: обходя
квартира: квартире
мера: меру мере
столкновение: столкновении
наконец-то: наконец-то
информация: информация
подходить: подходит
друг: друг другом другу
жилплощадь: жилплощадь
пригрозить: пригрозил
сустав: суставы суставами суставов
палец: пальцами
интересный: интересным
будущее: будущем
проводить: проводить проводите
передний: передними передние передних
авторитет: авторитет
характер: характера характер
расходиться: расходившегося
крокет: крокеты
яблоко: яблока
крепкий: крепкие
воспринимать: воспринимать
ребёнок: детям
габарит: габариты
кончик: кончик
волосяной: волосяных волосяные
сравнительно: сравнительно
среди: среди
любой: любое любой
подушечка: подушечками
линия: линию линии
учесть: учесть учтите
окончание: окончаний
трусость: трусостью
двойной: двойного
проток: протоков
грудина: грудине
брахицефал: брахицефалы брахицефал
придавать: придающей
считаться: считается
собаковод: собаководов собаководы
кто: кем
воспаляться: воспаляется
высокомерный: высокомерными
линька: линькой линька
вручную: вручную
просто: просто
проходиться: проходиться
непослушание: непослушании
оттянуть: оттянут
скрашивать: скрашивать
обязать: обязано
палочка: палочкой
подождать: подождать
снизить: снизить снизит
найти: найдет
заливистый: заливистым
успешный: успешного
находить: находить находят
обозначить: обозначенной обозначены
достоинство: достоинством
согревать: согревающей
покорять: покорять
домашний: домашней
молочный: молочные молочных
квадратный: квадратный
европейский: европейского европейских
западный: западных
одиночество: одиночеством одиночеству
лапа: лапой лапами лапы лап
территория: территории
декоративный: декоративная
женский: женского женской
температура: температур
нависать: нависающая
добавить: добавьте
чистка: чистка
социализация: социализацию
фокус: фокусы
дог-шоу: дог-шоу
умеренный: умеренная умеренной
конкретный: конкретнее конкретном
происхождение: происхождения
лапка: лапки
наследственный: наследственные
резец: резцы
необходимо: необходимо
следующий: следующими
готовый: готовы готов готовое
какой-нибудь: какой-нибудь
задний: задние задних
гидроцефалия: гидроцефалия
переносица: переносице
разрез: разрез
деятельность: деятельность деятельности
терпеть: терпеть
дрессировка: дрессировка дрессировке
время: время временем
агрессивность: агрессивность
требовать: требует
наказание: наказания
начать: начали
держать: держит
американский: американский
возникать: возникать
труднодоступный: труднодоступные
толстой: толстого
умение: умений умением
небо: неба
занятие: занятием
отдельный: отдельные отдельный отдельных
например: например
дискомфорт: дискомфортом дискомфорт
несколько: несколько
сетчатка: сетчатки
грозить: грозит
лёгкий: легкой
обидеть: обидеть
делиться: делиться
понять: понял понять
тёмно-коричневый: темно-коричневый
резко: резко
к: ко
положительно: положительно
реклама: реклама
нюанс: нюанс
оказываться: оказываться
минимальный: минимальные
остальной: остальные остальном остальное
полагаться: полагается
выраженный: выраженным выраженные
эйк: эйка
дистихиаз: дистихиаз
процедура: процедуру процедуры процедура
угольно-чёрный: угольно-черный угольно-черного
внимание: вниманием внимание
непосредственно: непосредственно
рекомендоваться: рекомендуется
спокойно: спокойно
отдать: отдайте
губа: губ губы
получиться: получится
воспитание: воспитание
грубость: грубость
здоровый: здорового здоров
увеличить: увеличило
выстригание: выстригание
пощипывать: пощипывать
кровообращение: кровообращение
заражение: заражения
который: которыми которого котором которых которым которые который
вырывать: вырывать
прочее: прочему
располагаться: располагается располагаются
сайт: сайту
увлечься: увлеклись
завершаться: завершается
длинный: длиннее длинная длинной
весёлый: веселом весел
смена: смена
выпуклый: выпуклым
дополнительный: дополнительных
чей: чьей чья
позволять: позволяет
сосуществовать: сосуществовать
полезно: полезно
ослиный: ослиным
водород: водорода
недуг: недугов недуги
крупный: крупная
купировать: купированные купировать
мириться: мирятся
пытаться: пытается пытаются
экстерьер: экстерьер экстерьеру экстерьера
потрясать: потрясающая
трое: троих
форум: форум форуме
пацифист: пацифисты
малый: малый малых
стоп: стопом
предпочтение: предпочтение
разумный: разумной
подтянутый: подтянутый
протяжение: протяжении
незначительный: незначительной
просматриваться: просматриваться
минимизировать: минимизировать
скопиться: скопившийся
атрофия: атрофии
дверной: дверного
действие: действия действие
усов: усов
отверстие: отверстий
боль: боль
сезонный: сезонно
тяжело: тяжело
полакомиться: полакомиться
игровой: игровую
внести: внесет
положение: положение положения
советовать: советуют
вызревание: вызревания
человекоориентированность: человекоориентированность
любитель: любители
скоро: скоро
мясо: мяса мясо
усатый: усатый
подтверждение: подтверждение
меланхолия: меланхолией
разнообразный: разнообразные
злоба: злобы
ресница: ресниц
натуральный: натуральной
ремесло: ремеслом
описание: описание
один: одна одной одну
убирать: убирать убирающей
начало: начало
хлоргексидин: хлоргексидином
нормальный: нормальные нормальный
белый: белых
полениться: поленится
гребень: гребень
однако: однако
пражский: пражский
удобный: удобной удобные
подмешать: подмешаны
тельце: тельцем
становиться: становится
поэтому: поэтому
близкий: близком
питательный: питательнее
предлагать: предлагают
наличие: наличием наличии
копирование: копирование
дружелюбный: дружелюбная
придумывать: придумывая
активность: активность
юный: юный юных
дружелюбность: дружелюбность
равный: равна равного равные
незнакомец: незнакомцам
пясть: пястей
плавно: плавно
доставить: доставить
отзыв: отзывах отзывы
нога: ноги ногами ногах
развернуть: разверните развернутыми
остаться: остались
задокументировать: задокументирована
псевдоголодный: псевдоголодные
кошка: кошки
следовать: следует
неприятный: неприятный неприятные
нереально: нереально
ускорить: ускорите
пожелать: пожелает
привлечь: привлечь
шум: шум
физический: физическое
широкий: широкий широкая
пожилой: пожилых пожилым
особь: особи особей
возрастной: возрастную
метка: метки
наблюдать: наблюдать
сквозняк: сквозняков
мопс: мопсов
пах: паха
верхний: верхние верхних верхняя
отличие: отличие
рамка: рамки
допустимый: допустимо допустимы
настоятельно: настоятельно
назад: назад
недокорм: недокорм
планировать: планируете
поначалу: поначалу
отчётливый: отчетливыми
гном: гномов
заглядывать: заглядывайте
кость: кости
осторожно: осторожно
дом: дома доме
мочь: могут можете
локоть: локти
другой: других другими
порода: породы пород породами породу порода
присыпка: присыпка
приносить: приносят
ножницы: ножницами
объявление: объявления
медленно: медленно
шалость: шалости
основной: основные
жёсткость: жесткость
бородач: бородач бородачам
интеллект: интеллект
охранный: охранные
многие: многие
покупать: покупайте
прилегать: прилегать
культура: культуры
вес: вес
туалетный: туалетной
конец: конец
возраст: возраст возраста возрасте
линять: линяют
ежедневно: ежедневно
нос: носа носом нос
разведение: разведение разведения разведению
жидкость: жидкость
причина: причине
вероятно: вероятно
именно: именно
перекоситься: перекосившаяся
бородатый: бородатых
серьёзно: серьезно
ведомый: ведомые
носовой: носовой
вязать: вязать
продолжительность: продолжительность
идентифицировать: идентифицировать
сечение: сечение
слюнный: слюнных
штрих: штрихи
пища: пище
снимать: снимать
нежизнеспособный: нежизнеспособным
доминирование: доминировании
усердствовать: усердствовать
приостановить: приостановить
расположить: расположены
полотно: полотно полотнах
волосатый: волосатыми
зависимость: зависимости
одежда: одежду
раздражение: раздражения
подклеивать: подклеивают
продавец: продавца
подход: подход
вокруг: вокруг
депигментировать: депигментированная
черно-подпалый: черно-подпалый черно-подпалого
учиться: учиться
система: системе
никак: никак
утром: утром
слегка: слегка
любимый: любимая
фото: фото
смешно: смешно
маленький: маленького маленькие
заодно: заодно
кошачий: кошачьим
яндекс: яндекс
простой: простое
уголок: уголок
рука: руках рук
окунаться: окунаются
анальный: анальной
собственный: собственной собственную
участие: участие
вперёд: вперед
оставлять: оставлять
череп: черепа
ухо: уха ушами уши
объединять: объединяли
прямой: прямую
переусердствовать: переусердствовал
породистый: породистых
обязательный: обязательная
сбрасывать: сбрасывают
овчарка: овчарками
угол: углами
вредный: вреден
окрасить: окрашенная
полустоячий: полустоячую
инстинкт: инстинктами
журнал: журнал
весь: всей всему всем
ответственно: ответственно
ближний: ближнего
что-то: чем-то
игривый: игривые
делать: делать делает делают
морковь: морковь
заниматься: занимались
предстоять: предстоит
постав: постав
определить: определить
предпочитать: предпочитая
эклампсия: эклампсия
пищеварение: пищеварение
практиковать: практикующим
ширина: ширины
вываливаться: вываливающимся вываливающийся
порядок: порядка
нервный: нервных нервной
покров: покров покрову
брахицефальный: брахицефального брахицефальным
болезнь: болезни
уступка: уступки
требовательный: требовательная
ограниченный: ограниченной
отреагировать: отреагировала
приобретать: приобретая приобретать приобретает
клык: клыков
обоняние: обоняние
поедать: поедавших
либо: либо
помогать: помогают
требование: требование требований
незаменимый: незаменимая
поднять: поднять
какой: какие
образ: образом
существенный: существенные
взгляд: взглядом взгляды
превращать: превращали
придание: придания
детский: детская
подопечный: подопечным подопечному
отделить: отделена
тормозить: тормозящая
подвижность: подвижностью
обеспечивать: обеспечивают
изображение: изображения
собачка: собачки собачка
внимательно: внимательно
дисквалификация: дисквалификации
укусить: укусить
обезопасить: обезопасить
невооружённый: невооруженным
обновление: обновлению
эмоциональный: эмоциональные
дешёвый: дешевле
гастрономический: гастрономическими
селекция: селекции
пусть: пусть
низкий: низких
поддаваться: поддавайтесь
корпус: корпуса корпус
появляться: появляющихся
скакательный: скакательные скакательными скакательных
шесть: шесть
перекус: перекус
вести: ведет
коготок: коготки
несвоевременный: несвоевременная
строение: строения
взросление: взросления
встряхнуть: встряхнуть
помета: помете помета
хвост: хвосты хвост
дело: дело делами дела деле
звонок: звонка
распродажа: распродажи
перейти: перейти
постараться: постарается
зайти: зашел
очаровательный: очаровательное
сутки: сутки
статус: статус
акционный: акционный
усач: усачи
эксцентричный: эксцентричному
укоротить: укороченные укоротить укороченным
из-за: из-за
связываться: связываться
спонтанный: спонтанную
игрушечный: игрушечные
прижать: прижать
слово: слова
собранный: собранными
приплюснуть: приплюснутыми
бородка: бородка бородки
менее: менее
складка: складок складки
сигнал: сигнал
идти: идут
уровень: уровне
выстраивать: выстраивает
жёсткий: жесткой
кипячёный: кипяченом
воспринять: воспринял
подпасть: подпасть подпала
импровизированный: импровизированную импровизированные
конюшня: конюшнях
бельгия: бельгия
шалить: шалит
грудь: груди грудь
клетка: клетка
смещение: смещения
кавалер-кинг-чарльз-спаниель: кавалер-кинг-чарльз-спаниелей
костяк: костяк
обстановка: обстановке
флегматичный: флегматичным
заводчик: заводчикам заводчики
область: область области областью
рацион: рационе рацион
уделить: уделите
требоваться: требуется
масса: массу
вбок: вбок
альбион: альбиона
отучить: отучить
попрошайничество: попрошайничеству
запрет: запрет
кой: коем
связать: связано
посредством: посредством
день: день
спина: спины спина
конструкция: конструкция конструкцию
гигиена: гигиена
внешность: внешностью внешности
отклонение: отклонениями
выступать: выступать
копчёность: копчености
подобный: подобные подобных
придерживаться: придерживаться
изогнутый: изогнутую
ван: ван
небольшой: небольшие небольшой
устойчивый: устойчивого
ощущение: ощущения
необходимый: необходимую
зимний: зимнее
оценка: оценке
пора: пора пор
нетронутый: нетронутой
рубль: рублей
заводной: заводным
грубый: грубой
тот: тому
взрослый: взрослому
фактор: факторы
йорк: йорков
расчёсывание: расчесывания
вещь: вещей вещь
мочка: мочка
охладить: охлажденном
вечером: вечером
основательность: основательность
увлечь: увлеченный
чехословацкий: чехословацкий
подбородок: подбородке
полость: полости
иерархический: иерархической
слабо: слабо
игрушка: игрушки
ряд: ряды
дог: дог
персонаж: персонажами
аномалия: аномалии аномалия
корзинка: корзинкой
целенаправленно: целенаправленно
капризный: капризная
помидор: помидоры
выбирать: выбирая
иметь: имеет иметь имел имеют
умильный: умильный умильные
сбой: сбоям
стоимость: стоимость
пучок: пучки пучками
иначе: иначе
особенно: особенно
бок: бока
желательно: желательно
полноценный: полноценном
стрессосниматель: стрессосниматель
строго: строго
учебный: учебный
отвлечение: отвлечением
осмотреть: осмотреть
час: часов
машинка: машинкой
повседневность: повседневность
заменитель: заменитель
бактерия: бактерии
достаточно: достаточно
обязательно: обязательно
повышенный: повышенное
расти: растущих
причинить: причините
избаловать: избалованное
промежуток: промежутках
нуждаться: нуждающимся
пара: пару
мордашка: мордашками
неделя: неделю
подозрительность: подозрительности
однородность: однородность
двухмесячный: двухмесячные
клещ: клещи
реагировать: реагируют
популярность: популярность
неопрятный: неопрятный
размещаться: размещаться
охотно: охотно
понимать: понимать
несмотря: несмотря
сладость: сладости
купить: купить
часто: часто
дюрер: дюрера
графика: графика
ухаживать: ухаживать
игнорировать: игнорировать
давить: давить
промывать: промывать
дружелюбно: дружелюбно
смышлёность: смышленостью
вертикально: вертикально
сообразить: сообразит
призвать: призвано
разводить: разводили
усик: усики
ниша: нишу
период: периоды
ответить: ответить
голова: голова
взрослеть: взрослеющего
случай: случаях случае
пёсик: песика
предок: предки
наклонить: наклоненный
лицо: лица
обострённый: обостренное
характерный: характерен
деструктивный: деструктивным
услышать: услышать
фуфайка: фуфайки
кто-то: кто-то
поставить: поставленное
этот: этих
провокация: провокации
потребность: потребности потребность
постный: постного
бровь: брови
выставляться: выставляется
нежелательно: нежелательно
чистый: чистой
приподнять: приподнятое
домочадец: домочадцев домочадцем
крупа: круп
приходиться: приходятся приходится
благополучный: благополучное
погулять: погулять
патология: патологии
далеко: далеко
пример: примера
одноклассник: одноклассники
наследовать: наследуемых
диверсия: диверсии
волосок: волоски волосков
глазастик: глазастики
команда: команды команда
энергично: энергично
внутренний: внутреннюю внутренней
здоровье: здоровья здоровье
потряхивать: потряхивает
очередь: очереди
четырёхмесячный: четырехмесячном
случайный: случайные
край: край
тщательный: тщательнее
чётко: четко
кроме: кроме
кормёжка: кормежки
ринг: рингов
переизбыток: переизбыток
стандартизировать: стандартизирована
продукция: продукцию
нечего: нечего
частый: чаще почаще
слёзный: слезная
поиск: поиск
получить: получить
температурный: температурному
зуб: зубы зубов
важный: важные важный
усатик: усатик
прощать: прощать
разрешить: разрешено
тусклый: тусклой
узнать: узнает
применение: применением
белые: белые
выглядеть: выглядят
сажать: сажать
скрывать: скрывающий
явление: явление
ротовой: ротовой
урок: урок
кормление: кормлений кормления кормление
тыква: тыква
сделать: сделано
лакомство: лакомством
дезинфицировать: дезинфицирующие
обрастать: обрастают
память: память
порок: пороки пороками
главный: главным главная
слой: слоях
поясничный: поясничная
заходить: заходит
пигментировать: пигментированная
жизнь: жизни
абсолютно: абсолютно
наружный: наружную
забывать: забывайте
они: ними
отмереть: отмершие
выручить: выручат
вид: виде вид
бжу-баланс: бжу-баланс
плечо: плечи
запах: запах
пространство: пространства
нож: ножа
группа: группы
англия: англию
сигнализировать: сигнализируют
почесать: почесать
филирование: филирование
надоедливый: надоедливые
нужно: нужно
мимимишность: мимимишности
также: также
толчок: толчок
процесс: процесс
стеноз: стеноз
умный: умная
луковица: луковицах
настроение: настроение
покой: покоях
шёрстный: шерстный шерстному
момент: моменты момент
внутри: внутри
протеин: протеина
выходить: выходит выходят
выноситься: выносятся
весна: весной
окантовка: окантовку
прочёсывать: прочесывать
побег: побегам
формироваться: формируются
специальный: специальных
стандарт: стандарт
лежанка: лежанкой
некупированный: некупированный
отлов: отлова
прогулка: прогулок
далёкий: дальше
заняться: заняться
дозволить: дозволенного
умеренно: умеренно
оставаться: остается
влажный: влажная
волнообразный: волнообразной
грешить: грешит
высоко: высоко
агрессия: агрессию
вестись: вестись
сложно: сложно
крайне: крайне
записать: запишет
отварить: отваренными
стоить: стоит
это: это
срочно: срочно
притягивать: притягивает
переразвитый: переразвитым
филе: филе
щенячий: щенячьего
выбор: выбору
стараться: стараясь старайтесь
порка: порок
осложнение: осложнения
межсезонье: межсезонье
осуществлять: осуществляют
специфический: специфического
соперничать: соперничают
фольклор: фольклора
заинтересоваться: заинтересовалась
способный: способен
убрать: убрать
стол: стола
однажды: однажды
позитив: позитива
участок: участках участке
оставляться: оставляется
гриффонлео: гриффонлео
пребывать: пребывают
каша: каши
ровный: ровный
пощипать: пощипать
приятель: приятелей
легко: легко
ватный: ватной
тетания: тетания
утеплить: утепленную
идеально: идеально
трёхмесячный: трехмесячную трехмесячном
лента: ленту
производитель: производителей
огурец: огурцы
послеродовой: послеродовая
регулировать: регулировать
лоб: лбом
основательно: основательно
преодолеть: преодолевших
торчать: торчащие
кисломолочный: кисломолочную
бомонд: бомонда
крипторхизм: крипторхизмом
уверить: уверены
местный: местная
последовательность: последовательность
аффенпинчер: аффенпинчеров
мифология: мифологии
сила: силу
проплешина: проплешин
локтевой: локтевых
элемент: элемента
разногласие: разногласия
удивляться: удивляйтесь
чувствительный: чувствительных
вакансия: вакансии
прямо: прямо
дёрнуть: дернули
стекать: стекает
ограничение: ограничениям
компаньонский: компаньонские
двуногий: двуногий
свойство: свойствами
цель: цель
мир: мира
план: плане
вроде: вроде
корректировать: корректировать
доля: доли
дальнейший: дальнейшем
инструмент: инструментов
генетически: генетически
путать: путать
чистокровный: чистокровных
нагрузка: нагрузку
общество: общество
выше: выше
смочить: смоченной
злаковый: злаковые
заполонить: заполонили
переходящий: переходящие
управлять: управлять
удобно: удобно
бал: балы
чересчур: чересчур
подозревать: подозревают
отмечаться: отмечаться
растительный: растительном
прессовать: прессованные
повизгивать: повизгивает
удовлетворять: удовлетворять
появиться: появившееся
корм: корма
картофель: картофелю
кокер-спаниель: кокер-спаниель
рейтинг: рейтинг
генетический: генетических
навестить: навестите
мнение: мнению
член: членами
подписываться: подписывайтесь
несправедливость: несправедливость
знаменитый: знаменитый
получение: получения
присутствие: присутствие
самостоятельно: самостоятельно
прибегать: прибегают
соблюдать: соблюдать
катаракта: катаракты
затягиваться: затягивается
запретить: запрещено
наблюдательный: наблюдательны
очень: очень
лояльность: лояльность
возрождение: возрождения
особенность: особенности особенность
выполнять: выполнять
кпз: кпз
декоративность: декоративность
наоборот: наоборот
постепенно: постепенно
избежать: избежать
кличка: клички кличку
правило: правила
королевство: королевство
список: список
тряпочка: тряпочкой
зубной: зубным
славиться: славятся
лай: лаем
родовой: родовой
касаться: касается
выставочный: выставочных
действовать: действуя
конечный: конечном
свойственный: свойственны
проверка: проверку
удалить: удалить
подлежать: подлежат
перекись: перекиси
баланс: балансе
шампунь: шампуня
экстремально: экстремально
лидер: лидера
проект: проекте
головастый: головастые
брабансон: брабансон
повадка: повадки
прикосновение: прикосновения
кг: кг
естественный: естественном
сей: сих
среднее: среднего
риск: риск
обставить: обставить
мирный: мирной
отзываться: отзываться
рот: рот
страна: страна
инфекция: инфекция
низко: низко
чужак: чужака
ущемить: ущемили
кожный: кожных
четырехразовый: четырехразовый
шиворот: шиворот
посадка: посадка
волна: волне
причём: причем
развить: развитая
тонко: тонко
депрессия: депрессиями
уезжать: уезжать
закрутить: закручен
лицевой: лицевой
есть: едят
вольер: вольер
временно: временно
конечность: конечности
оба: оба
бобовый: бобовым
водить: водите
пушистый: пушистых
арнольфиня: арнольфини
сезон: сезона
сон: сне
мускулистый: мускулистые
городской: городским
грызун: грызунами
гораздо: гораздо
переделать: переделает
встречаться: встречаются
резкий: резкими
демонстрировать: демонстрировать
зима: зиму
типичный: типичные
запрещать: запрещают
