америка: америке
туалет: туалет туалетом
короткий: короткую короткие короткая короткими
стоптать: стоптанными
заметить: заметили
овощ: овощи
корочка: корочек
отличать: отличают
гулялачтый: гулялачто
кровь: крови
широко: широко
преодолевать: преодолевают
средний: средняя среднее средних средней
неповторимый: неповторимым
оставить: оставят оставить оставленный
пельман: пельман
познакомить: познакомить
чёрный: черный
сколько: сколько
своевременный: своевременной
быть: будете будьте будут будем
предсказать: предсказать
название: название названием названия
свежий: свежий
расслоение: расслоение
домой: домой
собака: собаку собак собака собаках собакам собаке собаки
примерно: примерно
процесс: процессом процесс
крыло: крылья
вывести: вывести
противный: противным
тонкий: тонкое
переезд: переезда
хороший: лучшим хороших хорошим хорошему хороший хорошими лучшими
извлечь: извлеките
заранее: заранее
возникать: возникают
ноздря: ноздри
прикус: прикусе прикус
справляться: справляются справлялись
склонность: склонности склонность
обсуждение: обсуждения
отношение: отношениях отношение
следовать: следуют следует
рыбный: рыбное
миска: миску миски
цена: цена цену
перекрываться: перекрывается
реальность: реальности
освободить: освободил
основательность: основательности
любимый: любимых
псиный: псины
подушечка: подушечки
любой: любая любую любые любой
материал: материалов
бассет-хаундать: бассет-хаундам
бассет: бассет бассетам бассеты бассетов бассета
спинка: спинку
скорбный: скорбное
рефлекторно: рефлекторно
массивный: массивным массивный массивные массивной
поведение: поведения
вымыть: вымыть
след: след следу
охотиться: охотятся охотиться
собственный: собственных собственный собственного собственными собственные
любовь: любовь
сторона: стороны
дисквалифицировать: дисквалифицирующие
брызги: брызг брызги
упругий: упругим
перейти: перешла перейти
больший: большим
активизироваться: активизируется
норный: норного норной
свойственный: свойственные свойственна
семейство: семейства
субпродукт: субпродукты
выраженный: выраженный
сомкнутый: сомкнутые
подъезд: подъезда
зато: зато
россия: россия россии
живот: живот живота
протирание: протирание
морда: морде морды мордой
национальный: национального
обратный: обратная
отчётливо: отчетливо
тотальный: тотальная
гнить: гниющих
представитель: представителей представителям представителями представители
отвлечь: отвлечь
шея: шея шеи
особенность: особенностью особенности
традиционный: традиционная традиционным традиционной
специфический: специфическая
шерсть: шерсть шерстью
место: местами место
ушастый: ушастого ушастая
низкий: низкий низкая низкой
запрет: запрета запрет
грязнуля: грязнулю
буквальный: буквальном
объявиться: объявились
заводчик: заводчиками заводчики
меланхолик: меланхолик
бровь: бровей
пакостить: пакостит
должный: должны должен должно должна
тип: тип типов
узкий: узкая
колоссальный: колоссальная
перфекционист: перфекционисты
месяц: месяц месяца месяцев
тишина: тишины
большой: большой
существенный: существенный
великобритания: великобритания
бладхаунд: бладхаундами
локатор: локаторы
включая: включая
нога: ног ноги
артезиано-нормандский: артезиано-нормандские артезиано-нормандский артезиано-нормандских
отличаться: отличается
дежурить: дежурить
дополнительный: дополнительный дополнительного
хаундсейчас: хаундсейчас
собирательство: собирательства
небольшой: небольшое небольшие небольшими
эксклюзивный: эксклюзивная
иллюзия: иллюзию
знать: знали знает
моментально: моментально
встретить: встретить
морщинистый: морщинистыми
история: история
недюжинный: недюжинным
щенок: щенка щенков щенки щенок щенкам
ножка: ножками ножки
проявляться: проявляется
лестница: лестниц
приходить: приходит
свидетельствующий: свидетельствующими
выгул: выгул выгула
обязательный: обязательный
желудок: желудке
стимулировать: стимулирует
питомец: питомцев питомец питомца питомцем
взрослый: взрослый взрослых
каждый: каждого каждый
форма: форма форму
туалетный: туалетные туалетным
юный: юного
особый: особое
комбинезон: комбинезонах
запас: запасом
толчок: толчку
уязвимый: уязвимое
нередко: нередко
рьяно: рьяно
воронка: воронки
характеристика: характеристика
выставка: выставках выставке
рабочий: рабочая рабочим
такой: таком таких такие такая таким
руб: руб
лошадь: лошадью
дом: дому дома доме
фекалия: фекалиях
коротколапый: коротколапые
зарождение: зарождения
средне-коричневый: средне-коричневый
ушастик: ушастики ушастика
пахнуть: пахнет пахнуть пахнут
часок: часок
надоедать: надоедают
валяться: валяется валяясь
вид: виды видом
месячный: месячный месячного месячных
еда: еды еду
коготь: когти
порода: породе породы порода породой
стать: стала стали станет
дегтярный: дегтярным
снежный: снежные
вытерпеть: вытерпеть
выйти: вышли
выторговать: выторговать
быстро: быстро
маленький: маленькой маленький маленького меньше маленькая
раскрыть: раскройте
основное: основном
охватывать: охватывает
бассет-хаунд: бассет-хаунду бассет-хаунда бассет-хаунд бассет-хаунды бассет-хаундов
видео: видео
помимо: помимо
отпускать: отпускайте
трубка: трубку
защитить: защитить
свисать: свисают свисающей свисающие
понравиться: понравившегося
меню: меню
вода: воды вода
полностью: полностью
улица: улицу улице
поступаться: поступается
требование: требованию
пёс: псы пес пса псами
холодный: холодную
тело: телу тело
брылей: брылей
куполовидный: куполовидную
вдобавок: вдобавок
фауна: фауны
остаток: остатков
владелец: владельца владельцев владельцами владелец
фигурировать: фигурировали
чай: чай
очёс: очесов
диван: диванах диванам дивана
гордый: гордый
ваш: вашу вашей ваш
охотник: охотника охотников
образ: образ образом
проблематично: проблематично
физиология: физиологии
ровный: ровными ровным
содержание: содержание содержания
оперный: оперными
раздуться: раздуется
перина: перинам
сера: серы
нужный: нужны
работа: работе
мина: миной мину
немного: немного
живой: живом
рекомендовать: рекомендуют
какой-то: какой-то
атлет: атлетами
угнаться: угнаться
киста: кисты
оставаться: остаются остается
покидать: покидает
подвес: подвес
глюкозамин: глюкозамином
догонялки: догонялки
помёт: пометов
кстати: кстати
связь: связь связи
примерный: примерный
другой: другую других другим
точно: точно
выступать: выступающие выступающим
выделять: выделять
потешный: потешные потешный
клуб: клуб клуба
жизнерадостный: жизнерадостный жизнерадостные
перевернуть: переверните
добавить: добавить добавили добавьте
ветер: ветра
мягкий: мягкой мягким
сохраняться: сохраняется
комфорт: комфорту комфортом комфорт
радужный: радужной
проходить: проходить
заподозрить: заподозрить
пока: пока
сменяться: сменяются
корпулентный: корпулентный
сводистый: сводистые
воздух: воздух
жильё: жилья
дословный: дословный
приземистый: приземистых
облюбовать: облюбовал
лежанка: лежанкам лежанку
толстокожий: толстокожие
скелет: скелет
типичный: типичный
структура: структуру
давать: давать давай
месть: мести
кислота: кислоты
смешной: смешные
плюсна: плюснами
перемена: перемены
выдающийся: выдающийся выдающиеся
расслабиться: расслабиться
обувь: обувь
французский: французских
хилый: хилые
частенько: частенько
раздобыть: раздобыть
идти: идешь
напоминать: напоминающие
предмет: предметы предмет
методика: методику
вечный: вечного
подтянутый: подтянута
крысарик: крысарик
плотно: плотно
определённый: определенные
стимул: стимулами
питьевой: питьевой
качество: качестве качества
слежка: слежка
бывать: бывают
смотреть: см смотрите
плюс: плюс
лёгкий: легкий легкой
фотография: фотографии
досмотр: досмотр
широкий: широкие широкой
невзирая: невзирая
пружинистый: пружинистому
коротконогий: коротконогим коротконогими
понимание: пониманием
расширить: расширила
уход: уходе уход
диагноз: диагноза
забросить: забросить
постель: постель
столько: столько
восторженный: восторженным
фосфор: фосфором
помнить: помните
результат: результат результате
дать: данной дать дай
практический: практического
питомник: питомники питомниках питомников питомнике
верхний: верхней
пара: пары пару
находиться: находиться
поладить: поладить
сложение: сложения
глаз: глаза глаз глазах глазами глазам
купить: купленными купить
прийтись: придется
оперировать: оперируют
часть: части часть
вкусняшка: вкусняшками
количество: количеством количество
толстой: толстая
сказать: сказать
поздний: позже
смысл: смысле
век: века веке век веку веков
перезагрузка: перезагрузка
собачий: собачьей собачьих собачье
предпочтительный: предпочтительный
остальной: остальными остальных остальные
звучный: звучный
взять: взяли
постоянный: постоянными постоянные постоянное
поскольку: поскольку
прочий: прочие
правило: правилам правило правила
повториться: повториться
пользоваться: пользуются
покупать: покупать
краткий: краткая
называться: называться
весьма: весьма
изобретать: изобретать
свой: своими своим своих свои
кухня: кухне
плотный: плотная
формироваться: формироваться
незаурядный: незаурядным
малыш: малышей
пятый: пятой
нести: несет
перевод: перевод
эксперт: экспертов
темно-карим: темно-карим
упрямство: упрямством
забывать: забываем забывать забывайте
вконтакте: вконтакте
отказаться: откажется
рядом: рядом
впечатление: впечатление
ария: ариями
секция: секции
брудастый: брудастый
час-другой: час-другой
ярко: ярко
конкретный: конкретное конкретный
мес: мес
хозяин: хозяин хозяину хозяев хозяина
пересечь: пересеченной пересекли
тонуть: тонуть
стопроцентный: стопроцентной
немаловажный: немаловажный
животное: животных животным животные животное
сомнение: сомнение
ножницеобразный: ножницеобразном
старый: старая
исключение: исключений исключения
любим: любимом
бег: беге
переводить: переводить
характер: характером характер
непринуждённый: непринужденном
лужа: лужи лужу
тон: тон
выбрать: выбрать
аромат: аромат
облик: облик
завязывать: завязывают
настоящий: настоящей настоящие
избавляться: избавляться
счёт: счет
основать: основана
сустав: сустава суставы сустав суставами
хотя: хотя
нижний: нижняя нижней
стандартизация: стандартизации
интеллектуальный: интеллектуальным
неустойчивый: неустойчивы
экипировка: экипировка
наш: наша наше
х: х
обманчивый: обманчиво
кожа: кожу кожи
первый: первому первых
шекспир: шекспира
двигаться: движущейся движется
сам: сами сама
попонка: попонку попонки
обладать: обладая
менять: менять
набирать: набирает
объёмный: объемное
пасть: пасть
опытный: опытный опытные
марафонский: марафонскими
прикрытие: прикрытием
костяк: костяка костяком
породный: породный породной
свободно: свободно
познакомиться: познакомиться
беспокоить: беспокоить беспокоит
рукопись: рукописях
страсть: страсть
квартира: квартире
размер: размеры размер
официально: официально
два: двум двух
информация: информация
складка: складками складок
взлететь: взлетит
послушный: послушного
михаилович: михайловна
продираться: продираться
желать: желают
жилплощадь: жилплощадь
надеяться: надеяться
будущее: будущем
свинья: свинью
прогулка: прогулку прогулки прогулок прогулке
пробежка: пробежками
год: годам лет год годов году
ниже: ниже
кошка: кошкой кошки кошек
эгоизм: эгоизма
половина: половины
творить: творят
мириться: мириться
окрас: окрас окрасы
пухлый: пухлые
ежедневный: ежедневный
воровство: воровство
охотничий: охотничьими охотничьим охотничьей
крепкий: крепкие крепким крепкий
польза: пользой
прямой: прямом
маскироваться: маскироваться
ощупь: ощупь
среди: среди
шорох: шороха
изображаться: изображались
фазан: фазана фазанов
разновидность: разновидностям
категорически: категорически
линия: линию линия линий линии
официальный: официального
развести: разведенной
интенсивный: интенсивнее
длинный: длинные длинный длинную длинными
считаться: считается считаются
беззащитный: беззащитный
нырять: нырять
развитой: развитыми
стянуть: стянуть
подход: подходе
пол: полу
нелишний: нелишний
двухцветной: двухцветными
вручную: вручную
напор: напором
просто: просто
аллергия: аллергия
изюминка: изюминка
мало: мало
кишка: кишок
овальный: овальная
снизить: снизить
кашица: кашицу
съестной: съестное
бархатистый: бархатистое
сдерживать: сдерживать
неприятно: неприятно
вынужденный: вынужденным
подчеркнуть: подчеркнуто
подпалина: подпалинами
слюнтяй: слюнтяи
ковёр: ковре
одинаковый: одинаковым
принять: принято приняло приняли
вислоухий: вислоухая
волочиться: волочащиеся
подложить: подложил
фанатизм: фанатизма
пощупать: пощупайте
инструкция: инструкциями
фрукт: фрукты
домашний: домашней
молочный: молочные
одиночество: одиночеством одиночеству одиночество
газета: газета газете
который: которое которой котором которая которых которым которые которому который
несформированный: несформированным
вмешательство: вмешательства
ездить: ездить
претендовать: претендующее
выражение: выражение
волос: волоса
светлый: светлой
обиженно-печальный: обиженно-печальное
умный: умен
дог-шоу: дог-шоу
умеренный: умеренная умеренное умеренным
происхождение: происхождения
лапка: лапки лапках
козинец: козинец
эластичный: эластичной
неприятный: неприятной неприятного
безупречный: безупречную
начаться: началось начался
необходимо: необходимо
готовый: готовы
пузик: пузик
сибарит: сибарит
пища: пищи пищу
какой-нибудь: какой-нибудь
задний: задние задних
редкий: реже редкого
виртуозно: виртуозно
увидеть: увидела
гончий: гончая гончей гончим гончих
спешка: спешке
упрямец: упрямцем
терпеть: терпеть
дрессировка: дрессировка дрессировки
предплечье: предплечья
стандартный: стандартный стандартной
время: время временем
карабкаться: карабкаясь
сука: суки
подозрительный: подозрительное
толстый: толстыми толстые толстых
агрессивность: агрессивность
ушной: ушной ушное
требовать: требует
день: дней день
погода: погоду
местность: местности
отлучка: отлучку
показывать: показывает
историк: историков
блюдо: блюдо
паинька: паинек
пугаться: пугается
просмотр: просмотров просмотра
купать: купая купают
кусаться: кусаться
квалификация: квалификаций квалификация
подкормка: подкормки
слиться: слилась
витамин: витамином
мутация: мутацией
валежник: валежник
например: например
несколько: несколько
личность: личность
родина: родиной родине
рост: рост
напасть: напала
ответ: ответа ответ
потомство: потомство
отечественный: отечественных
согласно: согласно
уплетать: уплетает
пакость: пакостям пакости
чипированный: чипированного
правильный: правильном
хотеться: хочется
стараться: стараемся
поторговаться: поторговаться
реклама: реклама
соответственно: соответственно
наклон: наклоном
говядина: говядиной
чёрно-белый: черно-белыми
понять: поймет понять
низкорослый: низкорослых
печальный: печальной
принцип: принципами
отказываться: отказываться
франция: франция франции
кангала: кангал
полагаться: полагается
ущемление: ущемление
процедура: процедуру
внимание: вниманием внимании
захватывать: захватывало
болезнь: болезнь болезни болезнью
мочка: мочки
мозговой: мозговые
получиться: получится получилось
губа: губ губой
воспитание: воспитание
внутрь: внутрь
уксусный: уксусной
понятно: понятно
один: одно одной
здоровый: здорового здоров здоровый
обнаружить: обнаружите
быстрорастущий: быстрорастущая
связать: связана
дичь: дичи
мысль: мыслями
околачиваться: околачивается
кровообращение: кровообращение
опустошать: опустошает
добавлять: добавлять
закрепить: закрепленной
добиться: добиться
поблажка: поблажки
сайт: сайту
подниматься: поднимайтесь
гусеница: гусеницы
лакать: лакать
специалист: специалисту специалист
активный: активный
полезно: полезно
число: числу числа
бассет-хаундом: бассет-хаундом
реагировать: реагирует
конкурсант: конкурсантов
этот: эта
зверский: зверскому
вымах: вымаху вымах
лишь: лишь
что-то: что-то
вариант: вариант варианты
борзая: борзых
называть: называемый
выводить: выводить
постановка: постановки
вредность: вредностью
адаптировать: адаптировать
форум: форум форуме
упорный: упорного
заворот: завороту
стоп: стопом
хитреца: хитрецы
предпочтение: предпочтение
конец: конце конец
минимизировать: минимизировать
элементарный: элементарной
образовать: образуя образующей
магнит: магнит
меланхоличный: меланхоличное
присущий: присущее присущая
мальчик: мальчики
переставать: перестает
хозяйский: хозяйскую хозяйских
советовать: советуют
переборщить: переборщить
попадаться: попадаются
завернуть: завернутые
ходить: ходили ходить
явный: явной явный
этап: этапе этап
светлоокрашенный: светлоокрашенных
избирательность: избирательность
разработать: разработать
натаска: натаске
рельеф: рельефа
земля: земли
достаточный: достаточную
описание: описание
травяной: травяными
начало: начало
разозлить: разозлил разозленным
ненапряжный: ненапряжно
расти: растущим
амбре: амбре
декоративный: декоративные декоративный
лопатка: лопатки
неуклюжий: неуклюжий
источать: источают
ответить: ответит
однако: однако
пражский: пражский
парижский: парижской
перенести: перенести
отсутствие: отсутствием отсутствия отсутствие
поэтому: поэтому
коричневый: коричневый
копирование: копирование
дружелюбный: дружелюбная
нужда: нужду нужды
попытаться: попытаются попытайтесь попытаться
активность: активность
подверженный: подвержены
подсадить: подсажены
вьетнамка: вьетнамками
призыв: призыва
опахалообразный: опахалообразные
осматривать: осматривайте
дружелюбность: дружелюбность
отделиться: отделились
подхватить: подхватила
зима: зимы
плавно: плавно
отзыв: отзывах отзывы
сугроб: сугробах
развернуть: разверните
кровяной: кровяному
хобби: хобби
перемещение: перемещения
критика: критику
животный: животному
грызть: грызет
шум: шум
благоухание: благоухание
поиграть: поиграйте
особь: особи особям особей
раздутость: раздутости
уровень: уровня
псовина: псовина
резиночка: резиночкой
минимальный: минимальной
отличие: отличие
прыжок: прыжках
аксессуар: аксессуар аксессуары
назад: назад
преимущественно: преимущественно
слой: слоем слоях
наталия: наталия
мочь: могут можете
сегодняшний: сегодняшний
точка: точкой
неутомимый: неутомимого
кровать: кровати
адрес: адреса
обезжиренный: обезжиренный
обидчивый: обидчив
мутоновый: мутоновой
целое: целом
объявление: объявления
делать: делайте делать делает делающие
основной: основные
решение: решение
мячик: мячик
бытовой: бытовые
интеллект: интеллект интеллектом
охранный: охранные
многие: многие
дорогой: подороже
средне: средне
вес: вес
обязать: обяжет
шлёпнуть: шлепнуть
поднять: поднят
полотенце: полотенцем
план: план плане
намокать: намокает
голос: голос
линять: линяют
ежедневно: ежедневно
коренастый: коренастый
разведение: разведение
подобный: подобная
заметка: заметки
минировать: минируют
морщина: морщины
положить: положено
намеренно: намеренно
абсцесс: абсцессы
причина: причине причин
именно: именно
серьёзно: серьезно
единожды: единожды
выбросить: выбросить
устать: устал
продолжительность: продолжительность
набрать: набравшего
влажный: влажной
подопечный: подопечный
низкорослость: низкорослость
межпальцевый: межпальцевые
составлять: составлять
аппетит: аппетитом аппетиту
отлично: отлично
право: прав право
отдать: отдай
надёжный: надежных
запястье: запястья
оказываться: оказывается
окрестить: окрестили
полотно: полотно
развитие: развития
осень: осенью
способ: способом
вокруг: вокруг
привлекаться: привлекавшихся
никак: никак
утром: утром
слегка: слегка
тот: те тех тому
заканчивать: заканчивает заканчивая
навечно: навечно
английский: английской английский
псарня: псарнях
фото: фото
бобовый: бобовых
съедобный: съедобно
поникнуть: поникшие
густой: густые
яндекс: яндекс
обожать: обожают
рука: руках
массовый: массовый
гармонично: гармонично
участие: участие
режим: режим
британец: британец
хотеть: хотите хотел
оставлять: оставлять
вперёд: вперед
привычка: привычек привычки
мой: моем
агрессивный: агрессивен
найк: найками
лапа: лапы лапу
спина: спиной
эталонный: эталонными
холка: холке холкой
смочь: смогли
подкрепление: подкрепления
двор: дворе
инстинкт: инстинктами
журнал: журнал
программа: программой
высота: высота
заглянуть: загляните
удаваться: удавалось
повзрослеть: повзрослев
мастиф: мастиф
рыже-белый: рыже-белыми
нуждаться: нуждаются
гулять: гулять
возмущаться: возмущаться
внешний: внешним
предпочитать: предпочитая предпочитают
применение: применения
уходить: уходя
картофель: картофеля
настроение: настроения
неровный: неровного
получать: получают
нарушение: нарушение
ухо: ушами уши ушам
отнестись: отнестись
кривоножка: кривоножками
различимый: различимый
лоток: лоток лотку
совершенно: совершенно
контролировать: контролировать
обоняние: обоняние обоняния
либо: либо
добыча: добычи добычей
полуправда: полуправдой
минута: минут
оптимальный: оптимальной
строгий: строгое
патологический: патологическим
взгляд: взглядом взгляды
услышать: услышит
внимательно: внимательно
травмироваться: травмируются
ванна: ванну
зверь: зверя
спускаться: спускайтесь
ла-манш: ла-манш
мускулистый: мускулистое
создать: создана
условие: условий условиях
допустимый: допустимы
слюна: слюна слюны
кобель: кобели
двухразовый: двухразовую
согревать: согревающие
сопровождаться: сопровождаться сопровождается
вести: ведет ведите
разнообразие: разнообразие
обеспечивать: обеспечивая
походить: походите
состязание: состязания
дисплазия: дисплазией
слабый: слабыми
темп: темпе
пошаговый: пошаговыми
агент: агенты
немой: нем
увалень: увальня
скрещивание: скрещивания
реально: реально
профессиональный: профессиональными
из-за: из-за
главное: главное
максимум: максимум
шуба: шубы
действие: действие
игрушечный: игрушечные
закрученность: закрученности
начинать: начинает начиная
оболочка: оболочки
прохожий: прохожих
скакательный: скакательными
вывих: вывихом
менее: менее
охота: охота охоты
временной: временной
жить: живете живут
полноразмерный: полноразмерных
складчатость: складчатости
источник: источниках
прутик: прутиком
команда: командам команда
во-вторых: во-вторых
грудь: груди грудь
обстановка: обстановке
ткань: тканью
слишком: слишком
никто: никто
поощрение: поощрения
требоваться: требуется
потерпеть: потерпеть
кой: коем
забыть: забыть
ставить: ставящими
проделать: проделайте
гигиена: гигиена
подросток: подростков
обида: обиды
избавлять: избавляет
желание: желанием желания
печёночный: печеночный
массировать: массировать
снова: снова
орешек: орешки
оценка: оценке
полоса: полосы
появиться: появился
пора: пора пор
интерчемпион: интерчемпионов
рубль: рублей
исключить: исключить
завывание: завывания
сказываться: сказывается
вещь: вещей
вечером: вечером
паностит: паностит
искривление: искривления
возможный: возможен
увлечь: увлеченный
ищейка: ищейка
пугать: пугать
игрушка: игрушки
шерстяной: шерстяной
самолюбивый: самолюбивый
одёргивание: одергивания
сбить: сбить
весить: весит весят
основный: основное основная
жилище: жилище
иметь: имеет иметь имеют
волосяной: волосяные
стоимость: стоимость
наклонность: наклонностями
осмотреть: осмотрите
последний: последнее
особенно: особенно
душа: душой
желательно: желательно
спешить: спешите
учебный: учебный
щенячий: щенячьи
возле: возле
верх: верху
современный: современным
нравиться: нравится
приклеиться: приклеившуюся
диванный: диванного диванными
достаточно: достаточно
обязательно: обязательно
грязь: грязи
урок: уроков
раздражать: раздражает
проскакивать: проскакивать
стремление: стремления
сложность: сложности
нарушить: нарушить
квартирный: квартирной
ребёнок: ребенком
показатель: показателям
редко: редко
возраст: возраста возрасте
проказник: проказника
неделя: неделю
производить: производит
талант: талантам
приспособить: приспособлен приспособлена
пять: пять
анонсирование: анонсирования
охотно: охотно
англия: англии
фонтан: фонтаном
служебный: служебные
часто: часто
азарт: азартом
неглубокий: неглубокая
улучшать: улучшает
поставить: поставлены поставленные
характерный: характерная характерное
образоваться: образовались
ушко: ушки
леонбергер: леонбергер
давить: давить
волей-неволей: волей-неволей
пункт: пункт
хирургический: хирургического
упустить: упустит
коротенький: коротенькие
умеренно-глубокий: умеренно-глубокая
разбрызгать: разбрызганная
голова: голова
письменный: письменных
аджилить: аджилити
залом: заломы
автомагистраль: автомагистралей
внушительный: внушительную
мешкиплотный: мешкиплотного
начать: начал
трехцветной: трехцветными
искусственно: искусственно
неповоротливый: неповоротливой
хромота: хромотой
подшёрсток: подшерстка
руководствоваться: руководствуясь
племя: племени
мешать: мешающие мешает мешают мешать
весь: всем
сговорчивый: сговорчивых
вероятность: вероятность
различный: различных
джентльмен: джентльмен
пристанище: пристанище
избыточный: избыточный
одноклассник: одноклассники
падать: падали
челюсть: челюсть
послушание: послушания
правда: правда
предать: преданных
выход: выходов
возможность: возможности возможность
скорость: скорость
растение: растений
отдельный: отдельный
случайный: случайные
передний: передние передних
кроме: кроме
движение: движении
позволить: позволит
разница: разницы
представить: представив
компромисс: компромисса
чувство: чувство
параанальный: параанальные
справить: справив
отучить: отучили
периодичность: периодичностью
грибок: грибок
частый: чаще
породность: породность
поиск: поиск поиска
становление: становления
пробираться: пробираться
слышный: слышно
терпеливость: терпеливость
сравнивать: сравнивайте
тазобедренный: тазобедренного
зуб: зубы
вообще: вообще
нагружать: нагружайте
молодой: молодым
разлагаться: разлагающуюся
есть: ест
туда: туда
ловушка: ловушки
жительство: жительства
объясняться: объясняется
полезный: полезны
потребоваться: потребуется
исследовать: исследуйте
себя: собой
воровать: воровать
белые: белые
постараться: постараться
общительный: общительный общительные
шоу-класс: шоу-классом
шампунь: шампунем
кустарник: кустарника
окончательно: окончательно
болезненно: болезненно
пятно: пятно
вдоль: вдоль
лежать: лежать
незначительный: незначительных
служба: службу
закутаться: закутавшись
щётка: щеткой
помогать: помогали
обратиться: обратитесь
кормление: кормлений кормление
сделать: сделано
нос: нос
игра: игры
потребность: потребность
периодически: периодически
порок: пороки пороками
трапеза: трапезы
стандарт: стандарту стандарт
назвать: назвали
повод: повод
предок: предков
репутация: репутацию
оберегать: оберегающие
жизнь: жизни жизнь
ряженка: ряженку
абсолютно: абсолютно
создавать: создавая
они: ними
сильно: сильно
самый: самых
мешок: мешках
благодаря: благодаря
дело: дела деле
всё-таки: все-таки
видеть: видит
запах: запах запаха
кучка: кучку
питательный: питательно
грустный: грустные грустную
ловкач: ловкач
российский: российских
разговорчивость: разговорчивость
железа: железы
оттенок: оттенком
нужно: нужно
мимимишность: мимимишности
также: также
щёлкать: щелкают
корневище: корневищ
увлекаться: увлекающаяся
момент: моменты момент
светло-карим: светло-карим
мясистый: мясистыми
особенный: особенных
проход: проходы проход
внутри: внутри
покой: покое
возможно: возможно
динамичный: динамичные
сблизить: сближенные
сквозь: сквозь
весна: весной
удлинённый: удлиненное
внеплановый: внеплановые
крупяной: крупяные
одной-единственный: одной-единственной
корпус: корпус
брылястость: брылястость
облачить: облачить
каша: каша каши
кролик: кролики кролика
глубокий: глубоких глубокий
уважать: уважать
косточка: косточки
привести: привести
понаблюдать: понаблюдайте
посадка: посадкой посадка
потенциальный: потенциальной
попасть: попала
обжорство: обжорству
виллебранд: виллебранда
впоследствии: впоследствии
коммуникабельный: коммуникабельные
лакомство: лакомства
книга: книгах
натура: натура
свёрнутый: свернутая
сложно: сложно
крайне: крайне
коротколапик: коротколапики
стоить: стоит
это: это
срочно: срочно
растянуться: растянувшийся
естественно: естественно
существо: существа
притягивать: притягивает
бедро: бедрами
любить: любит
ворчать: ворчать
чашечка: чашечки
филе: филе
коротконожка: коротконожка
шаг: шагу
вопрос: вопрос
забитый: забитые
порка: порок
обучать: обучать
кормить: кормить
тройка: тройку
вполне: вполне
радовать: радует
испанский: испанский
нагрузка: нагрузка
излишний: излишней
устроить: устроит
крупный: крупные
терроризировать: терроризировать
уклад: уклад
ласка: ласки
равновесие: равновесия
ромашка: ромашка
личный: личных
частота: частотой
общий: общем
повышенный: повышенном
закрывать: закрывать
регин: регина
невозможно: невозможно
способный: способен способны
стол: стола
приучение: приучения
однажды: однажды
аккуратно: аккуратно
заинтересовать: заинтересовавший
вкусный: вкусные
взглянуть: взглянуть
пузырь: пузырь
легко: легко
манера: манера
пеший: пешая
привить: привитого
лента: ленту
хрупкий: хрупки
специальный: специальную
здоровье: здоровье
посудина: посудине
очищать: очищая
воспитать: воспитать
порция: порции
сочетание: сочетании
вверх: вверх
полоскать: полоскать
ошибочно: ошибочно
бассет-хаундами: бассет-хаундами
подпортить: подпортить
добавка: добавки
проветривание: проветривание
придать: придало
толк: толк
эмоциональный: эмоциональная
теоретически: теоретически
упорно: упорно
уверить: уверены
обижёнка: обиженки
расчёсывать: расчесывать
во-первых: во-первых
сила: силу
избегать: избегать
упорствовать: упорствует
вакансия: вакансии
поводок: поводок поводка
путать: путают
экстерьерный: экстерьерная
блестяще: блестяще
гастрономический: гастрономическое
удовольствие: удовольствиях
расположить: расположенными
обойтись: обойдется
протест: протест
постоянно: постоянно
засорить: засорены
вроде: вроде
подавлять: подавляющее
по-другому: по-другому
смахивать: смахивает
этикет: этикетом
следопыт: следопыта
трюфель: трюфелей
вор: вора
выше: выше
сыграть: сыграть
жёлтый: желтым
грыжа: грыжи
занятие: занятия
возбраняться: возбраняется
вот-вот: вот-вот
случаться: случается
прийти: придя
вчерашний: вчерашней
чересчур: чересчур
затылок: затылке затылком
покупка: покупка
повести: поведет
изгиб: изгиб
посадить: посажены
распахнуть: распахнутые
вырасти: выросли
большинство: большинство
главный: главная
практически: практически
полгода: полугода
рейтинг: рейтинг
умиротворённый: умиротворенным
дисциплина: дисциплины
длина: длину
смиренно: смиренно
подписываться: подписывайтесь
повязать: повязав
фолликул: фолликулы
вытянутый: вытянутая
настой: настоями
переносить: переносить
следовательно: следовательно
достигаться: достигается
означать: означает
мордочка: мордочкой
использовать: использовать
защёчный: защечных
кормёжка: кормежку
запретить: запрещено
среднестатистический: среднестатистической
очень: очень
обойти: обойти
исполнительность: исполнительность
час: часу
всевозможный: всевозможные
мелкий: мелким
находить: находящими
пройти: пройдя
трансформироваться: трансформируясь
свёртываемость: свертываемости
произойти: произошло
развеваться: развевающееся развеваются
интерес: интересы
отит: отитам
наоборот: наоборот
постепенно: постепенно
круп: крупом
кличка: клички
заросль: заросли
вблизи: вблизи
частность: частности
отыскать: отыскать
список: список
уединение: уединение
слизистый: слизистой
тряпочка: тряпочкой
готовиться: готовьтесь
саблевидный: саблевидная
касаться: касается
граница: границы
беспредельщик: беспредельщика
экстремально: экстремально
променад: променада
проект: проекте
сразу: сразу
получить: полученное
тайный: тайная
наследство: наследству
кг: кг
необходимость: необходимости
умиляться: умиляться
кефир: кефир
доносить: доносило
легавый: легавой
линька: линька
коленный: коленной
ошейник: ошейник
отслеживать: отслеживать
рацион: рацион
дверь: двери
страна: страна
гонка: гонкам
заботиться: заботиться
набивать: набивает
насолить: насолить
стая: стае
отучать: отучайте
наедине: наедине
полиция: полицию
лизнуть: лизнуть
причём: причем
развить: развитая
ситуация: ситуации
кальций: кальцием
рыжеватый: рыжеватыми
состригать: состригая
кинологический: кинологического
сосед: соседей
давно: давно
умело: умело
превращать: превращает
конечность: конечности
ожидание: ожидании
являться: является
хвост: хвост
учить: учат
случай: случае
негативный: негативные
убрать: уберите
хондроитин: хондроитином
гораздо: гораздо
г: г
недуг: недуг
колорит: колорита
коврик: коврике
эй: эй
казаться: казалось
