сегодня: сегодня
уход: уход уходе
предполагать: предполагающий
пемброк: пемброк
отлично: отлично
три: трех
смышлёный: смышленый
сам: сами
полустоячий: полустоячие
цирроз: цирроз
содержимое: содержимое
держаться: держится
близкий: близких близкие ближайших
неприятный: неприятных
затылочный: затылочный
частый: чаще
страна: страны стране стран страна
поиск: поиск
формироваться: формировался
шерсть: шерсти шерсть шерстью
повадка: повадками
семя: семян
кинолог: кинологов
банальный: банальное
считать: считайте
везде: везде
тело: тела тело
собаковод: собаковода собаководов
оказываться: оказываются
борный: борной
численность: численности
паста: пасту
атмосфера: атмосферу
короче: короче
зубной: зубную
привести: привело
контактный: контактные
открыть: открыв
связка: связки связками
чёрный: черных черную черными
опускаться: опускается
здоровый: здоровых здоровая
корсар: корсары
оттенок: оттенок оттенка
вообще: вообще
проблема: проблемы проблема
локон: локонов
накапливаться: накапливается
дело: делам дело
собака: собака собаку собакам собаке собакой собак собаки
тальк: талька
порода: породам породами пород породу породы порода породой
следить: следите
собаководство: собаководства
занятие: занятиях
сколько: сколько
отдельный: отдельной отдельные
волосок: волосков
размашистость: размашистости
свой: своей своем свои
полотно: полотно
скакательный: скакательного
характер: характер
миссия: миссия
висячий: висячих
название: название названии названия
свежий: свежий
квартира: квартире
весёлый: веселый
себя: собой
основный: основная
микс: микс
дать: даст
детский: детское детской детскую
официально: официально
польша: польша
вывоз: вывоз
сотня: сотен
период: период периоды
палевый: палевыми палевых палевый
информация: информация информацию
местный: местными местные
готовность: готовность
слегка: слегка
состоять: состоит
тот: те
тюфячок: тюфячками
помощь: помощи
плотный: плотным
сравнить: сравнить
скрещиваться: скрещивались
друг: друг друга
заранее: заранее
чемпионский: чемпионские
больший: большую большим большие
справляться: справляются
обсуждение: обсуждения
явление: явление
доктор: доктор
уметь: умеющие
год: год лет годов году
агрессия: агрессии
ротовой: ротовой
желать: желают
направление: направлении
цена: цена цены
фото: фото
инбридинг: инбридингу инбридинг
палец: пальцами пальцы
мадагаскар: мадагаскаре мадагаскар мадагаскара
сводистый: сводистыми
куст: кустах
треугольник: треугольник
проказник: проказником
преодолевать: преодолевать
очаровывать: очаровывающий
распространение: распространению
стена: стенах
допускаться: допускается
светлый: светлые
корить: корена
спинка: спинка
болезненность: болезненность
аппарат: аппарат
подушечка: подушечки подушечками
ремонт: ремонт
сделать: сделано
создавать: создавать создает
вы: вами
конкретный: конкретном конкретного
материал: материалов
ниже: ниже
удовольствие: удовольствием
перевод: переводе
племенной: племенные
пёс: пса
поголовье: поголовья поголовьем
болонка: болонок
животное: животного животными животные животное животным животных
потребность: потребность
родитель: родители родителей
периодически: периодически
окрас: окрас окраса
родословный: родословную
яндекс: яндекс
порок: пороки
главный: главными главных главная
память: память
такой: такое
австралийский: австралийским
ушной: ушное
считаться: считаются считается
хлопковый: хлопковой хлопковые хлопковым хлопковую хлопкового хлопковых
джей: джей
перекус: перекусом перекус
голосовой: голосовыми
рука: руках
некрупный: некрупным
недокус: недокус
польза: пользу
иностранный: иностранного
жизнь: жизни
поклонник: поклонники
союз: союзом
миниатюрный: миниатюрные
остальной: остальном
занимать: занимать занимает
ножницы: ножницы ножницами
кончик: кончик кончиком
зарасти: зарос
аллергический: аллергическим
стоять: стоят
заканчиваться: заканчивается
различный: различным
забывать: забывайте
растяжение: растяжениям
небольшой: небольшая небольшой небольшие
число: число
дуга: дуги
они: ними
дисквалифицировать: дисквалифицирующие
слабый: слабые
покупатель: покупателя
любой: любое
исполняться: исполняться
роберт: роберт
лапа: лапах лап
город: город
самый: самых самым
категорически: категорически
династия: династия
ребёнок: детьми
дикий: дикими
отклонение: отклонение
веко: веки
пинцет: пинцет
питомник: питомника питомники
который: которых которого которое которым которые которой который
россия: россия
спина: спиной спина
иммунный: иммунную
ухо: ушах уши ушей
холка: холке
морда: морде мордой
скрыть: скрыть
неугомонный: неугомонный
безвольный: безвольными
всё-таки: все-таки
ряд: ряда
обратный: обратная обратные обратном
богатый: богатых
подхват: подхвату
средний: средние среднее средний
затем: затем
продвигать: продвигает
святой: святой
вид: виде вид
нейтральный: нейтральные
почитать: почитала
бесконфликтный: бесконфликтно
видеть: видит
впервые: впервые
журнал: журнал
строгий: строгих
развитой: развитые развитой
линия: линии
представитель: представителей представителям представитель представители
наполеон: наполеона
заводить: заводите заводящие
шёрстка: шерстку
тонкий: тонкие тонким
высота: высота
грань: грани
горбатый: горбатая
обучение: обучению обучения
вокальный: вокальные
ваш: ваше вашей
косметика: косметики
шея: шея
переходить: переходит
стиль: стиль
глаукома: глаукома
просто: просто
основной: основной основные
компаньон: компаньон
аллергия: аллергия
располагать: располагает
дружба: дружбу
способный: способные
бедро: бедру бедром бедра
комик: комик
позитивный: позитивный позитивную
бороздка-потёк: бороздки-потеки
вырасти: вырастет
натуральный: натуральным
максимальный: максимальный
документ: документы документов
хлопок: хлопок
относительно: относительно
нужно: нужно
мимимишность: мимимишности
след: следов
одиночество: одиночества одиночеству
снизить: снизить
котон-де-тулеар: котон-де-тулеара котон-де-тулеар котон-де-тулеарами котон-де-тулеары котон-де-тулеаров
действие: действиями
вызывать: вызывают
также: также
экстерьер: экстерьера
коричневый: коричневыми коричневые коричневую
линейка: линеек
один: одним одной
умный: умная
собираться: собираетесь
метод: метод
несложно: несложно
нервный: нервных
породный: породного породных породному
значительный: значительном
закрутить: закрученный
лезть: лезут
болезнь: болезни болезнь
момент: моменты момент
сертификат: сертификат
целиком: целиком
хитрый: хитрые
исключение: исключение
исполниться: исполнится
покорять: покорять
возрастной: возрастной
норматив: нормативов
возможно: возможно
раздражение: раздражение
низкий: низкая
отзыв: отзывы отзывах
нежный: нежная
светло-серый: светло-серого
декоративный: декоративная декоративных
прошлое: прошлого
королевский: королевской королевских
либо: либо
месяц: месяц месяцев
анальный: анального
компанейский: компанейские
двигательный: двигательной
шкала: шкале
иметься: имеется
гипоаллергенный: гипоаллергенных
оставить: оставит
дверь: дверей дверь
локоть: локтей
сверху: сверху
корпус: корпус корпуса
выражение: выражение
общение: общения
активно: активно
участок: участки
добавить: добавьте
провокатор: провокаторами
питание: питанием
одинаковый: одинаковой
стандарт: стандарт стандартов стандарта
белый: белого белой белая белое белых
сера: сера
американский: американского
бишон: бишонами бишона бишонов бишоны бишон бишоне
предрасположенность: предрасположенность
чёткий: четкая
провоцировать: провоцирующая
суд: суда
сердечно-сосудистый: сердечно-сосудистой
участие: участием
прогулка: прогулок
обернуть: обернуть
умеренный: умеренная
происхождение: происхождения
заболевание: заболевания заболеваний
тёмный: темные
лапка: лапки
отдел: отдел
обучить: обучить
европейский: европейских
первый: первых первый первую
заблудиться: заблудиться
должный: должно
необходимо: необходимо
умеренно: умеренно
готовый: готовы
достигать: достигать
глаз: глаз глазами глаза
исторически: исторически
непоседа: непоседой
способствовать: способствует
многий: многим
встретить: встретить
обстоять: обстоит
история: история
положительный: положительным
постучать: постучат
выполнение: выполнение
внимательно: внимательно
фан-клуб: фан-клуба
ранее: ранее
щенок: щенка щенки щенок щенком щенков
бытовой: бытовых
команда: команда команд команды
округлый: округлая
сосед: соседями соседей
видно: видно
злопамятность: злопамятности
часть: частей часть части
дешёвый: дешевле
кобель: кобеля кобели
приготовить: приготовить
покупать: покупая покупать
запретить: запрещен запрещено
текстура: текстуру
похвала: похвалы
лёт: лету
подвес: подвеса
никакой: никакой никаких
практиковаться: практиковался
дрессировка: дрессировка дрессировки
выстригать: выстригать
стоить: стоит
это: это
время: время
питомец: питомцев питомца питомец
сука: суки сук
водиться: водится
приём: приемы
агрессивность: агрессивность
остров: острова острове
существо: существа
нехватка: нехватка
минимальный: минимальный
указанный: указанных
тесно: тесно
движение: движения
регулярный: регулярным
шесть: шесть
вязка: вязка
наказание: наказания
помета: пометах пометы
новозеландский: новозеландским
выпуклый: выпуклые
межкомнатный: межкомнатных
характеристика: характеристика характеристики характеристикам
край: краям
вариация: вариации
стоп: стоп
местность: местности
мадагаскарец: мадагаскарцы мадагаскарцев мадагаскарец
смотреть: смотреть см смотрит смотрите
случка: случкой
другой: другие других
аборигенный: аборигенной
неокрашенный: неокрашенные
применять: применяйте
поздний: поздний
сведение: сведению
родственник: родственников родственники
присущий: присущих
признать: признала
вполне: вполне
проживание: проживании
зарождение: зарождения
фенотип: фенотип
являться: являются
вельможа: вельмож
покупаться: покупайтесь
перейти: перейти
снимать: снимает
шоу-экстерьер: шоу-экстерьером
повод: поводу
продажа: продаже
хвостатый: хвостатых
офтальмологический: офтальмологические
например: например
карра: карре
несколько: несколько
еда: еды
податливый: податливый
из-за: из-за
главное: главное
регулярно: регулярно
сестра: сестрами
хозяйский: хозяйских
проверить: проверьте
спутаться: спутавшихся
отвлекаться: отвлекайтесь
рост: рост роста
психотерапевт: психотерапевт
голова: головы голова
номер: номера
ежедневный: ежедневным
пудра: пудра пудрой
потомство: потомство
десятка: десятке
удаление: удалении удаления
рождаться: рождается
крупный: крупным
качество: качества качестве качество
гигиенический: гигиенической
быстро: быстро
помогать: помогая
обидчивость: обидчивости
чистка: чистки
бороздка: бороздки бороздка
входить: входят входя
собачка: собачек
невольный: невольными
ухоженность: ухоженность
уровень: уровне
увозить: увозили
видео: видео
помимо: помимо
обследование: обследования
наклон: наклоном
использование: использование
раз: раза
изменение: изменения
мясо: мясом
международный: международный
заводчик: заводчиком заводчикам заводчики
легко: легко
мадагаскарский: мадагаскарскими мадагаскарского мадагаскарские мадагаскарская мадагаскарском мадагаскарских мадагаскарский
бешенство: бешенство
курортный: курортный
ветеринарный: ветеринарный ветеринарные
исчезновение: исчезновения
восстановление: восстановления
сплошной: сплошная
инфекционный: инфекционный
юморный: юморными
лента: ленту
производитель: производителей
разрешаться: разрешается
полностью: полностью
специальный: специальную специальные специальной
здоровье: здоровье здоровья
во-вторых: во-вторых
содержать: содержали
малоплодный: малоплодной
франция: франция
требование: требования
южный: южной
быть: будьте будут
продавец: продавец
цель: целью
компания: компании
полный: полном
домашний: домашних домашними
выраженный: выраженным
манера: манерам
типичный: типичное
служебник: служебник
вдобавок: вдобавок
область: область
отсутствие: отсутствие
ткань: тканью
угощение: угощения
вакцинация: вакцинация
белоснежный: белоснежный
слишком: слишком
мадагарский: мадагарские
мочка: мочки мочка мочку
ревакцинация: ревакцинация
выходец: выходцев
получиться: получится
воспитание: воспитание
вывезти: вывезенных
вывих: вывихам
мышечный: мышечной
предоставлять: предоставляет
потерпеть: потерпеть
вечер: вечер
лай: лай
скука: скуки
клуб: клубом клуб
обходиться: обходиться
параметр: параметров
запрет: запрет
признаваться: признаются
наследственный: наследственных
титул: титулы
мордочка: мордочка
картофельный: картофельного
хороший: хорошим хорошее
пакет: пакет
содержание: содержание содержания
покупка: покупке
разговорчивость: разговорчивости
родина: родина
парвовирусный: парвовирусный
занести: занесла
сероватый: сероватые
немного: немного
замечательный: замечательно
сайт: сайту
во-первых: во-первых
псалмовый: псалмова
гигиена: гигиена гигиеной
сухой: сухие
таможенный: таможенные
чередоваться: чередующихся
черепной: черепной черепная
стандартный: стандартная
задний: задних
плюс: плюсы
дорогой: дорогих
именовать: именовали
параллель: параллель
находиться: находились находятся
жёсткий: жесткого жесткая жестких
брат: братьями
дорогостоящий: дорогостоящей
разбирания: разбиранию
вакансия: вакансии
закрывание: закрыванию
соответствие: соответствие
согласный: согласна
оповестить: оповестит
реакция: реакциям
утверждать: утверждают
недуг: недугов
книзу: книзу
бедный: бедных
оценка: оценке
дугообразный: дугообразная
сочетание: сочетанием
претендент: претенденты
лишь: лишь
покой: покоя
прикус: прикус
приходиться: приходится
стимулировать: стимулируйте
эпицентр: эпицентре
долго: долго
опорно-двигательный: опорно-двигательный
называть: называемый
подбирать: подбирайте
лобный: лобная
мочекаменный: мочекаменная
попадать: попадают
постоянно: постоянно
лептоспироз: лептоспироз
форум: форум форуме
ориентирование: ориентированием
связь: связь
сосуществовать: сосуществуют
крик: крики
разведение: разведения
точно: точно
европа: европу
комплексный: комплексная
утро: утро
пират: пираты
контакт: контакта
увлечься: увлекшегося
позвонок: позвонков
паспорт: паспорт
длинный: длинная
голень: голени голенью
стандартизировать: стандартизировала
треугольничек: треугольничков
полость: полости
искать: ищите
выше: выше
облачко: облачко
отверстие: отверстия
рывок: рывки
потребоваться: потребуются
наличие: наличии
окрасить: окрашены
очищаться: очищаются
встреча: встречу
тип: типу
приход: приходе
анатомия: анатомии
владелец: владельцев
длина: длине длина длины
подкрепление: подкреплением
любитель: любители любителей
поселиться: поселился
спасать: спасают
прослеживаться: прослеживается
столетие: столетия
расчесывание: расчесываниям
хлопчатник: хлопчатника
пока: пока
променад: променад
осматриваться: осматриваются
короткий: короткие коротким
изгиб: изгиб
грумерский: грумерской
позволять: позволяющая позволяющей
корм: корма
выставка: выставок выставки
аллерген: аллергенов
система: систему системы
подравнивать: подравнивать
состояние: состоянии
иметь: имеет имеющие имевшие
признак: признак
внешний: внешние внешнее
порядок: порядков
прибегать: прибегали
описание: описание
волкодав: волкодав
прорисовать: прорисованы
практически: практически
хвост-свечка: хвост-свечка
катаракт: катаракта
смещение: смещению
возбудить: возбужденного
начало: начало
стоимость: стоимость
рейтинг: рейтинг
допустимый: допустимый
пропорция: пропорции
генетический: генетических
интеллект: интеллектом интеллект
граница: граница
приобрести: приобрести
штрих: штрихами
привозный: привозных
неплохой: неплохая
дважды: дважды
поддерживать: поддерживать
проход: проход
особенно: особенно
кислота: кислоты
зоопсихолог: зоопсихологов
застрять: застрявших
подписываться: подписывайтесь
обязательный: обязательные
лопатка: лопатки
щётка: щетку
гарантировать: гарантируют
развлекательный: развлекательным
вытянутый: вытянутое
протирать: протирать
соотношение: соотношения
строчка: строчку
мальтийский: мальтийских
поставщик: поставщиками
структура: структурой
найти: найти
печень: печени
обоснованный: обоснованному
заниматься: заниматься
стоячий: стоячие
вписаться: вписаться
означать: означает
рубеж: рубеж
подпортить: подпортит
собачий: собачьих
самостоятельно: самостоятельно
шумный: шумные
достаточно: достаточно
затылок: затылок
использовать: использовать
потеряться: потеряться
обязательно: обязательно
накапливание: накапливанию
хвост: хвоста хвост
хозяин: хозяина хозяин
бельмо: бельма
прилегать: прилегают
завиток: завитков
поэтому: поэтому
очень: очень
особь: особей особи
клетка: клеток
обойти: обойти
четыре: четырех
сквозь: сквозь
круглый: круглые
пёсик: песиков песика
пара: пару
энтерит: энтерит
показатель: показателям
поводок: поводка
консультация: консультацию
копирование: копирование
редко: редко
дружелюбный: дружелюбная
негатив: негатив
метр: метров
умение: умение умениям
фотография: фотографии
активность: активность активности
конфликт: конфликта
неделя: неделю
интерес: интересы
выщипать: выщипать
агрессивный: агрессивная
совместный: совместном
зоомагазин: зоомагазина
ирландский: ирландский
дружелюбность: дружелюбность
отправляться: отправляясь
обезопасить: обезопасит
отметка: отметки
разнообразный: разнообразных
присутствие: присутствии
основать: основал основана
заметить: замечено
создание: создания
слуховой: слуховой
избежать: избежать
круп: крупом
клоун: клоуна
подвижный: подвижные
стэнли: стэнли
куриный: куриным
кличка: клички
правило: правила
нога: ноги
частность: частности
несмотря: несмотря
список: список списки
поясничный: поясничный
высокий: высокая
хождение: хождению
купить: купить
крахмал: крахмала
часто: часто
надбровный: надбровные
разговор: разговоров
заняться: займитесь
коробочка: коробочки
кошка: кошки
устранение: устранения
имидж: имидж
прямой: прямые прямая
масса: массе
потеря: потерей
нереально: нереально
представить: представил
проказа: проказы
ушко: ушки
прижиматься: прижимающийся
резкий: резкие
электроошейник: электроошейника
лосьон: лосьоны
свободный: свободные
телефонный: телефонные
прийтись: придется
шум: шум
мягкий: мягкий
предположительно: предположительно
правящий: правящая
визг: визг
заметный: заметное
обильный: обильное
масть: масть
комплекс: комплексов
уборка: уборки
количество: количеством
непосредственность: непосредственностью
трюк: трюкам
вертикально: вертикально
процедура: процедуры
проект: проекте
контрастный: контрастный
гость: гостей
смысл: смысле
форма: форме
америка: америку
угол: угол
продолжать: продолжают
сербия: сербия
зуб: зубов
отличие: отличие
случай: случаях случае
скула: скулам скулы
поскольку: поскольку
беседа: беседы
дом: домах
набрать: набрав
зашифровать: зашифрованы
необходимость: необходимости
пользоваться: пользуются
сторона: сторону
способность: способностям
краткий: краткая
корея: кореи
пхунсан: пхунсан
уроженец: уроженцы
весьма: весьма
обзавестись: обзавестись
летний: летний
импортировать: импортированных импортированное
гепатит: гепатит
специалиста-породника: специалиста-породника
напоминать: напоминающей
база: базу
шалопай: шалопай
дефект: дефектами
мордашка: мордашке
задаток: задатками
линька: линька
судьба: судьба
отношение: отношение
цвет: цвет
кость: кости
работать: работают
блистать: блещет
место: место
сеть: сети
осветлять: осветляющей
идти: идти
образовать: образующая
обозначить: обозначены
пищевой: пищевая
мочь: могут можете
перечисленный: перечисленным
купание: купаниям
минимум: минимум
исключительно: исключительно
прядка: прядок
рф: рф
плечевой: плечевые
оказаться: оказались
эксперт: экспертов
завиваться: завивающаяся
вельша-корги: вельш-корги
грабить: грабя
км: км
осторожный: поосторожнее
лохматый: лохматый
важный: важный
депигментировать: депигментированные
шерстинка: шерстинок
узнать: узнаете
вконтакте: вконтакте
становиться: становятся
целое: целом
объявление: объявления
впечатление: впечатление
создать: создать
эталонный: эталонном
мария: марии
обычный: обычное
развить: развитая
глазок: глазки
рассесть: рассел
охранный: охранные
наполненность: наполненности
книга: книга
вес: вес
отличный: отличную
помск: помски
пример: примера
запоминать: запоминать
одноклассник: одноклассники
умело: умело
французский: французского
марка: марки
поднять: поднят
мальтеза: мальтезе
оценить: оценит
скорее: скорее
взять: взят взять
кормление: кормление
отрезвление: отрезвления
бугор: бугор
конечность: конечности
юго-западный: юго-западной
конец: конец
слезотечение: слезотечение
сша: сша
общий: общий
красота: красота
появление: появления
версия: версий
дисквалификация: дисквалификацию
нос: носа
приподнять: приподнятым
извлечение: извлечению
пособие: пособии
губа: губы
постав: постава
адекватно: адекватно
брать: берите
волос: волос
собака-долгожитель: собаки-долгожители
возможность: возможности
сходство: сходство
запереться: запереться
коробка: коробки
тон: тон
возраст: возрасте
выбрать: выбрать
узнавать: узнавайте
именно: именно
зуд: зуд
пыль: пыли
грудь: грудь
возможный: возможны
случайный: случайные
тщательный: тщательного
мясистый: мясистые
сумеречно-ночной: сумеречно-ночная
чётко: четко
собственный: собственные
подверженность: подверженность
условие: условия
реклама: реклама
сустав: сустава
г: г
хотя: хотя
нежелание: нежелание
продолжительность: продолжительность
интеллектуальный: интеллектуальным
сообразительность: сообразительности
х: х
несоответствие: несоответствие
серьёзный: серьезные
воронка: воронке
котон: котон
любопытство: любопытство
