вертикальный: вертикальные
выразить: выразить
овощ: овощи
ожирение: ожирения
событие: событий
повод: поводом повод
использовать: используя использованы используют использовать
тело: тела телу телом тело
колебаться: колеблется
широко: широко
популярность: популярности
средний: средняя среднее средний
удивительно: удивительно
уставать: устает
тусклый: тусклая
доберман: доберманы доберманом доберманами доберманов добермане добермана доберман
счастие: счастье
параллельный: параллельные
агрессия: агрессия
курьёз: курьезов
расти: растет
чёрный: черный
сколько: сколько
переименовать: переименовали
елена: елена
массивность: массивности
душа: души
название: название названия
домой: домой
собака: собаку собакой собак собака собаке собаки
любознательный: любознателен
физический: физических физической
симптом: симптомы
обсуждение: обсуждения
полицейский: полицейском полицейский
темпераментность: темпераментности
искривление: искривление
цена: цена цены
лечение: лечение лечению
спать: спит
достигнуть: достигшим
озлобление: озлобления
содержаться: содержится содержаться содержатся
подушечка: подушечки
напряжённость: напряженности
вызвать: вызвана
резвиться: резвится
материал: материалов
природа: природы природе природой природа
удовольствие: удовольствием
щетина: щетиной
сосед: сосед
предел: пределов пределах
доберман-пинчер: доберман-пинчер доберман-пинчеров
немецкий: немецком немецкого
оставить: оставить оставив
подпалина: подпалин
обратить: обратите
воспитываться: воспитывается воспитывались
след: след следы
стоять: стоят
любовь: любовь
обсохнуть: обсохнуть
сторона: стороны сторону
петербург: петербурга
хороший: хорошую хороших хорошего хорошим хорошие лучшего лучшие лучшем хорошее лучших
де: де
положительный: положительных
субпродукт: субпродукты
россия: россия россии
живот: живот животе
обратный: обратная
итог: итоге
достижение: достижение
справиться: справиться справится
следующий: следующих следующие
слабость: слабость
мероприятие: мероприятия
представитель: представителей представители
команда: команду команд команды команда
фактор: фактором
шея: шея
овчарка: овчарки
отмечать: отмечают
компаньон: компаньон компаньона
выплеснуть: выплеснуть
страна: страной странах страна
гарантировать: гарантирует
получать: получать
шерсть: шерсть шерсти
некупированный: некупированными некупированным
вынудить: вынужден
специально: специально
систематичность: систематичность
запретить: запрещена запрещено
кинолог: кинологи
подрезаться: подрезаются
качество: качеств качестве качествах качества
мышление: мышлением
воспитанный: воспитанную
применять: применять
возникнуть: возникших возникнет
один: одним одна одной
собака-аристократ: собака-аристократ
создатель: создателем
челюсть: челюсти челюстям
метод: метод методами
небольшой: небольшого небольшой
должный: должны должен должно должна
препятствовать: препятствовать
аллергия: аллергией
север: север
класс: класса
посадить: посажен посажены
сочетать: сочетающей сочетающим сочетающая
разница: разницу
холодный: холодный
ласковый: ласкова ласковым
сохранение: сохранения сохранении
человек: людям людей человеку человека человек
относиться: относится относятся
поселить: поселить
рождаться: рождаются
терпеливо: терпеливо
слабый: слабых
злой: злы
сверху: сверху
столь: столь
общий: общим общее общего общему
мышца: мышц мышцы
спустя: спустя
масть: масти
рост: росту рост роста росте
пинчер: пинчер пинчеров пинчеры
выраженный: выражен выраженными выраженной
верный: верный верного
важно: важно
дополнительный: дополнительный
тень: тени
помнить: помня помните
обучаться: обучается
признак: признаками признаки признаком признаков
дисквалифицировать: дисквалифицирующими дисквалифицирующим
виват: виват
история: история историй истории
щенок: щенка щенков щенки щенок щенку
эффективный: эффективным эффективные эффективнее
проявляться: проявляется
видно: видно
покупать: покупая покупать
поощрять: поощрять
заворот: заворота
прилегать: прилегающие прилегающим прилегает
форма: форма формы
парадоксальный: парадоксально
забывать: забывает забывайте
обучение: обучении обучение
кисломолочный: кисломолочные
базовый: базовых
наноситься: наносится
характеристика: характеристика характеристики характеристик характеристиками
стоп: стоп
происходить: происходящих
помощь: помощью помощь
успех: успеха успех успехи
уложить: уложенных
секунда: секунд секунду
птичий: птичьем
заводчик: заводчик заводчиком заводчике заводчиков заводчики
около: около
зарождение: зарождения
сроду: сроду
пятно: пятна пятен
уверенно: уверенно
тёплый: теплым
прийти: пришел прийти
подстилка: подстилка
подразумевать: подразумевает
еда: еды
коготь: когти
пэт-класс: пэт-класса
порода: породе породам породы пород породу порода
знание: знанием
осмотр: осмотров
палец: пальцы
быстро: быстро
кардинально: кардинально
квадратный: квадратная квадратный
входить: входят
частый: частое
отдел: отделы
роль: ролью
удаться: удалось
ракурс: ракурса
видео: видео
обследование: обследования
подойти: подойдет подойдете
ночной: ночной
тюрингский: тюрингский
организовать: организовать организован
данный: данном
меню: меню
очередь: очередь
полностью: полностью
никакой: никаких никакие
возникновение: возникновения возникновение возникновению
подобрать: подобрал
кошка: кошка кошки
возможный: возможные возможным
пёс: псы пес пса
способный: способно способный способна
каждый: каждой каждый каждому
вакцинация: вакцинация
спутник: спутник
владелец: владельца владельцев
жестокость: жестокость
такой: таких такое такие такая такого такую таким
мышечный: мышечной
понимать: понимаете понимать
бесконечно: бесконечно
соответствовать: соответствовала соответствующая
называть: называют
интернет: интернете интернет
проблематично: проблематично
беседа: беседа
содержание: содержание содержанию содержания
стать: станут стали стал станет став
судорожный: судорожная
предположить: предположить
работа: работе работы
защитный: защитной защитном
медикаментозный: медикаментозное медикаментозной
немного: немного
ложиться: ложиться
перловка: перловки
сокращаться: сокращается
предать: предан преданного
представление: представления
расчесать: расчешите
слово: слово словом
боязливость: боязливость
жить: живет живу живете
огромный: огромного огромной
оставаться: остаются остается
послушание: послушанию послушания
давать: дает
задача: задачей задач
ответить: ответят
макушка: макушки
прививка: прививках прививок
болезненный: болезненное
он: нему
связь: связь
выполнение: выполнению выполнения
переносить: переносит переносят
надёжный: надежного
позвонок: позвонка
клуб: клуб
система: система системы
схожесть: схожести
любящий: любящий
убедиться: убедиться
вода: воде
передний: передним передней передние
внешность: внешность внешностью внешности
короткошёрстный: короткошерстная
клеймо: клейма
брид-класс: брид-класс
длина: длине длиной длина
преступление: преступление преступлений
радужный: радужной
запись: записи
применительно: применительно
профилактический: профилактических профилактические
бедро: бедра
проходить: проходить
специфический: специфическое
рядовой: рядовая
сводистый: сводистые
постоянный: постоянных постоянный постоянные
перестать: перестанет
гулять: гуляем гулять
защита: защите
возраст: возрасту возраста
обойтись: обошлось обойтись
ехать: едет
природный: природные природных природный
исключить: исключено
позыв: позывы
уровень: уровнем
заниматься: заниматься занимающиеся
мебель: мебель
плотно: плотно
многочисленный: многочисленные
запрещаться: запрещается
принцип: принципу
преувеличение: преувеличение
мощь: мощи
смотреть: см смотрите
способность: способности
фотография: фотографии
широкий: широкие широкая широкое
сверхосторожность: сверхосторожность
работать: работать
современный: современные
уход: уходе ухода уход уходу
голубой: голубой голубые
результат: результатов результат результатом результатах результате
страдать: страдают
высокий: высокая высокую высокой высокий высшего
питомник: питомники питомнике
пара: пары
взрослый: взрослой взрослого
величина: величине
глаз: глаза глаз глазу
вплотную: вплотную
собственный: собственном собственное
проведение: проведении
прийтись: придется пришлось
февраль: феврале
заложить: заложенной заложенные
наказывать: наказывать
мягкий: мягкий
воротник: воротнике
обильный: обильное
самый: самым самое самых самые
фридрих: фридрих
соответствующий: соответствующие
ветклиника: ветклинику
пускать: пускать
часть: части часть
ознакомиться: ознакомиться
сказать: сказать
век: века
забегать: забегать
собачий: собачьей
малыш: малышу малыш малышами малыши малыша
вести: вести
год: года лет год году
предмет: предмет
слюноотделение: слюноотделение
квалифицировать: квалифицированной
прогулка: прогулка прогулки прогулок
взять: взяли
реакция: реакция реакций
поскольку: поскольку
правило: правилам правило правила правил
состояние: состоянием состоянию
агрессивный: агрессивной агрессивный
истеричный: истеричны
простой: простой
краткий: краткая
почитать: почитать
свой: своими своем свой свое своего своей своих своему
сильный: сильная сильного сильной
любой: любого любую любое
отношение: отношение отношению
налог: налогов
место: место
домашний: домашний домашней домашним
уха: ухе уху
смягчить: смягчить
обеспечивать: обеспечиваете
весь: весь всей всему всем
жертва: жертву
уроженец: уроженец
превосходство: превосходство
обогрев: обогрев
эксперт: экспертов эксперты
ранний: раннего
недостаточность: недостаточность
умный: умный умна умного умная
незамедлительный: незамедлительного
терапия: терапией
доверить: доверить
вконтакте: вконтакте
рядом: рядом
впечатление: впечатление
раскрыть: раскрыто раскрыть
дать: дать дадут данные дало дай
разведение: разведением разведению
ярко: ярко
обращение: обращения обращением
хозяин: хозяин хозяином хозяину хозяина
пол: пол полом
подбородок: подбородок
животное: животных животным животного животные животное
частный: частные
выведение: выведении выведением
исключение: исключений
лизательный: лизательной
пригодный: пригодные
завершение: завершением
характер: характером характера характеров характеру характер
спокойный: спокойным
выбрать: выбрать
манчестерский: манчестерский
мнение: мнения мнение мнению
взрывной: взрывным
основать: основана
неверно: неверно
хотя: хотя
продукт: продуктов продукты
стачиваться: стачиваются
внешний: внешней внешнего внешний
обтереть: оботрите
видный: видны
сам: сами самого сама
хвост: хвостом хвоста хвост
шоу-класс: шоу-класс
установить: установить
тампон: тампоном
купить: купил купить
пасть: пасть
проблема: проблемы проблемах проблема проблеме проблем
попробовать: попробуем
грация: грацию
чувствовать: чувствовать чувствует
включить: включены
заняться: занялся
заметный: заметный
тая: тая
естественный: естественного
технический: технические
квартира: квартире
размер: размеры размера
информация: информация
идеальный: идеальной идеальная
подходить: подходит
соразмерный: соразмерна
друг: друг друга друзьями
ходьба: ходьбе
масса: масса массой
максимально: максимально
полноценный: полноценные
мочь: могли могут можете
распространение: распространению распространение
спинка: спинка
ребро: ребра ребрами
выбор: выбор выбору
видать: видал
половина: половины
знать: знает
окрас: окрас
ежедневный: ежедневный
воспринимать: воспринимать
явиться: явившихся
вплоть: вплоть
правильный: правильного правильном правильный
карма: карма
среди: среди
дом: дом дома доме
дефекация: дефекации
племенной: племенной
серьёзный: серьезных серьезной
это: этим это
состав: составы
видимо: видимо
вскоре: вскоре
злоба: злобу
вышколить: вышколенную
крепкий: крепким крепкий крепкого
считаться: считается
развитой: развитые развитой развиты
рабочий: рабочих рабочие
операция: операция
находиться: находится находящееся
подход: подходе
без: безо
рука: руки
просто: просто
дождь: дождь
вырасти: вырастет
питие: питья
выйти: выйти
безупречный: безупречным
конец: конца конец
внимательный: внимательному внимательна
истерично-агрессивно: истерично-агрессивно
мир: миру мира
вожак: вожак
легендарный: легендарном
низкий: низкая
купировать: купируют купирован купированы
который: которое которого которая которых которые который
сердце: сердцем сердца
неоднократно: неоднократно
тип: типе
добавить: добавьте
холка: холка холке
ветеринар: ветеринары ветеринара
предрасположенность: предрасположенность
элитарный: элитарные
умеренный: умеренная
происхождение: происхождения
заболевание: заболевания заболевание заболеваний
тёмный: темные темный
профессиональный: профессиональные
резкий: резкий
ад: ада
необходимо: необходимо
запустить: запущена
пища: пищи пищу
терьер: терьер
удлинённый: удлиненная
щенячий: щенячью
дрожь: дрожь
задний: задние
редкий: реже редкая
вид: вида виду вид
кобель: кобеля кобели кобель
разрез: разрез
гладкий: гладкая гладкой
дрессировка: дрессировка дрессировке дрессировки
изящество: изяществом
время: время
приблизительно: приблизительно
сука: суки сук сука
агрессивность: агрессивность
выражать: выражал
планировать: планируем
деятельность: деятельности
урок: уроки
непрофессионал: непрофессионала
другой: другие
просмотр: просмотров
найти: найдете найти
русло: русло
мера: мере меры
кли-кай: кли-кай
тахикардия: тахикардия
несколько: несколько нескольких
личность: личность
пойнтер: пойнтер
множество: множество
ответ: ответа ответов
тупой: тупой
наш: наше
закон: законом
лечь: лягут
к: ко
реклама: реклама
клиент: клиенты клиентам
винить: винить
запуганность: запуганности
солидный: солидного
великий: великого
флегматичный: флегматичный
мускулатура: мускулатурой мускулатура
бытовать: бытующее
непосредственно: непосредственно
рекомендоваться: рекомендуется
выносливость: выносливостью
напоминать: напоминает
мочка: мочки мочка
болезнь: болезнь болезни
документ: документа
стекленеть: стекленеют
направить: направить
характерный: характерны
воспитание: воспитание воспитании
германия: германия германии германию
ржаво-рыжий: ржаво-рыжих
комната: комнаты
имя: имени имя
наследственный: наследственных наследственными
правильно: правильно
сборщик: сборщик
беспрекословный: беспрекословной
добермановхотеть: добермановхотела
добиться: добиться добьетесь
сайт: сайту
сухой: сухие
черепной: черепной
особенность: особенностей особенности
следствие: следствие
суточный: суточная
понять: понять поймут
этот: эта этих
быть: будут
лишь: лишь
принять: приняв
услышать: услышите
универсальный: универсальную
форум: форум форуме
падение: падении падения
боссерон: боссероны
безобидный: безобидная
аритмия: аритмия
край: краем
определиться: определиться
профессия: профессий
начало: начала начало начале
нисколько: нисколько
боль: боль
нужный: нужное
порой: порой
чистота: чистоте
любитель: любители
слагаемое: слагаемые
принести: принеся
соблюдение: соблюдение
осматривать: осматривая
выводиться: выводилась
знаменитый: знамениты
живой: живыми
описание: описание
организовывать: организовывая
эрфурт: эрфурте
здоровье: здоровьем здоровья здоровье
белый: белых белый
бандит: бандит
одинаковый: одинакова
карина: карина
аполёд: апольде апольды
однако: однако
позволять: позволяя позволяют позволяйте
национальный: национальный
преданность: преданность преданности
становиться: становится
щекастость: щекастость
поэтому: поэтому
коричневый: коричневый коричневых
манка: манки
случай: случаев случаи случае
глубина: глубина
предлагать: предлагают
копирование: копирование
кефир: кефире
трудно: трудно
добрый: добрый добрым
прекрасно: прекрасно
активность: активность активности
селекционер: селекционерам
помещение: помещении помещение
существовать: существует
дружелюбность: дружелюбность
равный: равна
прибегать: прибегать прибегая
обидеться: обидятся
заслуга: заслугах
лекарство: лекарства
отзыв: отзывах отзывы
громкий: громкий
винко: винко
нога: ноги
крупный: крупных
причисление: причисление
иммунитет: иммунитета
следовать: следует следуйте
плохой: плохим худшем худшее
указать: указав
шум: шум шумом
жизненный: жизненные
спадать: спадающая
натуральный: натуральные натуральных
граница: границами
провоцировать: провоцирующим
прямой: прямая прямые
густой: густая
подсказать: подскажите
аллергический: аллергических
федерация: федерация
ваш: вашими ваши вашей ваш вашего ваша
рассказать: расскажут
назад: назад
ведущий: ведущие
оттенок: оттенка оттенок
пожалуйста: пожалуйста
лето: летом
активный: активен активной
зарубцеваться: зарубцеваться
липецк: липецке
цвет: цвет
отдать: отдам
строка: строки
корн: корне
получить: получена получила
видеть: видеть
ухо: ушей ушами уши ушам
объявление: объявления
треф: трефе
подружиться: подружились
сделать: сделать сделано
основной: основные
полова: половой
решение: решение
мускулистый: мускулистым мускулистая
диплом: дипломами
мячик: мячик
интеллект: интеллект интеллекта
охранный: охранные охранной
многие: многие
взращивать: взращивать
настороженно: настороженно
вес: вес
степень: степени степень
сторожевой: сторожевой
полотенце: полотенцем
недовольство: недовольство
нос: носа
своевременный: своевременная
процедура: процедурах процедура
именно: именно
вопрос: вопросы вопросом вопрос
серьёзно: серьезно
доля: долей
топ-лист: топ-листы
отклонение: отклонения отклонение отклонением
холодное: холодное
восприниматься: воспринимается
продолжительность: продолжительность
закруглить: закругленный
потребление: потребления
международный: международная
несоответствие: несоответствие
единомышленник: единомышленника
составлять: составлять
отлично: отлично
линия: линия линий линии
подавлять: подавляющем
усвоить: усвоенные
доходить: доходит
обладать: обладающий
инстинктивно: инстинктивно
джим: джим
говорить: говорят
следить: следите
шествие: шествие
зависимость: зависимости
одышка: одышка
доберманна: доберманн
диагностировать: диагностируют
насилие: насилию
черно-подпалый: черно-подпалый
учиться: учиться
обыватель: обывателей
никак: никак
запрашивать: запрашивать
слегка: слегка
умственный: умственной
тот: те
обучаемость: обучаемости
здравствуйте: здравствуйте
больший: большую большие большей
чемпион: чемпионами
купание: купание
фото: фото
замечательный: замечательной
сталкиваться: сталкивался
пятилетний: пятилетнего
питание: питание
безальтернативный: безальтернативно
маленький: маленького меньше
допускаться: допускается допускаются
вы: вами
искать: ищете
болонка: болонок
готовый: готов
доноситься: доносившимся
яндекс: яндекс
количество: количество
вдогонку: вдогонку
собираться: собираясь
здоровый: здоров здоровые здоровый
приведение: приведением
определённый: определенной определенных
тонус: тонуса
гармонично: гармонично
приобретать: приобретали
хотеть: хотите хочу
допустить: допущены
лапа: лапы лап лапу
делать: делая делают
оценить: оценить
скрыть: скрыть
предпочтение: предпочтений
относить: относят
взгляд: взгляде
премиум-класс: премиум-класса
журнал: журнал
обучать: обучаемых
высота: высота
ответственно: ответственно
месяц: месяца месяцев
фарш: фарш
действие: действий
решаться: решаться
ослабление: ослабление
популярный: популярной популярных
мастиф: мастиф
блокировать: блокирующие
морковь: морковь
тд: тд
нуждаться: нуждаются
любимый: любимого
посчитать: посчитали
пыльца: пыльцой
составить: составленного
первый: первое первый первую
обычный: обычной обычная
затаить: затаить
нарушение: нарушение
изящный: изящная
незаметный: незаметные
грациозность: грациозностью
кардиотест: кардиотесты
статистический: статистические
морозов: морозова
думать: думать
совершенно: совершенно
всякий: всяких
уравновесить: уравновешенным уравновешенной
вдоволь: вдоволь
активно: активно
минута: минут
брать: брал
образ: образом
овальный: овальной
нежелательный: нежелательны нежелательных
погрызть: погрызенные
неустойчивый: неустойчивым
интеллектуальный: интеллектуальные
доберманный: доберманна
заработать: заработать
селекция: селекции
собака-мама: собаки-мамы
ответственный: ответственный
прилагать: прилагая
разобраться: разобраться
корпус: корпуса корпус
плохо: плохо
поставить: поставленных
сумма: сумму
заметно: заметно
лапка: лапке
официальный: официальная
посещать: посещая
служить: служившем
курс: курсе курсу
установленный: установленным
жирный: жирное
являться: являются является
перейти: перейти
неправильный: неправильное
необходимый: необходимых необходимым
ханаанский: ханаанская
открываться: открывается
отто: отто
ткань: ткани
стремительность: стремительность
из-за: из-за
регулярно: регулярно
красивый: красивый
первоначально: первоначально
поведение: поведение
номер: номер номером
рынок: рынке
селекционный: селекционной
оболочка: оболочки
есенин: есенина
менее: менее
звучать: звучит
залысина: залысинами
жёсткий: жесткой жесткая
терять: теряет
чистый: чистым чистой
послушный: послушной
принадлежность: принадлежности
осанка: осанки
дыхание: дыханием
систематический: систематические
воспаление: воспаление
непогода: непогоду
взаимоотношение: взаимоотношениях
костяк: костяк
отсутствие: отсутствие
европа: европе
одиночество: одиночеству
подходящий: подходящих
последний: последний
развить: развита развитая
зимой: зимой
нарколепсия: нарколепсия
реестр: реестр
бесстрашие: бесстрашие
чёткость: четкостью
стандарт: стандарта стандарту
кой: коем
день: день
выполнить: выполненных
престарелый: престарелая
морда: морда
спина: спины спина
рвота: рвоте
карла: карла
обустроить: обустроенном
бдительность: бдительность бдительности бдительностью
подобный: подобные
жёлтый: желтые
вольер: вольере вольера вольер
представляться: представляется
капуста: капуста
доска: досок
защитник: защитник
оценка: оценке
нагрузка: нагрузок нагрузках
состояться: состоялась
рубль: рублей
девочка-доберман: девочка-доберман
спереди: спереди
требование: требованиям требований
определять: определяемыми
щель: щели
ишемический: ишемическая
излишний: излишне излишней
разумный: разумных
работоспособность: работоспособность
смело: смело
топ: топ
длинный: длинная
стая: стаи
что-то: чему-то
игрушка: игрушки
грубость: грубости
внимание: внимание
дог: дог
блестящий: блестящей
непродолжительный: непродолжительная
прикус: прикуса прикус
совершенствование: совершенствованием
убрать: убрали
крестцовый: крестцовой
весить: весит
короткий: короткие короткая
одежда: одежды
стоимость: стоимость
телятина: телятина
особенно: особенно
ясный: ясна ясными
желательно: желательно
подавать: подавать
бишон: бишон
личный: личное
час: часов
отсутствовать: отсутствует
незначительный: незначительное
сложный: сложным
гоеллера: гоеллер гоеллера
достаточно: достаточно
поддаваться: поддается
обязательно: обязательно
входящий: входящая
контроль: контроле контроль
карл: карл
ход: ходе
миска: миски
очертание: очертаний
особь: особям
выпуклый: выпуклая
новый: новой новому
ранка: ранка
москва: москве москва
волчий: волчьи
кровь: кровей
неделя: неделю
группа: группе
подозрительность: подозрительности
специальный: специальные специальной
коренной: коренных
ошейник: ошейнике
связанный: связанные
иметь: иметь имеют имеющих
несмотря: несмотря
служебный: служебные служебным
часто: часто
графика: графика
носить: носить
воплотить: воплотить
семья: семье
ушко: ушки
добиваться: добиваться
безболезненный: безболезненный
дружелюбно: дружелюбно
профессионал: профессионалам
узконаправленный: узконаправленных
завести: завести
желание: желание
вертикально: вертикально
продаваться: продающихся
полуторамесячный: полуторамесячному
грудной: грудной
голова: голова
избавление: избавления
крошка-доберман: крошки-добермана
поразительный: поразительных
ласка: ласка
пупочный: пупочной
аляскинский: аляскинский
распределить: распределена
убеждение: убеждение
рекомендация: рекомендации
лаг: лаги
смерть: смерти
сожаление: сожалению
начать: начал
мокрый: мокрым
расстройство: расстройство
наличие: наличие
тепло: теплом
инфракрасный: инфракрасных
семейный: семейный семейные
клетка: клетки
подшёрсток: подшерстка
ротвейлер: ротвейлеры
удивительный: удивительных удивительным
крупа: круп
совпадать: совпадает
гордость: гордости гордость
далеко: далеко
трусость: трусость
злобный: злобном
припухлость: припухлости
презентация: презентация
одноклассник: одноклассники
знакомый: знакомым
скорее: скорее
изъян: изъяны
размягчать: размягчать
узнать: узнать
возможность: возможности
прописать: прописанные
отмена: отмене
генетический: генетическая
индекс: индекса
коробка: коробки
чистить: чистить
растение: растений
грудь: грудь
забота: забота
случайный: случайные
чётко: четко
показ: показ
кроме: кроме
мясо: мясо
полный: полному полное полном
спинной: спинной
плесневый: плесневыми
сегодня: сегодня
водный: водных
чувство: чувство
мыслить: мыслить
поиск: поиск
изумительный: изумительные
конкретный: конкретной
негативный: негативных
коротко: коротко
зуб: зубы зубов
молодой: молодым
пропорция: пропорциям
грозный: грозного
вялость: вялость
раздать: раздать
знаток: знатоки
себя: собой
белые: белые
неподвижный: неподвижным
период: период
кровоточить: кровоточат
разместить: разместить
предложить: предложат
ротовой: ротовой
нервозный: нервозной
малый: наименьшую
некоторый: некоторой
щётка: щеткой
триумфальный: триумфальное
разнообразный: разнообразными
сучий: сучьем
тапка: тапки
сигнал: сигналом
лакомство: лакомством
присмотреться: присмотритесь
потребность: потребность
периодически: периодически
память: память
главный: главным главные главная
порок: пороки
восторг: восторга
полиция: полиции
предок: предков
репутация: репутацию
опухоль: опухоль
опытный: опытных
доберманчик: доберманчика
жизнь: жизни
восхищение: восхищения
два: двух
занимать: занимать
тк: тк
лопоушко: лопоушку
ёмко: емко
сменить: сменил
способствовать: способствовало
ребёнок: детьми
строение: строением
ответный: ответная
пыль: пылью
дело: дела
всё-таки: все-таки
затем: затем
плечо: плечи
ассоциация: ассоциаций
светлый: светлый светлого
воспитывать: воспитывать
учитывать: учитывать
гладкошёрстный: гладкошерстной
волнистый: волнистая
желудок: желудка
нужно: нужно
мимимишность: мимимишности
покладистый: покладистой
животик: животик
настойчивость: настойчивость
также: также
толчок: толчок
экстерьер: экстерьера
процесс: процесс
приступ: приступам
розоватый: розоватые
ждать: ждать
луис: луис
момент: моменты момент
кот: кот
окружающий: окружающих
нежирный: нежирные
холлера: холлер
уверенный: уверенного
двигательный: двигательной
крупяной: крупяные
задуматься: задумался
отсюда: отсюда
набегаться: набегавшемуся
кинологический: кинологическая
ровный: ровная
обучить: обучить
обморок: обмороков
норма: норма
начинать: начиная
привести: привести
понаблюдать: понаблюдайте
изначально: изначально
высоко: высоко
утонченность: утонченностью
задаток: задатках задатки
неадекватный: неадекватном
крайне: крайне
стоить: стоит
любимец: любимец любимцы
питомец: питомца питомцем
ножницеобразный: ножницеобразный
чужак: чужаку
практиковаться: практикуется
зависеть: зависит
помочь: помочь
страх: страха
кормить: кормить
вполне: вполне
смочь: сможет
медлить: медлить
равновесие: равновесия
житель: житель
старонемецкий: старонемецкие
выступать: выступающими выступающая
любить: любят
невозможно: невозможно
стол: стола
аккуратно: аккуратно
гаванский: гаванский
сидение: сиденье
служба: службе службы
участок: участках
кратковременный: кратковременном
тренировка: тренировка
каша: каши
многий: многих
легко: легко
лента: ленту
василий: василия
воспитать: воспитать
выставка-продажа: выставки-продажи
вседозволенность: вседозволенность
сердечно-сосудистый: сердечно-сосудистые
торчать: торчащие
анатомический: анатомическим
шумейко: шумейко
русский: русского
ватный: ватным
отличный: отличные
многое: многом
альтернатива: альтернативы
расчёсывать: расчесывать
занести: занесла
последовательность: последовательность
начеку: начеку
заплатить: заплатить
сила: силу
вакансия: вакансии
специалист: специалисты
сфера: сфере
вытянутость: вытянутости
человеческий: человеческим
город: города
снег: снег
сбалансированный: сбалансированное
постоянно: постоянно
вестись: велись
выделение: выделений
генетически: генетически
достаточный: достаточным достаточное
разниться: разнятся
проявиться: проявиться
достоинство: достоинства
выше: выше
толщина: толщиной
грыжа: грыжи
спутник-защитник: спутника-защитника
простудиться: простудиться
большинство: большинстве
вместе: вместе
психика: психикой
жара: жару
некорректный: некорректным
покупка: покупка
избранник: избранника
баловаться: балуется
амбициозный: амбициозны
о: обо
корм: корма
помассировать: помассируйте
гастрономический: гастрономических
вздутие: вздутие
неиссякаемый: неиссякаемое
рейтинг: рейтинг
произойти: произойти
обогреватель: обогревателей
купирование: купирование
действовать: действуют
ряд: ряд
машина: машине
террор: террора
подписываться: подписывайтесь
купироваться: купируется
авторитет: авторитетом
недостаточно: недостаточно
вытянутый: вытянутая
равномерно: равномерно
оправдать: оправдана
секьюрити: секьюрити
означать: означает
дисциплина: дисциплина
кабачок: кабачки
создание: создании
передать: передать
постановка: постановка
дефект: дефектам
придерживаться: придерживайтесь
очень: очень
обычно: обычно
разгорячить: разгоряченному
малыш-доберман: малышом-доберманом
выполнять: выполнять
альпода: альпода
второе: второе
наиболее: наиболее
мытьё: мытье
ответственность: ответственности
ирландский: ирландский
видимый: видимых
наоборот: наоборот
кличка: клички
прежде: прежде
держать: держать
поясничный: поясничный
благородство: благородство
лай: лаем
грибок: грибками
касаться: касается
значение: значения
вырастить: вырастить
артист: артиста
прекрасный: прекрасный прекрасные
проект: проекте
сразу: сразу
нервный: нервной
кг: кг
насколько: насколько
городской: городской
необходимость: необходимости
полгода: полгода
смочить: смоченным
сидеть: сидеть
темперамент: темперамента
поглаживание: поглаживание
безразличный: безразличный
среднее: среднего
гранулёма: гранулемы
линька: линька
идти: идти
рацион: рацион
создать: создали
вздутый: вздутый
шкура: шкуре
согреться: согреться
внутренний: внутренней
нервозность: нервозность
совет: советов
регулярный: регулярных
специализировать: специализированном
причём: причем
ситуация: ситуации
усилие: усилий
оружие: оружие
дружба: дружба
показать: показано
энергия: энергии
родитель: родителей
исчадие: исчадие
карточка: карточку
клин: клин
охрана: охране
комок: комке
губа: губы
элитный: элитных
основный: основных
качалов: качалова
диетический: диетические
условие: условия
гораздо: гораздо
сердечный: сердечная
основа: основа
элегантный: элегантной
ансамбль: ансамбль
обученный: обученный
уважаемый: уважаемые
какой: каких
